id,matchup_id,game_id,result,team_score,opponent_score,point_diff
1,1,1,W,106,95,11
2,2,1,L,95,106,-11
3,3,2,W,116,92,24
4,4,2,L,92,116,-24
5,5,3,W,113,80,33
6,6,3,L,80,113,-33
7,7,4,L,119,122,-3
8,8,4,W,122,119,3
9,9,5,W,133,130,3
10,10,5,L,130,133,-3
11,11,6,L,99,119,-20
12,12,6,W,119,99,20
13,13,7,L,83,100,-17
14,14,7,W,100,83,17
15,15,8,W,121,107,14
16,16,8,L,107,121,-14
17,17,9,L,105,128,-23
18,18,9,W,128,105,23
19,19,10,W,118,99,19
20,20,10,L,99,118,-19
21,21,11,L,141,145,-4
22,22,11,W,145,141,4
23,23,12,L,107,126,-19
24,24,12,W,126,107,19
25,25,13,L,108,119,-11
26,26,13,W,119,108,11
27,27,14,L,86,111,-25
28,28,14,W,111,86,25
29,9,15,W,115,107,8
30,10,15,L,107,115,-8
31,29,16,W,95,86,9
32,30,16,L,86,95,-9
33,31,17,L,115,125,-10
34,32,17,W,125,115,10
35,33,18,W,116,106,10
36,34,18,L,106,116,-10
37,35,19,W,118,107,11
38,36,19,L,107,118,-11
39,37,20,L,101,124,-23
40,38,20,W,124,101,23
41,25,21,W,144,97,47
42,26,21,L,97,144,-47
43,39,22,L,93,100,-7
44,40,22,W,100,93,7
45,41,23,W,116,111,5
46,42,23,L,111,116,-5
47,43,24,L,120,128,-8
48,44,24,W,128,120,8
49,45,25,W,115,107,8
50,46,25,L,107,115,-8
51,47,26,W,116,111,5
52,48,26,L,111,116,-5
53,49,27,L,111,124,-13
54,50,27,W,124,111,13
55,51,28,W,110,109,1
56,52,28,L,109,110,-1
57,41,29,L,107,108,-1
58,42,29,W,108,107,1
59,53,30,W,116,100,16
60,54,30,L,100,116,-16
61,55,31,L,95,98,-3
62,56,31,W,98,95,3
63,57,32,W,120,113,7
64,58,32,L,113,120,-7
65,59,33,L,104,106,-2
66,60,33,W,106,104,2
67,61,34,W,129,128,1
68,62,34,L,128,129,-1
69,63,35,L,91,127,-36
70,64,35,W,127,91,36
71,65,36,W,124,73,51
72,66,36,L,73,124,-51
73,67,37,L,110,130,-20
74,68,37,W,130,110,20
75,69,38,L,94,118,-24
76,70,38,W,118,94,24
77,71,39,W,128,119,9
78,72,39,L,119,128,-9
79,73,40,L,126,128,-2
80,74,40,W,128,126,2
81,75,41,W,125,106,19
82,76,41,L,106,125,-19
83,53,42,L,103,106,-3
84,54,42,W,106,103,3
85,77,43,W,122,112,10
86,78,43,L,112,122,-10
87,57,44,W,130,120,10
88,58,44,L,120,130,-10
89,79,45,W,116,111,5
90,80,45,L,111,116,-5
91,81,46,L,114,119,-5
92,82,46,W,119,114,5
93,83,47,W,109,89,20
94,84,47,L,89,109,-20
95,85,48,W,109,107,2
96,86,48,L,107,109,-2
97,87,49,W,121,108,13
98,88,49,L,108,121,-13
99,89,50,L,98,111,-13
100,90,50,W,111,98,13
101,91,51,W,123,95,28
102,92,51,L,95,123,-28
103,93,52,L,115,138,-23
104,94,52,W,138,115,23
105,95,53,L,99,138,-39
106,96,53,W,138,99,39
107,97,54,W,120,100,20
108,98,54,L,100,120,-20
109,99,55,L,121,122,-1
110,100,55,W,122,121,1
111,101,56,W,124,104,20
112,102,56,L,104,124,-20
113,103,57,L,114,121,-7
114,104,57,W,121,114,7
115,105,58,L,107,113,-6
116,106,58,W,113,107,6
117,107,59,L,107,121,-14
118,108,59,W,121,107,14
119,109,60,W,131,119,12
120,110,60,L,119,131,-12
121,111,61,L,101,111,-10
122,112,61,W,111,101,10
123,113,62,W,113,99,14
124,114,62,L,99,113,-14
125,32,63,W,124,122,2
126,31,63,L,122,124,-2
127,115,64,L,107,113,-6
128,116,64,W,113,107,6
129,117,65,L,102,106,-4
130,118,65,W,106,102,4
131,119,66,W,116,109,7
132,120,66,L,109,116,-7
133,121,67,L,99,125,-26
134,122,67,W,125,99,26
135,123,68,W,106,93,13
136,124,68,L,93,106,-13
137,124,69,W,111,108,3
138,123,69,L,108,111,-3
139,123,70,W,102,96,6
140,124,70,L,96,102,-6
141,123,71,L,104,115,-11
142,124,71,W,115,104,11
143,124,72,L,114,124,-10
144,123,72,W,124,114,10
145,124,73,L,98,116,-18
146,123,73,W,116,98,18
147,125,74,L,113,125,-12
148,126,74,W,125,113,12
149,127,75,L,107,117,-10
150,128,75,W,117,107,10
151,126,76,L,108,121,-13
152,125,76,W,121,108,13
153,128,77,W,114,108,6
154,127,77,L,108,114,-6
155,125,78,L,109,112,-3
156,126,78,W,112,109,3
157,128,79,L,106,114,-8
158,127,79,W,114,106,8
159,127,80,L,103,105,-2
160,128,80,W,105,103,2
161,125,81,W,117,106,11
162,126,81,L,106,117,-11
163,127,82,L,114,126,-12
164,128,82,W,126,114,12
165,126,83,W,106,101,5
166,125,83,L,101,106,-5
167,88,84,W,104,89,15
168,87,84,L,89,104,-15
169,126,85,W,117,114,3
170,125,85,L,114,117,-3
171,87,86,L,98,111,-13
172,88,86,W,111,98,13
173,129,87,L,96,119,-23
174,130,87,W,119,96,23
175,88,88,W,111,105,6
176,87,88,L,105,111,-6
177,131,89,W,92,87,5
178,132,89,L,87,92,-5
179,130,90,W,110,100,10
180,129,90,L,100,110,-10
181,132,91,W,125,122,3
182,131,91,L,122,125,-3
183,87,92,W,96,85,11
184,88,92,L,85,96,-11
185,26,93,W,103,94,9
186,25,93,L,94,103,-9
187,130,94,W,112,102,10
188,129,94,L,102,112,-10
189,131,95,W,111,89,22
190,132,95,L,89,111,-22
191,87,96,W,113,107,6
192,88,96,L,107,113,-6
193,25,97,W,118,115,3
194,26,97,L,115,118,-3
195,129,98,L,109,117,-8
196,130,98,W,117,109,8
197,88,99,W,110,101,9
198,87,99,L,101,110,-9
199,132,100,W,100,93,7
200,131,100,L,93,100,-7
201,25,101,L,100,115,-15
202,26,101,W,115,100,15
203,129,102,W,112,97,15
204,130,102,L,97,112,-15
205,88,103,L,97,120,-23
206,87,103,W,120,97,23
207,132,104,W,104,103,1
208,131,104,L,103,104,-1
209,26,105,W,116,114,2
210,25,105,L,114,116,-2
211,133,106,L,102,104,-2
212,134,106,W,104,102,2
213,131,107,W,102,99,3
214,132,107,L,99,102,-3
215,135,108,L,78,80,-2
216,136,108,W,80,78,2
217,26,109,W,115,104,11
218,25,109,L,104,115,-11
219,134,110,L,100,104,-4
220,133,110,W,104,100,4
221,131,111,W,112,94,18
222,132,111,L,94,112,-18
223,66,112,W,111,97,14
224,65,112,L,97,111,-14
225,136,113,W,119,107,12
226,135,113,L,107,119,-12
227,133,114,L,80,114,-34
228,134,114,W,114,80,34
229,137,115,L,104,118,-14
230,138,115,W,118,104,14
231,45,116,L,122,131,-9
232,46,116,W,131,122,9
233,135,117,L,107,117,-10
234,136,117,W,117,107,10
235,65,118,L,111,154,-43
236,66,118,W,154,111,43
237,46,119,W,135,115,20
238,45,119,L,115,135,-20
239,134,120,L,114,117,-3
240,133,120,W,117,114,3
241,139,121,L,87,99,-12
242,140,121,W,99,87,12
243,138,122,W,121,106,15
244,137,122,L,106,121,-15
245,141,123,W,150,122,28
246,142,123,L,122,150,-28
247,136,124,L,127,129,-2
248,135,124,W,129,127,2
249,66,125,L,133,135,-2
250,65,125,W,135,133,2
251,143,126,W,110,106,4
252,144,126,L,106,110,-4
253,138,127,W,121,107,14
254,137,127,L,107,121,-14
255,134,128,L,107,119,-12
256,133,128,W,119,107,12
257,46,129,W,116,108,8
258,45,129,L,108,116,-8
259,139,130,L,115,124,-9
260,140,130,W,124,115,9
261,141,131,W,117,92,25
262,142,131,L,92,117,-25
263,66,132,W,130,122,8
264,65,132,L,122,130,-8
265,143,133,W,102,94,8
266,144,133,L,94,102,-8
267,136,134,L,87,124,-37
268,135,134,W,124,87,37
269,137,135,L,96,111,-15
270,138,135,W,111,96,15
271,140,136,W,109,100,9
272,139,136,L,100,109,-9
273,45,137,L,88,111,-23
274,46,137,W,111,88,23
275,133,138,L,98,111,-13
276,134,138,W,111,98,13
277,144,139,L,101,128,-27
278,143,139,W,128,101,27
279,142,140,L,99,104,-5
280,141,140,W,104,99,5
281,135,141,W,124,105,19
282,136,141,L,105,124,-19
283,65,142,W,127,114,13
284,66,142,L,114,127,-13
285,45,143,W,100,93,7
286,46,143,L,93,100,-7
287,137,144,W,122,110,12
288,138,144,L,110,122,-12
289,140,145,W,113,101,12
290,139,145,L,101,113,-12
291,133,146,L,108,123,-15
292,134,146,W,123,108,15
293,142,147,L,110,134,-24
294,141,147,W,134,110,24
295,135,148,L,125,135,-10
296,136,148,W,135,125,10
297,65,149,L,110,118,-8
298,66,149,W,118,110,8
299,144,150,L,101,109,-8
300,143,150,W,109,101,8
301,145,151,L,122,126,-4
302,146,151,W,126,122,4
303,140,152,L,92,109,-17
304,139,152,W,109,92,17
305,147,153,L,103,107,-4
306,148,153,W,107,103,4
307,149,154,L,109,117,-8
308,150,154,W,117,109,8
309,151,155,W,134,96,38
310,152,155,L,96,134,-38
311,153,156,L,127,133,-6
312,154,156,W,133,127,6
313,155,157,W,96,90,6
314,156,157,L,90,96,-6
315,157,158,L,112,118,-6
316,158,158,W,118,112,6
317,159,159,W,136,122,14
318,160,159,L,122,136,-14
319,161,160,L,106,119,-13
320,162,160,W,119,106,13
321,117,161,L,102,128,-26
322,118,161,W,128,102,26
323,163,162,W,134,133,1
324,164,162,L,133,134,-1
325,39,163,W,125,121,4
326,40,163,L,121,125,-4
327,165,164,W,108,104,4
328,166,164,L,104,108,-4
329,167,165,L,115,116,-1
330,168,165,W,116,115,1
331,87,166,W,124,111,13
332,88,166,L,111,124,-13
333,169,167,L,105,123,-18
334,170,167,W,123,105,18
335,171,168,W,130,117,13
336,172,168,L,117,130,-13
337,24,169,W,122,107,15
338,23,169,L,107,122,-15
339,173,170,W,134,131,3
340,174,170,L,131,134,-3
341,175,171,W,126,113,13
342,176,171,L,113,126,-13
343,177,172,L,106,112,-6
344,178,172,W,112,106,6
345,179,173,W,108,96,12
346,180,173,L,96,108,-12
347,139,174,L,92,114,-22
348,140,174,W,114,92,22
349,127,175,L,121,124,-3
350,128,175,W,124,121,3
351,181,176,L,101,128,-27
352,182,176,W,128,101,27
353,183,177,W,122,114,8
354,184,177,L,114,122,-8
355,185,178,W,114,106,8
356,186,178,L,106,114,-8
357,187,179,L,103,121,-18
358,188,179,W,121,103,18
359,189,180,L,99,108,-9
360,190,180,W,108,99,9
361,191,181,L,121,124,-3
362,192,181,W,124,121,3
363,193,182,W,129,120,9
364,194,182,L,120,129,-9
365,8,183,W,129,112,17
366,7,183,L,112,129,-17
367,195,184,L,119,122,-3
368,196,184,W,122,119,3
369,55,185,W,122,113,9
370,56,185,L,113,122,-9
371,18,186,W,122,117,5
372,17,186,L,117,122,-5
373,197,187,L,132,136,-4
374,198,187,W,136,132,4
375,135,188,L,132,134,-2
376,136,188,W,134,132,2
377,199,189,L,111,116,-5
378,200,189,W,116,111,5
379,201,190,W,119,112,7
380,202,190,L,112,119,-7
381,158,191,L,111,119,-8
382,157,191,W,119,111,8
383,203,192,L,107,118,-11
384,204,192,W,118,107,11
385,131,193,W,122,100,22
386,132,193,L,100,122,-22
387,205,194,L,106,119,-13
388,206,194,W,119,106,13
389,207,195,L,92,121,-29
390,208,195,W,121,92,29
391,4,196,L,101,108,-7
392,3,196,W,108,101,7
393,209,197,W,125,115,10
394,210,197,L,115,125,-10
395,66,198,W,126,111,15
396,65,198,L,111,126,-15
397,211,199,L,99,114,-15
398,212,199,W,114,99,15
399,26,200,L,116,130,-14
400,25,200,W,130,116,14
401,130,201,L,97,113,-16
402,129,201,W,113,97,16
403,177,202,L,125,140,-15
404,178,202,W,140,125,15
405,91,203,L,115,149,-34
406,92,203,W,149,115,34
407,213,204,W,109,99,10
408,214,204,L,99,109,-10
409,215,205,L,115,124,-9
410,216,205,W,124,115,9
411,106,206,W,107,98,9
412,105,206,L,98,107,-9
413,217,207,W,105,86,19
414,218,207,L,86,105,-19
415,219,208,W,132,126,6
416,220,208,L,126,132,-6
417,73,209,L,102,110,-8
418,74,209,W,110,102,8
419,221,210,W,114,110,4
420,222,210,L,110,114,-4
421,223,211,W,117,115,2
422,224,211,L,115,117,-2
423,225,212,L,109,120,-11
424,226,212,W,120,109,11
425,227,213,W,119,116,3
426,228,213,L,116,119,-3
427,125,214,L,106,112,-6
428,126,214,W,112,106,6
429,229,215,W,116,108,8
430,230,215,L,108,116,-8
431,231,216,W,107,103,4
432,232,216,L,103,107,-4
433,233,217,L,99,109,-10
434,234,217,W,109,99,10
435,235,218,L,130,132,-2
436,236,218,W,132,130,2
437,237,219,W,111,100,11
438,238,219,L,100,111,-11
439,239,220,W,121,113,8
440,240,220,L,113,121,-8
441,241,221,L,116,120,-4
442,242,221,W,120,116,4
443,243,222,L,110,118,-8
444,244,222,W,118,110,8
445,245,223,L,116,132,-16
446,246,223,W,132,116,16
447,247,224,L,124,128,-4
448,248,224,W,128,124,4
449,109,225,W,108,106,2
450,110,225,L,106,108,-2
451,117,226,L,115,117,-2
452,118,226,W,117,115,2
453,51,227,L,94,110,-16
454,52,227,W,110,94,16
455,249,228,L,121,127,-6
456,250,228,W,127,121,6
457,251,229,L,92,107,-15
458,252,229,W,107,92,15
459,253,230,L,103,126,-23
460,254,230,W,126,103,23
461,255,231,W,125,105,20
462,256,231,L,105,125,-20
463,257,232,W,125,112,13
464,258,232,L,112,125,-13
465,145,233,L,135,140,-5
466,146,233,W,140,135,5
467,259,234,W,153,149,4
468,260,234,L,149,153,-4
469,100,235,L,112,119,-7
470,99,235,W,119,112,7
471,180,236,W,128,118,10
472,179,236,L,118,128,-10
473,261,237,L,120,129,-9
474,262,237,W,129,120,9
475,119,238,L,101,103,-2
476,120,238,W,103,101,2
477,263,239,W,106,104,2
478,264,239,L,104,106,-2
479,265,240,L,106,124,-18
480,266,240,W,124,106,18
481,267,241,L,97,113,-16
482,268,241,W,113,97,16
483,269,242,W,109,98,11
484,270,242,L,98,109,-11
485,271,243,W,136,131,5
486,272,243,L,131,136,-5
487,41,244,W,114,111,3
488,42,244,L,111,114,-3
489,273,245,L,103,108,-5
490,274,245,W,108,103,5
491,275,246,W,131,107,24
492,276,246,L,107,131,-24
493,277,247,L,109,119,-10
494,278,247,W,119,109,10
495,279,248,L,115,122,-7
496,280,248,W,122,115,7
497,281,249,W,120,115,5
498,282,249,L,115,120,-5
499,283,250,L,105,121,-16
500,284,250,W,121,105,16
501,285,251,W,104,102,2
502,286,251,L,102,104,-2
503,287,252,L,111,117,-6
504,288,252,W,117,111,6
505,289,253,L,95,109,-14
506,290,253,W,109,95,14
507,291,254,L,138,143,-5
508,292,254,W,143,138,5
509,293,255,W,101,92,9
510,294,255,L,92,101,-9
511,120,256,W,112,103,9
512,119,256,L,103,112,-9
513,295,257,L,84,96,-12
514,296,257,W,96,84,12
515,297,258,L,107,110,-3
516,298,258,W,110,107,3
517,299,259,W,105,104,1
518,300,259,L,104,105,-1
519,301,260,L,129,132,-3
520,302,260,W,132,129,3
521,303,261,W,120,107,13
522,304,261,L,107,120,-13
523,305,262,W,118,113,5
524,306,262,L,113,118,-5
525,307,263,W,100,89,11
526,308,263,L,89,100,-11
527,309,264,L,131,140,-9
528,310,264,W,140,131,9
529,311,265,W,112,109,3
530,312,265,L,109,112,-3
531,313,266,W,126,106,20
532,314,266,L,106,126,-20
533,315,267,W,123,111,12
534,316,267,L,111,123,-12
535,317,268,L,99,108,-9
536,318,268,W,108,99,9
537,319,269,L,102,104,-2
538,320,269,W,104,102,2
539,321,270,W,111,105,6
540,322,270,L,105,111,-6
541,323,271,L,114,118,-4
542,324,271,W,118,114,4
543,77,272,L,101,118,-17
544,78,272,W,118,101,17
545,284,273,L,117,127,-10
546,283,273,W,127,117,10
547,325,274,L,112,118,-6
548,326,274,W,118,112,6
549,327,275,L,120,139,-19
550,328,275,W,139,120,19
551,329,276,W,126,103,23
552,330,276,L,103,126,-23
553,331,277,W,132,118,14
554,332,277,L,118,132,-14
555,333,278,L,96,121,-25
556,334,278,W,121,96,25
557,75,279,W,108,102,6
558,76,279,L,102,108,-6
559,90,280,L,104,110,-6
560,89,280,W,110,104,6
561,335,281,W,99,94,5
562,336,281,L,94,99,-5
563,337,282,L,103,113,-10
564,338,282,W,113,103,10
565,339,283,W,114,112,2
566,340,283,L,112,114,-2
567,341,284,W,125,108,17
568,342,284,L,108,125,-17
569,343,285,W,121,113,8
570,344,285,L,113,121,-8
571,345,286,W,120,105,15
572,346,286,L,105,120,-15
573,347,287,W,112,104,8
574,348,287,L,104,112,-8
575,47,288,W,118,79,39
576,48,288,L,79,118,-39
577,349,289,L,108,115,-7
578,350,289,W,115,108,7
579,116,290,L,113,116,-3
580,115,290,W,116,113,3
581,351,291,L,104,125,-21
582,352,291,W,125,104,21
583,353,292,W,112,106,6
584,354,292,L,106,112,-6
585,355,293,W,114,107,7
586,356,293,L,107,114,-7
587,357,294,L,123,127,-4
588,358,294,W,127,123,4
589,359,295,L,100,119,-19
590,360,295,W,119,100,19
591,91,296,W,129,120,9
592,92,296,L,120,129,-9
593,361,297,L,126,133,-7
594,362,297,W,133,126,7
595,363,298,W,123,114,9
596,364,298,L,114,123,-9
597,365,299,W,104,103,1
598,366,299,L,103,104,-1
599,367,300,L,107,120,-13
600,368,300,W,120,107,13
601,369,301,W,116,100,16
602,370,301,L,100,116,-16
603,148,302,W,109,94,15
604,147,302,L,94,109,-15
605,304,303,W,139,134,5
606,303,303,L,134,139,-5
607,78,304,W,127,88,39
608,77,304,L,88,127,-39
609,371,305,L,123,125,-2
610,372,305,W,125,123,2
611,373,306,W,130,107,23
612,374,306,L,107,130,-23
613,375,307,W,126,113,13
614,376,307,L,113,126,-13
615,377,308,W,116,111,5
616,378,308,L,111,116,-5
617,379,309,L,107,109,-2
618,380,309,W,109,107,2
619,25,310,L,89,105,-16
620,26,310,W,105,89,16
621,381,311,W,111,91,20
622,382,311,L,91,111,-20
623,383,312,W,122,114,8
624,384,312,L,114,122,-8
625,150,313,L,118,133,-15
626,149,313,W,133,118,15
627,385,314,W,124,110,14
628,386,314,L,110,124,-14
629,387,315,W,93,85,8
630,388,315,L,85,93,-8
631,389,316,L,100,106,-6
632,390,316,W,106,100,6
633,391,317,L,130,136,-6
634,392,317,W,136,130,6
635,393,318,L,113,114,-1
636,394,318,W,114,113,1
637,395,319,L,113,116,-3
638,396,319,W,116,113,3
639,12,320,W,113,104,9
640,11,320,L,104,113,-9
641,397,321,L,117,129,-12
642,398,321,W,129,117,12
643,399,322,L,115,125,-10
644,400,322,W,125,115,10
645,401,323,W,115,99,16
646,402,323,L,99,115,-16
647,403,324,L,88,105,-17
648,404,324,W,105,88,17
649,405,325,W,111,110,1
650,406,325,L,110,111,-1
651,407,326,W,104,101,3
652,408,326,L,101,104,-3
653,409,327,L,119,129,-10
654,410,327,W,129,119,10
655,411,328,L,86,133,-47
656,412,328,W,133,86,47
657,22,329,L,118,141,-23
658,21,329,W,141,118,23
659,413,330,W,113,111,2
660,414,330,L,111,113,-2
661,415,331,W,99,96,3
662,416,331,L,96,99,-3
663,332,332,L,125,136,-11
664,331,332,W,136,125,11
665,88,333,L,103,132,-29
666,87,333,W,132,103,29
667,417,334,L,118,126,-8
668,418,334,W,126,118,8
669,419,335,L,104,116,-12
670,420,335,W,116,104,12
671,421,336,W,116,86,30
672,422,336,L,86,116,-30
673,84,337,L,106,115,-9
674,83,337,W,115,106,9
675,423,338,L,100,106,-6
676,424,338,W,106,100,6
677,425,339,L,108,112,-4
678,426,339,W,112,108,4
679,69,340,L,94,108,-14
680,70,340,W,108,94,14
681,427,341,W,130,120,10
682,428,341,L,120,130,-10
683,429,342,L,101,107,-6
684,430,342,W,107,101,6
685,431,343,W,129,126,3
686,432,343,L,126,129,-3
687,224,344,W,102,92,10
688,223,344,L,92,102,-10
689,277,345,W,109,103,6
690,278,345,L,103,109,-6
691,433,346,L,112,140,-28
692,434,346,W,140,112,28
693,244,347,L,106,110,-4
694,243,347,W,110,106,4
695,336,348,W,114,103,11
696,335,348,L,103,114,-11
697,435,349,W,112,94,18
698,436,349,L,94,112,-18
699,248,350,W,118,106,12
700,247,350,L,106,118,-12
701,437,351,L,80,119,-39
702,438,351,W,119,80,39
703,384,352,L,109,118,-9
704,383,352,W,118,109,9
705,186,353,W,108,97,11
706,185,353,L,97,108,-11
707,439,354,L,98,115,-17
708,440,354,W,115,98,17
709,441,355,W,124,122,2
710,442,355,L,122,124,-2
711,1,356,W,131,111,20
712,2,356,L,111,131,-20
713,443,357,L,97,124,-27
714,444,357,W,124,97,27
715,175,358,W,137,134,3
716,176,358,L,134,137,-3
717,445,359,L,112,129,-17
718,446,359,W,129,112,17
719,382,360,L,123,139,-16
720,381,360,W,139,123,16
721,372,361,L,112,123,-11
722,371,361,W,123,112,11
723,180,362,W,115,113,2
724,179,362,L,113,115,-2
725,447,363,L,119,125,-6
726,448,363,W,125,119,6
727,449,364,W,115,101,14
728,450,364,L,101,115,-14
729,10,365,L,117,126,-9
730,9,365,W,126,117,9
731,451,366,L,104,107,-3
732,452,366,W,107,104,3
733,453,367,L,81,127,-46
734,454,367,W,127,81,46
735,455,368,L,112,114,-2
736,456,368,W,114,112,2
737,457,369,L,103,131,-28
738,458,369,W,131,103,28
739,459,370,L,116,128,-12
740,460,370,W,128,116,12
741,461,371,W,120,110,10
742,462,371,L,110,120,-10
743,463,372,L,107,111,-4
744,464,372,W,111,107,4
745,465,373,L,98,119,-21
746,466,373,W,119,98,21
747,467,374,W,112,104,8
748,468,374,L,104,112,-8
749,59,375,W,115,86,29
750,60,375,L,86,115,-29
751,469,376,W,112,103,9
752,470,376,L,103,112,-9
753,448,377,L,105,124,-19
754,447,377,W,124,105,19
755,471,378,W,113,108,5
756,472,378,L,108,113,-5
757,108,379,W,106,98,8
758,107,379,L,98,106,-8
759,404,380,L,105,117,-12
760,403,380,W,117,105,12
761,364,381,L,101,118,-17
762,363,381,W,118,101,17
763,473,382,W,122,106,16
764,474,382,L,106,122,-16
765,157,383,W,113,104,9
766,158,383,L,104,113,-9
767,475,384,W,128,115,13
768,476,384,L,115,128,-13
769,477,385,W,127,117,10
770,478,385,L,117,127,-10
771,239,386,L,101,113,-12
772,240,386,W,113,101,12
773,479,387,L,124,129,-5
774,480,387,W,129,124,5
775,481,388,L,104,112,-8
776,482,388,W,112,104,8
777,483,389,W,135,105,30
778,484,389,L,105,135,-30
779,408,390,L,125,129,-4
780,407,390,W,129,125,4
781,485,391,W,126,106,20
782,486,391,L,106,126,-20
783,487,392,W,103,93,10
784,488,392,L,93,103,-10
785,489,393,L,133,141,-8
786,490,393,W,141,133,8
787,6,394,W,123,118,5
788,5,394,L,118,123,-5
789,491,395,L,112,116,-4
790,492,395,W,116,112,4
791,128,396,W,120,116,4
792,127,396,L,116,120,-4
793,222,397,L,111,130,-19
794,221,397,W,130,111,19
795,280,398,W,114,96,18
796,279,398,L,96,114,-18
797,360,399,L,111,118,-7
798,359,399,W,118,111,7
799,493,400,L,105,127,-22
800,494,400,W,127,105,22
801,495,401,W,115,108,7
802,496,401,L,108,115,-7
803,401,402,L,106,112,-6
804,402,402,W,112,106,6
805,141,403,L,91,101,-10
806,142,403,W,101,91,10
807,146,404,L,104,111,-7
808,145,404,W,111,104,7
809,497,405,L,101,116,-15
810,498,405,W,116,101,15
811,392,406,L,103,110,-7
812,391,406,W,110,103,7
813,457,407,W,114,106,8
814,458,407,L,106,114,-8
815,406,408,L,105,116,-11
816,405,408,W,116,105,11
817,476,409,L,117,138,-21
818,475,409,W,138,117,21
819,9,410,L,114,126,-12
820,10,410,W,126,114,12
821,499,411,W,113,101,12
822,500,411,L,101,113,-12
823,501,412,W,106,105,1
824,502,412,L,105,106,-1
825,503,413,L,100,125,-25
826,504,413,W,125,100,25
827,505,414,W,87,76,11
828,506,414,L,76,87,-11
829,220,415,L,120,127,-7
830,219,415,W,127,120,7
831,184,416,W,123,119,4
832,183,416,L,119,123,-4
833,507,417,L,126,137,-11
834,508,417,W,137,126,11
835,509,418,L,111,123,-12
836,510,418,W,123,111,12
837,428,419,L,126,135,-9
838,427,419,W,135,126,9
839,271,420,L,135,140,-5
840,272,420,W,140,135,5
841,511,421,L,109,115,-6
842,512,421,W,115,109,6
843,513,422,L,111,118,-7
844,514,422,W,118,111,7
845,462,423,W,114,113,1
846,461,423,L,113,114,-1
847,515,424,W,106,99,7
848,516,424,L,99,106,-7
849,517,425,W,133,92,41
850,518,425,L,92,133,-41
851,300,426,W,112,111,1
852,299,426,L,111,112,-1
853,20,427,W,116,100,16
854,19,427,L,100,116,-16
855,421,428,W,125,120,5
856,422,428,L,120,125,-5
857,142,429,L,118,119,-1
858,141,429,W,119,118,1
859,519,430,W,117,108,9
860,520,430,L,108,117,-9
861,262,431,L,102,122,-20
862,261,431,W,122,102,20
863,38,432,L,115,142,-27
864,37,432,W,142,115,27
865,138,433,W,111,95,16
866,137,433,L,95,111,-16
867,521,434,W,124,117,7
868,522,434,L,117,124,-7
869,296,435,W,95,92,3
870,295,435,L,92,95,-3
871,523,436,L,107,112,-5
872,524,436,W,112,107,5
873,356,437,L,101,108,-7
874,355,437,W,108,101,7
875,454,438,W,115,106,9
876,453,438,L,106,115,-9
877,525,439,L,118,119,-1
878,526,439,W,119,118,1
879,527,440,L,97,105,-8
880,528,440,W,105,97,8
881,529,441,L,91,127,-36
882,530,441,W,127,91,36
883,98,442,L,114,117,-3
884,97,442,W,117,114,3
885,531,443,L,107,119,-12
886,532,443,W,119,107,12
887,129,444,W,121,111,10
888,130,444,L,111,121,-10
889,533,445,L,117,125,-8
890,534,445,W,125,117,8
891,535,446,L,103,105,-2
892,536,446,W,105,103,2
893,465,447,L,101,112,-11
894,466,447,W,112,101,11
895,537,448,W,125,119,6
896,538,448,L,119,125,-6
897,136,449,W,98,95,3
898,135,449,L,95,98,-3
899,121,450,L,88,129,-41
900,122,450,W,129,88,41
901,195,451,L,100,116,-16
902,196,451,W,116,100,16
903,453,452,L,118,119,-1
904,454,452,W,119,118,1
905,539,453,L,103,109,-6
906,540,453,W,109,103,6
907,333,454,W,121,107,14
908,334,454,L,107,121,-14
909,541,455,L,111,128,-17
910,542,455,W,128,111,17
911,414,456,L,108,116,-8
912,413,456,W,116,108,8
913,543,457,W,127,120,7
914,544,457,L,120,127,-7
915,318,458,L,110,125,-15
916,317,458,W,125,110,15
917,16,459,L,102,129,-27
918,15,459,W,129,102,27
919,209,460,L,99,127,-28
920,210,460,W,127,99,28
921,545,461,W,120,108,12
922,546,461,L,108,120,-12
923,547,462,L,105,108,-3
924,548,462,W,108,105,3
925,549,463,L,82,96,-14
926,550,463,W,96,82,14
927,386,464,W,125,117,8
928,385,464,L,117,125,-8
929,551,465,L,97,119,-22
930,552,465,W,119,97,22
931,29,466,W,139,134,5
932,30,466,L,134,139,-5
933,553,467,L,109,113,-4
934,554,467,W,113,109,4
935,524,468,W,123,115,8
936,523,468,L,115,123,-8
937,555,469,W,112,100,12
938,556,469,L,100,112,-12
939,312,470,W,112,103,9
940,311,470,L,103,112,-9
941,557,471,L,106,137,-31
942,558,471,W,137,106,31
943,440,472,L,123,128,-5
944,439,472,W,128,123,5
945,559,473,L,102,129,-27
946,560,473,W,129,102,27
947,561,474,L,109,117,-8
948,562,474,W,117,109,8
949,310,475,L,108,129,-21
950,309,475,W,129,108,21
951,160,476,W,129,113,16
952,159,476,L,113,129,-16
953,37,477,L,106,118,-12
954,38,477,W,118,106,12
955,464,478,L,100,123,-23
956,463,478,W,123,100,23
957,244,479,L,107,113,-6
958,243,479,W,113,107,6
959,366,480,L,90,114,-24
960,365,480,W,114,90,24
961,563,481,W,131,112,19
962,564,481,L,112,131,-19
963,115,482,W,102,89,13
964,116,482,L,89,102,-13
965,107,483,W,92,85,7
966,108,483,L,85,92,-7
967,97,484,L,107,124,-17
968,98,484,W,124,107,17
969,144,485,L,95,116,-21
970,143,485,W,116,95,21
971,45,486,W,127,119,8
972,46,486,L,119,127,-8
973,181,487,W,111,107,4
974,182,487,L,107,111,-4
975,233,488,L,111,139,-28
976,234,488,W,139,111,28
977,260,489,L,121,128,-7
978,259,489,W,128,121,7
979,297,490,L,118,133,-15
980,298,490,W,133,118,15
981,565,491,W,105,92,13
982,566,491,L,92,105,-13
983,290,492,W,127,115,12
984,289,492,L,115,127,-12
985,567,493,L,104,119,-15
986,568,493,W,119,104,15
987,569,494,L,107,121,-14
988,570,494,W,121,107,14
989,446,495,L,117,127,-10
990,445,495,W,127,117,10
991,469,496,W,124,103,21
992,470,496,L,103,124,-21
993,135,497,L,100,106,-6
994,136,497,W,106,100,6
995,571,498,W,115,109,6
996,572,498,L,109,115,-6
997,573,499,W,127,106,21
998,574,499,L,106,127,-21
999,158,500,L,120,127,-7
1000,157,500,W,127,120,7
1001,575,501,L,115,125,-10
1002,576,501,W,125,115,10
1003,426,502,W,120,100,20
1004,425,502,L,100,120,-20
1005,73,503,L,112,125,-13
1006,74,503,W,125,112,13
1007,76,504,L,106,115,-9
1008,75,504,W,115,106,9
1009,420,505,W,125,111,14
1010,419,505,L,111,125,-14
1011,118,506,W,133,104,29
1012,117,506,L,104,133,-29
1013,577,507,L,96,104,-8
1014,578,507,W,104,96,8
1015,429,508,L,92,97,-5
1016,430,508,W,97,92,5
1017,176,509,L,131,151,-20
1018,175,509,W,151,131,20
1019,579,510,L,114,130,-16
1020,580,510,W,130,114,16
1021,125,511,W,109,101,8
1022,126,511,L,101,109,-8
1023,324,512,L,104,115,-11
1024,323,512,W,115,104,11
1025,554,513,W,133,129,4
1026,553,513,L,129,133,-4
1027,71,514,W,115,100,15
1028,72,514,L,100,115,-15
1029,116,515,L,92,113,-21
1030,115,515,W,113,92,21
1031,581,516,W,107,97,10
1032,582,516,L,97,107,-10
1033,583,517,L,109,110,-1
1034,584,517,W,110,109,1
1035,461,518,W,126,117,9
1036,462,518,L,117,126,-9
1037,49,519,L,110,117,-7
1038,50,519,W,117,110,7
1039,81,520,W,110,106,4
1040,82,520,L,106,110,-4
1041,585,521,L,109,114,-5
1042,586,521,W,114,109,5
1043,587,522,L,108,123,-15
1044,588,522,W,123,108,15
1045,424,523,L,129,139,-10
1046,423,523,W,139,129,10
1047,326,524,L,133,152,-19
1048,325,524,W,152,133,19
1049,589,525,W,112,97,15
1050,590,525,L,97,112,-15
1051,591,526,L,97,110,-13
1052,592,526,W,110,97,13
1053,368,527,L,91,108,-17
1054,367,527,W,108,91,17
1055,274,528,W,118,106,12
1056,273,528,L,106,118,-12
1057,576,529,W,121,111,10
1058,575,529,L,111,121,-10
1059,593,530,W,113,104,9
1060,594,530,L,104,113,-9
1061,183,531,L,107,112,-5
1062,184,531,W,112,107,5
1063,595,532,W,129,118,11
1064,596,532,L,118,129,-11
1065,597,533,W,98,81,17
1066,598,533,L,81,98,-17
1067,542,534,W,122,117,5
1068,541,534,L,117,122,-5
1069,550,535,W,125,112,13
1070,549,535,L,112,125,-13
1071,599,536,L,111,140,-29
1072,600,536,W,140,111,29
1073,288,537,W,131,124,7
1074,287,537,L,124,131,-7
1075,387,538,W,116,103,13
1076,388,538,L,103,116,-13
1077,14,539,W,118,112,6
1078,13,539,L,112,118,-6
1079,601,540,W,103,99,4
1080,602,540,L,99,103,-4
1081,603,541,W,113,106,7
1082,604,541,L,106,113,-7
1083,196,542,W,109,98,11
1084,195,542,L,98,109,-11
1085,174,543,W,133,125,8
1086,173,543,L,125,133,-8
1087,286,544,W,128,113,15
1088,285,544,L,113,128,-15
1089,472,545,W,124,112,12
1090,471,545,L,112,124,-12
1091,308,546,L,129,134,-5
1092,307,546,W,134,129,5
1093,605,547,L,95,102,-7
1094,606,547,W,102,95,7
1095,211,548,W,112,87,25
1096,212,548,L,87,112,-25
1097,55,549,W,121,117,4
1098,56,549,L,117,121,-4
1099,40,550,L,95,107,-12
1100,39,550,W,107,95,12
1101,23,551,L,95,119,-24
1102,24,551,W,119,95,24
1103,607,552,W,129,96,33
1104,608,552,L,96,129,-33
1105,390,553,L,106,127,-21
1106,389,553,W,127,106,21
1107,50,554,L,105,121,-16
1108,49,554,W,121,105,16
1109,609,555,W,100,92,8
1110,610,555,L,92,100,-8
1111,350,556,L,110,117,-7
1112,349,556,W,117,110,7
1113,36,557,W,120,114,6
1114,35,557,L,114,120,-6
1115,66,558,W,110,107,3
1116,65,558,L,107,110,-3
1117,611,559,L,124,129,-5
1118,612,559,W,129,124,5
1119,580,560,W,122,117,5
1120,579,560,L,117,122,-5
1121,555,561,W,106,83,23
1122,556,561,L,83,106,-23
1123,460,562,W,107,100,7
1124,459,562,L,100,107,-7
1125,234,563,W,126,116,10
1126,233,563,L,116,126,-10
1127,613,564,L,88,118,-30
1128,614,564,W,118,88,30
1129,133,565,W,112,107,5
1130,134,565,L,107,112,-5
1131,528,566,L,113,118,-5
1132,527,566,W,118,113,5
1133,482,567,W,117,111,6
1134,481,567,L,111,117,-6
1135,615,568,L,98,111,-13
1136,616,568,W,111,98,13
1137,617,569,L,100,106,-6
1138,618,569,W,106,100,6
1139,456,570,L,107,139,-32
1140,455,570,W,139,107,32
1141,602,571,W,120,118,2
1142,601,571,L,118,120,-2
1143,29,572,W,106,86,20
1144,30,572,L,86,106,-20
1145,619,573,L,102,107,-5
1146,620,573,W,107,102,5
1147,621,574,W,115,107,8
1148,622,574,L,107,115,-8
1149,623,575,L,95,109,-14
1150,624,575,W,109,95,14
1151,625,576,W,123,119,4
1152,626,576,L,119,123,-4
1153,627,577,L,101,123,-22
1154,628,577,W,123,101,22
1155,254,578,W,133,130,3
1156,253,578,L,130,133,-3
1157,43,579,W,136,103,33
1158,44,579,L,103,136,-33
1159,629,580,L,106,119,-13
1160,630,580,W,119,106,13
1161,83,581,W,90,87,3
1162,84,581,L,87,90,-3
1163,273,582,L,116,118,-2
1164,274,582,W,118,116,2
1165,508,583,W,122,112,10
1166,507,583,L,112,122,-10
1167,130,584,W,124,115,9
1168,129,584,L,115,124,-9
1169,228,585,W,117,97,20
1170,227,585,L,97,117,-20
1171,167,586,W,115,108,7
1172,168,586,L,108,115,-7
1173,173,587,L,112,120,-8
1174,174,587,W,120,112,8
1175,631,588,L,109,113,-4
1176,632,588,W,113,109,4
1177,633,589,W,121,120,1
1178,634,589,L,120,121,-1
1179,635,590,L,114,116,-2
1180,636,590,W,116,114,2
1181,637,591,L,111,140,-29
1182,638,591,W,140,111,29
1183,513,592,L,89,100,-11
1184,514,592,W,100,89,11
1185,639,593,W,121,98,23
1186,640,593,L,98,121,-23
1187,370,594,W,134,131,3
1188,369,594,L,131,134,-3
1189,100,595,L,123,128,-5
1190,99,595,W,128,123,5
1191,263,596,L,132,138,-6
1192,264,596,W,138,132,6
1193,590,597,L,95,122,-27
1194,589,597,W,122,95,27
1195,340,598,L,86,100,-14
1196,339,598,W,100,86,14
1197,221,599,W,127,123,4
1198,222,599,L,123,127,-4
1199,641,600,W,116,103,13
1200,642,600,L,103,116,-13
1201,620,601,L,100,106,-6
1202,619,601,W,106,100,6
1203,10,602,L,106,115,-9
1204,9,602,W,115,106,9
1205,481,603,L,106,117,-11
1206,482,603,W,117,106,11
1207,643,604,W,130,121,9
1208,644,604,L,121,130,-9
1209,636,605,W,104,99,5
1210,635,605,L,99,104,-5
1211,74,606,W,117,107,10
1212,73,606,L,107,117,-10
1213,645,607,W,119,118,1
1214,646,607,L,118,119,-1
1215,647,608,W,118,107,11
1216,648,608,L,107,118,-11
1217,68,609,L,102,128,-26
1218,67,609,W,128,102,26
1219,649,610,L,110,123,-13
1220,650,610,W,123,110,13
1221,518,611,L,103,128,-25
1222,517,611,W,128,103,25
1223,651,612,W,124,97,27
1224,652,612,L,97,124,-27
1225,434,613,L,110,121,-11
1226,433,613,W,121,110,11
1227,653,614,L,101,113,-12
1228,654,614,W,113,101,12
1229,249,615,L,95,101,-6
1230,250,615,W,101,95,6
1231,593,616,W,117,104,13
1232,594,616,L,104,117,-13
1233,655,617,L,112,115,-3
1234,656,617,W,115,112,3
1235,657,618,L,99,128,-29
1236,658,618,W,128,99,29
1237,659,619,W,117,110,7
1238,660,619,L,110,117,-7
1239,246,620,W,114,112,2
1240,245,620,L,112,114,-2
1241,82,621,W,105,104,1
1242,81,621,L,104,105,-1
1243,661,622,L,92,100,-8
1244,662,622,W,100,92,8
1245,410,623,W,127,116,11
1246,409,623,L,116,127,-11
1247,87,624,L,104,114,-10
1248,88,624,W,114,104,10
1249,21,625,L,86,108,-22
1250,22,625,W,108,86,22
1251,663,626,L,102,122,-20
1252,664,626,W,122,102,20
1253,665,627,L,121,124,-3
1254,666,627,W,124,121,3
1255,588,628,L,105,140,-35
1256,587,628,W,140,105,35
1257,287,629,L,109,139,-30
1258,288,629,W,139,109,30
1259,218,630,W,125,110,15
1260,217,630,L,110,125,-15
1261,667,631,L,91,109,-18
1262,668,631,W,109,91,18
1263,320,632,W,111,103,8
1264,319,632,L,103,111,-8
1265,669,633,W,108,99,9
1266,670,633,L,99,108,-9
1267,671,634,W,122,101,21
1268,672,634,L,101,122,-21
1269,673,635,L,92,109,-17
1270,674,635,W,109,92,17
1271,94,636,W,129,114,15
1272,93,636,L,114,129,-15
1273,75,637,W,116,105,11
1274,76,637,L,105,116,-11
1275,396,638,L,113,117,-4
1276,395,638,W,117,113,4
1277,276,639,L,100,109,-9
1278,275,639,W,109,100,9
1279,325,640,L,101,111,-10
1280,326,640,W,111,101,10
1281,109,641,L,121,134,-13
1282,110,641,W,134,121,13
1283,675,642,W,123,111,12
1284,676,642,L,111,123,-12
1285,677,643,L,94,98,-4
1286,678,643,W,98,94,4
1287,510,644,W,127,106,21
1288,509,644,L,106,127,-21
1289,134,645,L,92,113,-21
1290,133,645,W,113,92,21
1291,143,646,L,98,109,-11
1292,144,646,W,109,98,11
1293,679,647,L,102,116,-14
1294,680,647,W,116,102,14
1295,71,648,W,115,112,3
1296,72,648,L,112,115,-3
1297,681,649,W,129,114,15
1298,682,649,L,114,129,-15
1299,267,650,W,107,106,1
1300,268,650,L,106,107,-1
1301,96,651,W,107,98,9
1302,95,651,L,98,107,-9
1303,416,652,W,112,110,2
1304,415,652,L,110,112,-2
1305,58,653,L,89,123,-34
1306,57,653,W,123,89,34
1307,140,654,W,122,108,14
1308,139,654,L,108,122,-14
1309,538,655,L,108,123,-15
1310,537,655,W,123,108,15
1311,348,656,L,104,128,-24
1312,347,656,W,128,104,24
1313,683,657,W,122,115,7
1314,684,657,L,115,122,-7
1315,685,658,L,112,119,-7
1316,686,658,W,119,112,7
1317,687,659,W,111,103,8
1318,688,659,L,103,111,-8
1319,54,660,W,114,103,11
1320,53,660,L,103,114,-11
1321,610,661,L,87,117,-30
1322,609,661,W,117,87,30
1323,689,662,W,101,99,2
1324,690,662,L,99,101,-2
1325,72,663,W,115,113,2
1326,71,663,L,113,115,-2
1327,691,664,L,113,120,-7
1328,692,664,W,120,113,7
1329,263,665,W,128,126,2
1330,264,665,L,126,128,-2
1331,693,666,W,123,115,8
1332,694,666,L,115,123,-8
1333,156,667,L,94,99,-5
1334,155,667,W,99,94,5
1335,436,668,L,98,111,-13
1336,435,668,W,111,98,13
1337,695,669,L,104,126,-22
1338,696,669,W,126,104,22
1339,438,670,W,115,104,11
1340,437,670,L,104,115,-11
1341,380,671,L,110,118,-8
1342,379,671,W,118,110,8
1343,179,672,L,89,101,-12
1344,180,672,W,101,89,12
1345,697,673,L,132,135,-3
1346,698,673,W,135,132,3
1347,586,674,W,121,114,7
1348,585,674,L,114,121,-7
1349,699,675,W,118,103,15
1350,700,675,L,103,118,-15
1351,512,676,L,111,122,-11
1352,511,676,W,122,111,11
1353,701,677,L,99,106,-7
1354,702,677,W,106,99,7
1355,19,678,W,123,120,3
1356,20,678,L,120,123,-3
1357,34,679,W,111,104,7
1358,33,679,L,104,111,-7
1359,141,680,W,121,102,19
1360,142,680,L,102,121,-19
1361,443,681,W,140,114,26
1362,444,681,L,114,140,-26
1363,696,682,L,118,127,-9
1364,695,682,W,127,118,9
1365,540,683,W,121,106,15
1366,539,683,L,106,121,-15
1367,703,684,W,109,96,13
1368,704,684,L,96,109,-13
1369,177,685,W,117,115,2
1370,178,685,L,115,117,-2
1371,705,686,L,114,128,-14
1372,706,686,W,128,114,14
1373,654,687,W,111,104,7
1374,653,687,L,104,111,-7
1375,707,688,L,111,116,-5
1376,708,688,W,116,111,5
1377,352,689,W,122,103,19
1378,351,689,L,103,122,-19
1379,523,690,L,106,109,-3
1380,524,690,W,109,106,3
1381,115,691,L,85,105,-20
1382,116,691,W,105,85,20
1383,151,692,L,108,118,-10
1384,152,692,W,118,108,10
1385,640,693,L,112,120,-8
1386,639,693,W,120,112,8
1387,384,694,L,113,123,-10
1388,383,694,W,123,113,10
1389,709,695,L,111,123,-12
1390,710,695,W,123,111,12
1391,711,696,W,102,98,4
1392,712,696,L,98,102,-4
1393,103,697,W,109,106,3
1394,104,697,L,106,109,-3
1395,713,698,L,84,99,-15
1396,714,698,W,99,84,15
1397,458,699,W,109,103,6
1398,457,699,L,103,109,-6
1399,622,700,W,124,116,8
1400,621,700,L,116,124,-8
1401,408,701,L,123,128,-5
1402,407,701,W,128,123,5
1403,715,702,L,112,126,-14
1404,716,702,W,126,112,14
1405,231,703,L,76,84,-8
1406,232,703,W,84,76,8
1407,57,704,W,122,101,21
1408,58,704,L,101,122,-21
1409,717,705,L,104,106,-2
1410,718,705,W,106,104,2
1411,503,706,L,107,117,-10
1412,504,706,W,117,107,10
1413,719,707,L,93,117,-24
1414,720,707,W,117,93,24
1415,581,708,L,101,106,-5
1416,582,708,W,106,101,5
1417,50,709,L,104,130,-26
1418,49,709,W,130,104,26
1419,721,710,L,113,117,-4
1420,722,710,W,117,113,4
1421,572,711,L,97,117,-20
1422,571,711,W,117,97,20
1423,470,712,W,105,87,18
1424,469,712,L,87,105,-18
1425,723,713,W,109,92,17
1426,724,713,L,92,109,-17
1427,249,714,L,97,115,-18
1428,250,714,W,115,97,18
1429,283,715,W,122,116,6
1430,284,715,L,116,122,-6
1431,307,716,L,105,123,-18
1432,308,716,W,123,105,18
1433,616,717,W,123,102,21
1434,615,717,L,102,123,-21
1435,725,718,L,115,122,-7
1436,726,718,W,122,115,7
1437,322,719,L,81,104,-23
1438,321,719,W,104,81,23
1439,428,720,W,101,93,8
1440,427,720,L,93,101,-8
1441,562,721,L,112,127,-15
1442,561,721,W,127,112,15
1443,93,722,L,95,108,-13
1444,94,722,W,108,95,13
1445,644,723,W,98,97,1
1446,643,723,L,97,98,-1
1447,727,724,L,104,117,-13
1448,728,724,W,117,104,13
1449,32,725,L,115,120,-5
1450,31,725,W,120,115,5
1451,578,726,L,110,119,-9
1452,577,726,W,119,110,9
1453,729,727,W,120,107,13
1454,730,727,L,107,120,-13
1455,557,728,L,116,117,-1
1456,558,728,W,117,116,1
1457,137,729,L,100,111,-11
1458,138,729,W,111,100,11
1459,101,730,L,81,116,-35
1460,102,730,W,116,81,35
1461,279,731,W,107,100,7
1462,280,731,L,100,107,-7
1463,522,732,L,98,120,-22
1464,521,732,W,120,98,22
1465,731,733,L,109,136,-27
1466,732,733,W,136,109,27
1467,132,734,W,113,97,16
1468,131,734,L,97,113,-16
1469,53,735,W,112,110,2
1470,54,735,L,110,112,-2
1471,651,736,W,141,121,20
1472,652,736,L,121,141,-20
1473,46,737,W,128,120,8
1474,45,737,L,120,128,-8
1475,700,738,W,94,88,6
1476,699,738,L,88,94,-6
1477,733,739,L,98,108,-10
1478,734,739,W,108,98,10
1479,85,740,W,104,102,2
1480,86,740,L,102,104,-2
1481,139,741,L,112,113,-1
1482,140,741,W,113,112,1
1483,735,742,W,112,86,26
1484,736,742,L,86,112,-26
1485,354,743,L,117,129,-12
1486,353,743,W,129,117,12
1487,3,744,L,97,98,-1
1488,4,744,W,98,97,1
1489,402,745,L,96,105,-9
1490,401,745,W,105,96,9
1491,618,746,L,102,132,-30
1492,617,746,W,132,102,30
1493,98,747,L,115,121,-6
1494,97,747,W,121,115,6
1495,208,748,W,110,97,13
1496,207,748,L,97,110,-13
1497,553,749,W,105,104,1
1498,554,749,L,104,105,-1
1499,278,750,L,98,102,-4
1500,277,750,W,102,98,4
1501,592,751,W,94,82,12
1502,591,751,L,82,94,-12
1503,466,752,L,109,121,-12
1504,465,752,W,121,109,12
1505,131,753,W,118,102,16
1506,132,753,L,102,118,-16
1507,604,754,W,112,100,12
1508,603,754,L,100,112,-12
1509,119,755,W,111,106,5
1510,120,755,L,106,111,-5
1511,483,756,L,104,116,-12
1512,484,756,W,116,104,12
1513,109,757,W,145,115,30
1514,110,757,L,115,145,-30
1515,475,758,W,102,94,8
1516,476,758,L,94,102,-8
1517,493,759,L,118,121,-3
1518,494,759,W,121,118,3
1519,266,760,W,125,109,16
1520,265,760,L,109,125,-16
1521,280,761,W,121,115,6
1522,279,761,L,115,121,-6
1523,519,762,W,113,111,2
1524,520,762,L,111,113,-2
1525,498,763,L,104,107,-3
1526,497,763,W,107,104,3
1527,737,764,L,95,103,-8
1528,738,764,W,103,95,8
1529,714,765,L,104,113,-9
1530,713,765,W,113,104,9
1531,8,766,W,113,104,9
1532,7,766,L,104,113,-9
1533,454,767,L,115,120,-5
1534,453,767,W,120,115,5
1535,127,768,W,128,104,24
1536,128,768,L,104,128,-24
1537,739,769,L,107,110,-3
1538,740,769,W,110,107,3
1539,148,770,L,112,118,-6
1540,147,770,W,118,112,6
1541,724,771,L,93,119,-26
1542,723,771,W,119,93,26
1543,359,772,L,89,117,-28
1544,360,772,W,117,89,28
1545,669,773,W,119,107,12
1546,670,773,L,107,119,-12
1547,67,774,W,123,102,21
1548,68,774,L,102,123,-21
1549,407,775,L,115,119,-4
1550,408,775,W,119,115,4
1551,674,776,W,114,107,7
1552,673,776,L,107,114,-7
1553,105,777,L,108,125,-17
1554,106,777,W,125,108,17
1555,548,778,W,134,109,25
1556,547,778,L,109,134,-25
1557,529,779,W,139,125,14
1558,530,779,L,125,139,-14
1559,680,780,L,106,113,-7
1560,679,780,W,113,106,7
1561,21,781,L,112,122,-10
1562,22,781,W,122,112,10
1563,459,782,L,100,109,-9
1564,460,782,W,109,100,9
1565,449,783,L,102,106,-4
1566,450,783,W,106,102,4
1567,641,784,L,93,114,-21
1568,642,784,W,114,93,21
1569,666,785,L,114,129,-15
1570,665,785,W,129,114,15
1571,632,786,L,107,114,-7
1572,631,786,W,114,107,7
1573,374,787,L,103,118,-15
1574,373,787,W,118,103,15
1575,668,788,W,117,98,19
1576,667,788,L,98,117,-19
1577,182,789,L,108,126,-18
1578,181,789,W,126,108,18
1579,741,790,L,105,119,-14
1580,742,790,W,119,105,14
1581,637,791,L,118,122,-4
1582,638,791,W,122,118,4
1583,346,792,W,122,117,5
1584,345,792,L,117,122,-5
1585,338,793,L,104,111,-7
1586,337,793,W,111,104,7
1587,743,794,W,111,106,5
1588,744,794,L,106,111,-5
1589,328,795,L,105,118,-13
1590,327,795,W,118,105,13
1591,103,796,L,98,100,-2
1592,104,796,W,100,98,2
1593,558,797,W,108,104,4
1594,557,797,L,104,108,-4
1595,303,798,W,107,99,8
1596,304,798,L,99,107,-8
1597,565,799,W,112,99,13
1598,566,799,L,99,112,-13
1599,611,800,L,112,122,-10
1600,612,800,W,122,112,10
1601,745,801,W,109,103,6
1602,746,801,L,103,109,-6
1603,747,802,L,104,113,-9
1604,748,802,W,113,104,9
1605,208,803,L,122,126,-4
1606,207,803,W,126,122,4
1607,9,804,W,110,109,1
1608,10,804,L,109,110,-1
1609,749,805,W,108,101,7
1610,750,805,L,101,108,-7
1611,751,806,L,102,110,-8
1612,752,806,W,110,102,8
1613,704,807,L,102,109,-7
1614,703,807,W,109,102,7
1615,199,808,L,102,105,-3
1616,200,808,W,105,102,3
1617,272,809,L,120,143,-23
1618,271,809,W,143,120,23
1619,223,810,L,99,120,-21
1620,224,810,W,120,99,21
1621,442,811,L,106,109,-3
1622,441,811,W,109,106,3
1623,284,812,W,111,110,1
1624,283,812,L,110,111,-1
1625,753,813,L,111,118,-7
1626,754,813,W,118,111,7
1627,198,814,W,120,116,4
1628,197,814,L,116,120,-4
1629,618,815,W,133,119,14
1630,617,815,L,119,133,-14
1631,572,816,L,113,133,-20
1632,571,816,W,133,113,20
1633,170,817,L,107,109,-2
1634,169,817,W,109,107,2
1635,482,818,L,89,109,-20
1636,481,818,W,109,89,20
1637,755,819,L,105,111,-6
1638,756,819,W,111,105,6
1639,757,820,W,101,96,5
1640,758,820,L,96,101,-5
1641,154,821,W,130,119,11
1642,153,821,L,119,130,-11
1643,437,822,L,85,107,-22
1644,438,822,W,107,85,22
1645,435,823,W,100,79,21
1646,436,823,L,79,100,-21
1647,142,824,L,102,110,-8
1648,141,824,W,110,102,8
1649,759,825,W,115,107,8
1650,760,825,L,107,115,-8
1651,602,826,W,121,119,2
1652,601,826,L,119,121,-2
1653,516,827,L,111,128,-17
1654,515,827,W,128,111,17
1655,761,828,L,106,109,-3
1656,762,828,W,109,106,3
1657,763,829,L,108,125,-17
1658,764,829,W,125,108,17
1659,418,830,W,122,118,4
1660,417,830,L,118,122,-4
1661,240,831,L,102,110,-8
1662,239,831,W,110,102,8
1663,38,832,W,124,117,7
1664,37,832,L,117,124,-7
1665,487,833,W,83,73,10
1666,488,833,L,73,83,-10
1667,765,834,W,103,101,2
1668,766,834,L,101,103,-2
1669,314,835,W,130,107,23
1670,313,835,L,107,130,-23
1671,161,836,W,127,114,13
1672,162,836,L,114,127,-13
1673,767,837,L,109,116,-7
1674,768,837,W,116,109,7
1675,707,838,W,110,100,10
1676,708,838,L,100,110,-10
1677,123,839,W,113,110,3
1678,124,839,L,110,113,-3
1679,608,840,L,106,114,-8
1680,607,840,W,114,106,8
1681,209,841,L,99,114,-15
1682,210,841,W,114,99,15
1683,769,842,W,122,111,11
1684,770,842,L,111,122,-11
1685,302,843,W,117,109,8
1686,301,843,L,109,117,-8
1687,144,844,W,115,109,6
1688,143,844,L,109,115,-6
1689,771,845,W,124,122,2
1690,772,845,L,122,124,-2
1691,60,846,W,113,108,5
1692,59,846,L,108,113,-5
1693,101,847,L,102,136,-34
1694,102,847,W,136,102,34
1695,773,848,W,116,110,6
1696,774,848,L,110,116,-6
1697,646,849,W,96,87,9
1698,645,849,L,87,96,-9
1699,426,850,L,93,94,-1
1700,425,850,W,94,93,1
1701,775,851,W,112,92,20
1702,776,851,L,92,112,-20
1703,546,852,L,112,127,-15
1704,545,852,W,127,112,15
1705,41,853,L,117,122,-5
1706,42,853,W,122,117,5
1707,586,854,W,115,108,7
1708,585,854,L,108,115,-7
1709,80,855,W,127,116,11
1710,79,855,L,116,127,-11
1711,777,856,L,92,97,-5
1712,778,856,W,97,92,5
1713,720,857,L,87,115,-28
1714,719,857,W,115,87,28
1715,570,858,L,107,114,-7
1716,569,858,W,114,107,7
1717,480,859,L,121,135,-14
1718,479,859,W,135,121,14
1719,354,860,L,88,110,-22
1720,353,860,W,110,88,22
1721,7,861,W,119,118,1
1722,8,861,L,118,119,-1
1723,779,862,L,109,125,-16
1724,780,862,W,125,109,16
1725,660,863,W,105,103,2
1726,659,863,L,103,105,-2
1727,560,864,W,93,92,1
1728,559,864,L,92,93,-1
1729,781,865,W,110,99,11
1730,782,865,L,99,110,-11
1731,137,866,L,101,110,-9
1732,138,866,W,110,101,9
1733,52,867,W,104,90,14
1734,51,867,L,90,104,-14
1735,664,868,W,110,102,8
1736,663,868,L,102,110,-8
1737,630,869,W,108,96,12
1738,629,869,L,96,108,-12
1739,63,870,L,125,142,-17
1740,64,870,W,142,125,17
1741,292,871,W,122,107,15
1742,291,871,L,107,122,-15
1743,39,872,L,104,110,-6
1744,40,872,W,110,104,6
1745,783,873,W,135,119,16
1746,784,873,L,119,135,-16
1747,222,874,W,110,106,4
1748,221,874,L,106,110,-4
1749,785,875,L,102,105,-3
1750,786,875,W,105,102,3
1751,787,876,L,105,110,-5
1752,788,876,W,110,105,5
1753,215,877,L,112,126,-14
1754,216,877,W,126,112,14
1755,108,878,W,104,103,1
1756,107,878,L,103,104,-1
1757,357,879,L,84,130,-46
1758,358,879,W,130,84,46
1759,530,880,L,109,115,-6
1760,529,880,W,115,109,6
1761,70,881,L,94,141,-47
1762,69,881,W,141,94,47
1763,789,882,L,91,119,-28
1764,790,882,W,119,91,28
1765,791,883,L,101,108,-7
1766,792,883,W,108,101,7
1767,308,884,L,103,112,-9
1768,307,884,W,112,103,9
1769,46,885,W,136,113,23
1770,45,885,L,113,136,-23
1771,793,886,L,95,108,-13
1772,794,886,W,108,95,13
1773,61,887,W,100,98,2
1774,62,887,L,98,100,-2
1775,594,888,L,127,139,-12
1776,593,888,W,139,127,12
1777,795,889,W,93,87,6
1778,796,889,L,87,93,-6
1779,261,890,L,104,105,-1
1780,262,890,W,105,104,1
1781,59,891,W,111,104,7
1782,60,891,L,104,111,-7
1783,106,892,L,113,119,-6
1784,105,892,W,119,113,6
1785,797,893,W,119,109,10
1786,798,893,L,109,119,-10
1787,28,894,W,139,132,7
1788,27,894,L,132,139,-7
1789,756,895,W,129,92,37
1790,755,895,L,92,129,-37
1791,382,896,L,114,121,-7
1792,381,896,W,121,114,7
1793,799,897,L,99,106,-7
1794,800,897,W,106,99,7
1795,801,898,W,107,100,7
1796,802,898,L,100,107,-7
1797,803,899,L,91,106,-15
1798,804,899,W,106,91,15
1799,485,900,W,127,103,24
1800,486,900,L,103,127,-24
1801,126,901,L,93,112,-19
1802,125,901,W,112,93,19
1803,678,902,L,114,128,-14
1804,677,902,W,128,114,14
1805,229,903,W,121,96,25
1806,230,903,L,96,121,-25
1807,22,904,W,130,118,12
1808,21,904,L,118,130,-12
1809,315,905,L,116,127,-11
1810,316,905,W,127,116,11
1811,72,906,W,127,94,33
1812,71,906,L,94,127,-33
1813,57,907,W,127,120,7
1814,58,907,L,120,127,-7
1815,232,908,W,121,110,11
1816,231,908,L,110,121,-11
1817,17,909,L,97,117,-20
1818,18,909,W,117,97,20
1819,358,910,W,118,97,21
1820,357,910,L,97,118,-21
1821,169,911,L,133,135,-2
1822,170,911,W,135,133,2
1823,128,912,W,105,96,9
1824,127,912,L,96,105,-9
1825,805,913,L,94,103,-9
1826,806,913,W,103,94,9
1827,598,914,W,113,106,7
1828,597,914,L,106,113,-7
1829,662,915,W,109,104,5
1830,661,915,L,104,109,-5
1831,68,916,L,88,132,-44
1832,67,916,W,132,88,44
1833,807,917,L,79,104,-25
1834,808,917,W,104,79,25
1835,809,918,W,117,104,13
1836,810,918,L,104,117,-13
1837,811,919,W,113,104,9
1838,812,919,L,104,113,-9
1839,6,920,W,107,104,3
1840,5,920,L,104,107,-3
1841,396,921,W,109,106,3
1842,395,921,L,106,109,-3
1843,624,922,L,96,100,-4
1844,623,922,W,100,96,4
1845,732,923,L,98,132,-34
1846,731,923,W,132,98,34
1847,784,924,L,125,150,-25
1848,783,924,W,150,125,25
1849,294,925,L,110,130,-20
1850,293,925,W,130,110,20
1851,93,926,W,114,100,14
1852,94,926,L,100,114,-14
1853,686,927,W,115,107,8
1854,685,927,L,107,115,-8
1855,388,928,L,96,137,-41
1856,387,928,W,137,96,41
1857,684,929,L,111,158,-47
1858,683,929,W,158,111,47
1859,31,930,L,97,100,-3
1860,32,930,W,100,97,3
1861,250,931,L,116,119,-3
1862,249,931,W,119,116,3
1863,505,932,W,110,107,3
1864,506,932,L,107,110,-3
1865,764,933,W,119,110,9
1866,763,933,L,110,119,-9
1867,83,934,W,101,95,6
1868,84,934,L,95,101,-6
1869,813,935,L,103,125,-22
1870,814,935,W,125,103,22
1871,213,936,W,90,83,7
1872,214,936,L,83,90,-7
1873,815,937,L,103,107,-4
1874,816,937,W,107,103,4
1875,92,938,L,107,112,-5
1876,91,938,W,112,107,5
1877,708,939,L,104,105,-1
1878,707,939,W,105,104,1
1879,5,940,L,104,109,-5
1880,6,940,W,109,104,5
1881,500,941,L,105,122,-17
1882,499,941,W,122,105,17
1883,216,942,W,103,94,9
1884,215,942,L,94,103,-9
1885,548,943,L,97,107,-10
1886,547,943,W,107,97,10
1887,117,944,W,120,113,7
1888,118,944,L,113,120,-7
1889,630,945,L,119,136,-17
1890,629,945,W,136,119,17
1891,614,946,L,102,121,-19
1892,613,946,W,121,102,19
1893,258,947,W,140,132,8
1894,257,947,L,132,140,-8
1895,383,948,W,114,110,4
1896,384,948,L,110,114,-4
1897,342,949,L,91,97,-6
1898,341,949,W,97,91,6
1899,795,950,W,116,104,12
1900,796,950,L,104,116,-12
1901,91,951,L,110,121,-11
1902,92,951,W,121,110,11
1903,444,952,W,121,119,2
1904,443,952,L,119,121,-2
1905,506,953,L,101,102,-1
1906,505,953,W,102,101,1
1907,817,954,W,113,101,12
1908,818,954,L,101,113,-12
1909,13,955,L,98,126,-28
1910,14,955,W,126,98,28
1911,62,956,L,90,104,-14
1912,61,956,W,104,90,14
1913,736,957,L,102,111,-9
1914,735,957,W,111,102,9
1915,819,958,L,108,117,-9
1916,820,958,W,117,108,9
1917,706,959,L,104,117,-13
1918,705,959,W,117,104,13
1919,66,960,W,114,99,15
1920,65,960,L,99,114,-15
1921,821,961,W,108,106,2
1922,822,961,L,106,108,-2
1923,823,962,L,118,122,-4
1924,824,962,W,122,118,4
1925,492,963,L,88,103,-15
1926,491,963,W,103,88,15
1927,544,964,W,125,113,12
1928,543,964,L,113,125,-12
1929,40,965,L,96,101,-5
1930,39,965,W,101,96,5
1931,825,966,L,102,103,-1
1932,826,966,W,103,102,1
1933,15,967,W,114,104,10
1934,16,967,L,104,114,-10
1935,810,968,L,114,126,-12
1936,809,968,W,126,114,12
1937,816,969,W,117,94,23
1938,815,969,L,94,117,-23
1939,269,970,L,100,117,-17
1940,270,970,W,117,100,17
1941,827,971,W,100,97,3
1942,828,971,L,97,100,-3
1943,260,972,W,137,123,14
1944,259,972,L,123,137,-14
1945,520,973,L,104,116,-12
1946,519,973,W,116,104,12
1947,591,974,W,103,101,2
1948,592,974,L,101,103,-2
1949,253,975,L,109,134,-25
1950,254,975,W,134,109,25
1951,362,976,W,113,106,7
1952,361,976,L,106,113,-7
1953,580,977,W,119,116,3
1954,579,977,L,116,119,-3
1955,780,978,W,100,98,2
1956,779,978,L,98,100,-2
1957,403,979,W,109,108,1
1958,404,979,L,108,109,-1
1959,558,980,L,86,113,-27
1960,557,980,W,113,86,27
1961,829,981,W,111,104,7
1962,830,981,L,104,111,-7
1963,264,982,L,120,128,-8
1964,263,982,W,128,120,8
1965,488,983,W,116,115,1
1966,487,983,L,115,116,-1
1967,486,984,L,90,104,-14
1968,485,984,W,104,90,14
1969,831,985,L,104,110,-6
1970,832,985,W,110,104,6
1971,225,986,L,106,111,-5
1972,226,986,W,111,106,5
1973,608,987,L,109,113,-4
1974,607,987,W,113,109,4
1975,218,988,W,130,127,3
1976,217,988,L,127,130,-3
1977,788,989,W,116,108,8
1978,787,989,L,108,116,-8
1979,235,990,L,104,115,-11
1980,236,990,W,115,104,11
1981,205,991,L,97,116,-19
1982,206,991,W,116,97,19
1983,44,992,L,103,128,-25
1984,43,992,W,128,103,25
1985,346,993,L,119,122,-3
1986,345,993,W,122,119,3
1987,794,994,L,92,96,-4
1988,793,994,W,96,92,4
1989,569,995,L,118,125,-7
1990,570,995,W,125,118,7
1991,833,996,L,101,143,-42
1992,834,996,W,143,101,42
1993,672,997,L,129,137,-8
1994,671,997,W,137,129,8
1995,27,998,W,124,121,3
1996,28,998,L,121,124,-3
1997,80,999,W,103,95,8
1998,79,999,L,95,103,-8
1999,835,1000,L,132,138,-6
2000,836,1000,W,138,132,6
2001,214,1001,L,97,113,-16
2002,213,1001,W,113,97,16
2003,670,1002,L,89,109,-20
2004,669,1002,W,109,89,20
2005,735,1003,W,135,127,8
2006,736,1003,L,127,135,-8
2007,490,1004,L,104,107,-3
2008,489,1004,W,107,104,3
2009,652,1005,L,94,142,-48
2010,651,1005,W,142,94,48
2011,60,1006,L,91,101,-10
2012,59,1006,W,101,91,10
2013,49,1007,L,95,105,-10
2014,50,1007,W,105,95,10
2015,448,1008,L,100,124,-24
2016,447,1008,W,124,100,24
2017,84,1009,L,104,109,-5
2018,83,1009,W,109,104,5
2019,53,1010,L,116,120,-4
2020,54,1010,W,120,116,4
2021,476,1011,L,104,115,-11
2022,475,1011,W,115,104,11
2023,217,1012,L,107,112,-5
2024,218,1012,W,112,107,5
2025,663,1013,W,114,95,19
2026,664,1013,L,95,114,-19
2027,79,1014,W,112,102,10
2028,80,1014,L,102,112,-10
2029,74,1015,L,108,132,-24
2030,73,1015,W,132,108,24
2031,278,1016,L,110,117,-7
2032,277,1016,W,117,110,7
2033,626,1017,W,99,85,14
2034,625,1017,L,85,99,-14
2035,415,1018,L,96,132,-36
2036,416,1018,W,132,96,36
2037,502,1019,W,115,86,29
2038,501,1019,L,86,115,-29
2039,30,1020,L,105,123,-18
2040,29,1020,W,123,105,18
2041,147,1021,L,88,90,-2
2042,148,1021,W,90,88,2
2043,616,1022,W,115,101,14
2044,615,1022,L,101,115,-14
2045,58,1023,L,121,125,-4
2046,57,1023,W,125,121,4
2047,758,1024,L,101,122,-21
2048,757,1024,W,122,101,21
2049,450,1025,L,100,108,-8
2050,449,1025,W,108,100,8
2051,69,1026,W,114,95,19
2052,70,1026,L,95,114,-19
2053,826,1027,L,99,100,-1
2054,825,1027,W,100,99,1
2055,577,1028,W,131,114,17
2056,578,1028,L,114,131,-17
2057,740,1029,L,102,110,-8
2058,739,1029,W,110,102,8
2059,360,1030,W,102,83,19
2060,359,1030,L,83,102,-19
2061,534,1031,W,121,116,5
2062,533,1031,L,116,121,-5
2063,89,1032,L,94,109,-15
2064,90,1032,W,109,94,15
2065,430,1033,W,103,102,1
2066,429,1033,L,102,103,-1
2067,298,1034,W,117,111,6
2068,297,1034,L,111,117,-6
2069,606,1035,L,101,150,-49
2070,605,1035,W,150,101,49
2071,288,1036,W,125,105,20
2072,287,1036,L,105,125,-20
2073,837,1037,W,137,116,21
2074,838,1037,L,116,137,-21
2075,216,1038,L,106,107,-1
2076,215,1038,W,107,106,1
2077,394,1039,L,109,111,-2
2078,393,1039,W,111,109,2
2079,159,1040,L,97,99,-2
2080,160,1040,W,99,97,2
2081,692,1041,L,119,127,-8
2082,691,1041,W,127,119,8
2083,165,1042,L,102,111,-9
2084,166,1042,W,111,102,9
2085,568,1043,W,105,100,5
2086,567,1043,L,100,105,-5
2087,506,1044,L,106,109,-3
2088,505,1044,W,109,106,3
2089,786,1045,L,93,101,-8
2090,785,1045,W,101,93,8
2091,839,1046,L,103,106,-3
2092,840,1046,W,106,103,3
2093,447,1047,W,108,97,11
2094,448,1047,L,97,108,-11
2095,650,1048,L,112,128,-16
2096,649,1048,W,128,112,16
2097,615,1049,L,115,124,-9
2098,616,1049,W,124,115,9
2099,254,1050,L,127,132,-5
2100,253,1050,W,132,127,5
2101,818,1051,L,114,129,-15
2102,817,1051,W,129,114,15
2103,690,1052,W,114,106,8
2104,689,1052,L,106,114,-8
2105,345,1053,L,93,102,-9
2106,346,1053,W,102,93,9
2107,155,1054,L,133,140,-7
2108,156,1054,W,140,133,7
2109,3,1055,L,97,112,-15
2110,4,1055,W,112,97,15
2111,728,1056,W,119,117,2
2112,727,1056,L,117,119,-2
2113,422,1057,L,94,120,-26
2114,421,1057,W,120,94,26
2115,648,1058,L,114,119,-5
2116,647,1058,W,119,114,5
2117,802,1059,L,85,111,-26
2118,801,1059,W,111,85,26
2119,504,1060,W,123,115,8
2120,503,1060,L,115,123,-8
2121,316,1061,L,99,107,-8
2122,315,1061,W,107,99,8
2123,400,1062,L,102,120,-18
2124,399,1062,W,120,102,18
2125,694,1063,W,125,121,4
2126,693,1063,L,121,125,-4
2127,841,1064,L,108,117,-9
2128,842,1064,W,117,108,9
2129,70,1065,L,97,98,-1
2130,69,1065,W,98,97,1
2131,746,1066,L,106,116,-10
2132,745,1066,W,116,106,10
2133,562,1067,W,122,116,6
2134,561,1067,L,116,122,-6
2135,607,1068,W,122,108,14
2136,608,1068,L,108,122,-14
2137,112,1069,W,120,114,6
2138,111,1069,L,114,120,-6
2139,110,1070,W,113,109,4
2140,109,1070,L,109,113,-4
2141,776,1071,L,88,98,-10
2142,775,1071,W,98,88,10
2143,226,1072,W,109,102,7
2144,225,1072,L,102,109,-7
2145,843,1073,L,106,114,-8
2146,844,1073,W,114,106,8
2147,30,1074,W,108,87,21
2148,29,1074,L,87,108,-21
2149,412,1075,W,121,119,2
2150,411,1075,L,119,121,-2
2151,398,1076,L,113,124,-11
2152,397,1076,W,124,113,11
2153,460,1077,W,100,98,2
2154,459,1077,L,98,100,-2
2155,252,1078,W,113,104,9
2156,251,1078,L,104,113,-9
2157,552,1079,L,112,138,-26
2158,551,1079,W,138,112,26
2159,682,1080,W,135,115,20
2160,681,1080,L,115,135,-20
2161,845,1081,W,117,94,23
2162,846,1081,L,94,117,-23
2163,847,1082,W,115,110,5
2164,848,1082,L,110,115,-5
2165,828,1083,L,108,114,-6
2166,827,1083,W,114,108,6
2167,334,1084,W,138,122,16
2168,333,1084,L,122,138,-16
2169,840,1085,W,106,102,4
2170,839,1085,L,102,106,-4
2171,778,1086,L,97,100,-3
2172,777,1086,W,100,97,3
2173,471,1087,W,113,100,13
2174,472,1087,L,100,113,-13
2175,282,1088,L,86,118,-32
2176,281,1088,W,118,86,32
2177,114,1089,W,122,104,18
2178,113,1089,L,104,122,-18
2179,713,1090,L,119,125,-6
2180,714,1090,W,125,119,6
2181,164,1091,W,119,115,4
2182,163,1091,L,115,119,-4
2183,849,1092,W,121,109,12
2184,850,1092,L,109,121,-12
2185,792,1093,L,106,112,-6
2186,791,1093,W,112,106,6
2187,824,1094,L,100,103,-3
2188,823,1094,W,103,100,3
2189,124,1095,L,80,95,-15
2190,123,1095,W,95,80,15
2191,458,1096,L,112,121,-9
2192,457,1096,W,121,112,9
2193,202,1097,W,124,108,16
2194,201,1097,L,108,124,-16
2195,723,1098,W,108,87,21
2196,724,1098,L,87,108,-21
2197,17,1099,L,101,107,-6
2198,18,1099,W,107,101,6
2199,790,1100,W,129,124,5
2200,789,1100,L,124,129,-5
2201,296,1101,L,102,122,-20
2202,295,1101,W,122,102,20
2203,685,1102,L,121,137,-16
2204,686,1102,W,137,121,16
2205,484,1103,L,112,129,-17
2206,483,1103,W,129,112,17
2207,102,1104,W,113,93,20
2208,101,1104,L,93,113,-20
2209,474,1105,L,106,107,-1
2210,473,1105,W,107,106,1
2211,806,1106,L,104,106,-2
2212,805,1106,W,106,104,2
2213,238,1107,L,106,121,-15
2214,237,1107,W,121,106,15
2215,306,1108,L,120,124,-4
2216,305,1108,W,124,120,4
2217,35,1109,L,94,102,-8
2218,36,1109,W,102,94,8
2219,438,1110,L,120,122,-2
2220,437,1110,W,122,120,2
2221,353,1111,W,119,113,6
2222,354,1111,L,113,119,-6
2223,255,1112,L,89,109,-20
2224,256,1112,W,109,89,20
2225,634,1113,L,100,108,-8
2226,633,1113,W,108,100,8
2227,851,1114,W,118,112,6
2228,852,1114,L,112,118,-6
2229,750,1115,L,125,135,-10
2230,749,1115,W,135,125,10
2231,434,1116,W,107,100,7
2232,433,1116,L,100,107,-7
2233,612,1117,L,118,127,-9
2234,611,1117,W,127,118,9
2235,172,1118,L,109,114,-5
2236,171,1118,W,114,109,5
2237,617,1119,L,99,115,-16
2238,618,1119,W,115,99,16
2239,718,1120,W,134,106,28
2240,717,1120,L,106,134,-28
2241,15,1121,W,103,96,7
2242,16,1121,L,96,103,-7
2243,729,1122,L,94,105,-11
2244,730,1122,W,105,94,11
2245,834,1123,W,131,111,20
2246,833,1123,L,111,131,-20
2247,820,1124,L,100,129,-29
2248,819,1124,W,129,100,29
2249,766,1125,W,113,92,21
2250,765,1125,L,92,113,-21
2251,76,1126,L,95,108,-13
2252,75,1126,W,108,95,13
2253,838,1127,W,131,109,22
2254,837,1127,L,109,131,-22
2255,185,1128,L,105,115,-10
2256,186,1128,W,115,105,10
2257,804,1129,W,93,87,6
2258,803,1129,L,87,93,-6
2259,585,1130,W,114,105,9
2260,586,1130,L,105,114,-9
2261,191,1131,W,129,128,1
2262,192,1131,L,128,129,-1
2263,748,1132,W,91,87,4
2264,747,1132,L,87,91,-4
2265,5,1133,L,104,115,-11
2266,6,1133,W,115,104,11
2267,576,1134,L,109,113,-4
2268,575,1134,W,113,109,4
2269,734,1135,L,116,123,-7
2270,733,1135,W,123,116,7
2271,670,1136,L,106,112,-6
2272,669,1136,W,112,106,6
2273,722,1137,W,127,110,17
2274,721,1137,L,110,127,-17
2275,11,1138,L,95,102,-7
2276,12,1138,W,102,95,7
2277,94,1139,W,119,110,9
2278,93,1139,L,110,119,-9
2279,628,1140,L,101,102,-1
2280,627,1140,W,102,101,1
2281,812,1141,L,102,104,-2
2282,811,1141,W,104,102,2
2283,138,1142,W,123,91,32
2284,137,1142,L,91,123,-32
2285,603,1143,L,107,122,-15
2286,604,1143,W,122,107,15
2287,547,1144,L,97,103,-6
2288,548,1144,W,103,97,6
2289,479,1145,W,106,97,9
2290,480,1145,L,97,106,-9
2291,853,1146,L,95,117,-22
2292,854,1146,W,117,95,22
2293,536,1147,L,83,95,-12
2294,535,1147,W,95,83,12
2295,629,1148,W,102,99,3
2296,630,1148,L,99,102,-3
2297,274,1149,L,111,117,-6
2298,273,1149,W,117,111,6
2299,99,1150,L,105,116,-11
2300,100,1150,W,116,105,11
2301,855,1151,W,159,158,1
2302,856,1151,L,158,159,-1
2303,730,1152,L,96,110,-14
2304,729,1152,W,110,96,14
2305,752,1153,W,118,111,7
2306,751,1153,L,111,118,-7
2307,502,1154,W,118,108,10
2308,501,1154,L,108,118,-10
2309,566,1155,L,113,125,-12
2310,565,1155,W,125,113,12
2311,402,1156,W,121,110,11
2312,401,1156,L,110,121,-11
2313,404,1157,L,91,120,-29
2314,403,1157,W,120,91,29
2315,268,1158,W,109,106,3
2316,267,1158,L,106,109,-3
2317,480,1159,L,97,112,-15
2318,479,1159,W,112,97,15
2319,446,1160,W,105,103,2
2320,445,1160,L,103,105,-2
2321,399,1161,L,98,105,-7
2322,400,1161,W,105,98,7
2323,763,1162,L,112,129,-17
2324,764,1162,W,129,112,17
2325,133,1163,L,112,116,-4
2326,134,1163,W,116,112,4
2327,534,1164,L,110,113,-3
2328,533,1164,W,113,110,3
2329,214,1165,L,95,104,-9
2330,213,1165,W,104,95,9
2331,791,1166,L,94,96,-2
2332,792,1166,W,96,94,2
2333,857,1167,L,96,111,-15
2334,858,1167,W,111,96,15
2335,31,1168,W,101,94,7
2336,32,1168,L,94,101,-7
2337,450,1169,W,134,123,11
2338,449,1169,L,123,134,-11
2339,2,1170,W,96,95,1
2340,1,1170,L,95,96,-1
2341,48,1171,L,133,134,-1
2342,47,1171,W,134,133,1
2343,828,1172,L,92,120,-28
2344,827,1172,W,120,92,28
2345,173,1173,W,121,119,2
2346,174,1173,L,119,121,-2
2347,432,1174,L,109,116,-7
2348,431,1174,W,116,109,7
2349,859,1175,L,101,120,-19
2350,860,1175,W,120,101,19
2351,12,1176,L,99,110,-11
2352,11,1176,W,110,99,11
2353,811,1177,W,118,95,23
2354,812,1177,L,95,118,-23
2355,627,1178,L,81,113,-32
2356,628,1178,W,113,81,32
2357,561,1179,L,123,126,-3
2358,562,1179,W,126,123,3
2359,560,1180,W,108,84,24
2360,559,1180,L,84,108,-24
2361,427,1181,L,99,103,-4
2362,428,1181,W,103,99,4
2363,266,1182,W,117,111,6
2364,265,1182,L,111,117,-6
2365,836,1183,L,122,124,-2
2366,835,1183,W,124,122,2
2367,26,1184,W,131,126,5
2368,25,1184,L,126,131,-5
2369,224,1185,L,122,130,-8
2370,223,1185,W,130,122,8
2371,800,1186,W,110,102,8
2372,799,1186,L,102,110,-8
2373,520,1187,L,107,108,-1
2374,519,1187,W,108,107,1
2375,187,1188,W,97,85,12
2376,188,1188,L,85,97,-12
2377,316,1189,W,122,112,10
2378,315,1189,L,112,122,-10
2379,592,1190,L,109,113,-4
2380,591,1190,W,113,109,4
2381,230,1191,L,86,95,-9
2382,229,1191,W,95,86,9
2383,358,1192,W,123,116,7
2384,357,1192,L,116,123,-7
2385,132,1193,L,106,112,-6
2386,131,1193,W,112,106,6
2387,496,1194,W,121,99,22
2388,495,1194,L,99,121,-22
2389,241,1195,W,117,111,6
2390,242,1195,L,111,117,-6
2391,275,1196,W,141,122,19
2392,276,1196,L,122,141,-19
2393,44,1197,W,117,100,17
2394,43,1197,L,100,117,-17
2395,796,1198,L,85,94,-9
2396,795,1198,W,94,85,9
2397,54,1199,L,95,124,-29
2398,53,1199,W,124,95,29
2399,830,1200,L,111,120,-9
2400,829,1200,W,120,111,9
2401,143,1201,L,93,107,-14
2402,144,1201,W,107,93,14
2403,526,1202,L,100,108,-8
2404,525,1202,W,108,100,8
2405,726,1203,W,127,126,1
2406,725,1203,L,126,127,-1
2407,754,1204,L,101,120,-19
2408,753,1204,W,120,101,19
2409,488,1205,L,125,126,-1
2410,487,1205,W,126,125,1
2411,792,1206,W,119,110,9
2412,791,1206,L,110,119,-9
2413,52,1207,L,95,100,-5
2414,51,1207,W,100,95,5
2415,210,1208,W,108,100,8
2416,209,1208,L,100,108,-8
2417,113,1209,L,122,130,-8
2418,114,1209,W,130,122,8
2419,120,1210,L,102,112,-10
2420,119,1210,W,112,102,10
2421,343,1211,W,114,110,4
2422,344,1211,L,110,114,-4
2423,344,1212,W,106,105,1
2424,343,1212,L,105,106,-1
2425,343,1213,W,105,92,13
2426,344,1213,L,92,105,-13
2427,343,1214,W,123,109,14
2428,344,1214,L,109,123,-14
2429,344,1215,W,109,104,5
2430,343,1215,L,104,109,-5
2431,344,1216,L,109,118,-9
2432,343,1216,W,118,109,9
2433,186,1217,L,94,100,-6
2434,185,1217,W,100,94,6
2435,185,1218,W,105,99,6
2436,186,1218,L,99,105,-6
2437,186,1219,L,102,120,-18
2438,185,1219,W,120,102,18
2439,611,1220,W,119,117,2
2440,612,1220,L,117,119,-2
2441,186,1221,L,112,118,-6
2442,185,1221,W,118,112,6
2443,611,1222,W,110,99,11
2444,612,1222,L,99,110,-11
2445,185,1223,L,103,125,-22
2446,186,1223,W,125,103,22
2447,612,1224,L,111,114,-3
2448,611,1224,W,114,111,3
2449,185,1225,L,100,108,-8
2450,186,1225,W,108,100,8
2451,612,1226,L,94,116,-22
2452,611,1226,W,116,94,22
2453,40,1227,L,90,92,-2
2454,39,1227,W,92,90,2
2455,209,1228,W,100,96,4
2456,210,1228,L,96,100,-4
2457,484,1229,W,118,113,5
2458,483,1229,L,113,118,-5
2459,39,1230,L,101,112,-11
2460,40,1230,W,112,101,11
2461,210,1231,L,108,119,-11
2462,209,1231,W,119,108,11
2463,483,1232,L,99,104,-5
2464,484,1232,W,104,99,5
2465,100,1233,L,91,116,-25
2466,99,1233,W,116,91,25
2467,40,1234,L,89,125,-36
2468,39,1234,W,125,89,36
2469,209,1235,L,98,124,-26
2470,210,1235,W,124,98,26
2471,484,1236,L,108,112,-4
2472,483,1236,W,112,108,4
2473,99,1237,W,113,101,12
2474,100,1237,L,101,113,-12
2475,210,1238,W,116,112,4
2476,209,1238,L,112,116,-4
2477,39,1239,W,101,96,5
2478,40,1239,L,96,101,-5
2479,484,1240,L,121,126,-5
2480,483,1240,W,126,121,5
2481,99,1241,W,123,116,7
2482,100,1241,L,116,123,-7
2483,210,1242,L,137,140,-3
2484,209,1242,W,140,137,3
2485,39,1243,L,95,116,-21
2486,40,1243,W,116,95,21
2487,209,1244,W,97,90,7
2488,210,1244,L,90,97,-7
2489,100,1245,L,102,123,-21
2490,99,1245,W,123,102,21
2491,483,1246,L,109,115,-6
2492,484,1246,W,115,109,6
2493,209,1247,L,113,121,-8
2494,210,1247,W,121,113,8
2495,40,1248,W,94,89,5
2496,39,1248,L,89,94,-5
2497,100,1249,W,112,90,22
2498,99,1249,L,90,112,-22
2499,483,1250,L,100,104,-4
2500,484,1250,W,104,100,4
2501,40,1251,L,95,108,-13
2502,39,1251,W,108,95,13
2503,220,1252,L,86,90,-4
2504,219,1252,W,90,86,4
2505,276,1253,W,129,110,19
2506,275,1253,L,110,129,-19
2507,219,1254,L,103,120,-17
2508,220,1254,W,120,103,17
2509,462,1255,L,93,100,-7
2510,461,1255,W,100,93,7
2511,275,1256,W,129,121,8
2512,276,1256,L,121,129,-8
2513,630,1257,L,115,118,-3
2514,629,1257,W,118,115,3
2515,481,1258,L,100,122,-22
2516,482,1258,W,122,100,22
2517,214,1259,L,96,115,-19
2518,213,1259,W,115,96,19
2519,220,1260,L,90,108,-18
2520,219,1260,W,108,90,18
2521,485,1261,W,127,104,23
2522,486,1261,L,104,127,-23
2523,461,1262,L,91,107,-16
2524,462,1262,W,107,91,16
2525,629,1263,W,111,98,13
2526,630,1263,L,98,111,-13
2527,276,1264,W,113,105,8
2528,275,1264,L,105,113,-8
2529,213,1265,W,107,85,22
2530,214,1265,L,85,107,-22
2531,41,1266,W,110,106,4
2532,42,1266,L,106,110,-4
2533,485,1267,W,119,103,16
2534,486,1267,L,103,119,-16
2535,482,1268,W,112,108,4
2536,481,1268,L,108,112,-4
2537,219,1269,W,117,103,14
2538,220,1269,L,103,117,-14
2539,461,1270,W,104,101,3
2540,462,1270,L,101,104,-3
2541,41,1271,W,104,96,8
2542,42,1271,L,96,104,-8
2543,629,1272,L,108,120,-12
2544,630,1272,W,120,108,12
2545,213,1273,W,98,93,5
2546,214,1273,L,93,98,-5
2547,219,1274,L,108,118,-10
2548,220,1274,W,118,108,10
2549,276,1275,W,132,105,27
2550,275,1275,L,105,132,-27
2551,482,1276,W,131,115,16
2552,481,1276,L,115,131,-16
2553,42,1277,L,91,99,-8
2554,41,1277,W,99,91,8
2555,462,1278,L,98,118,-20
2556,461,1278,W,118,98,20
2557,486,1279,L,99,120,-21
2558,485,1279,W,120,99,21
2559,214,1280,L,82,111,-29
2560,213,1280,W,111,82,29
2561,220,1281,L,105,114,-9
2562,219,1281,W,114,105,9
2563,630,1282,L,94,114,-20
2564,629,1282,W,114,94,20
2565,481,1283,L,123,145,-22
2566,482,1283,W,145,123,22
2567,275,1284,W,135,131,4
2568,276,1284,L,131,135,-4
2569,42,1285,L,74,84,-10
2570,41,1285,W,84,74,10
2571,486,1286,L,86,121,-35
2572,485,1286,W,121,86,35
2573,462,1287,L,90,122,-32
2574,461,1287,W,122,90,32
2575,630,1288,L,99,104,-5
2576,629,1288,W,104,99,5
2577,275,1289,L,104,121,-17
2578,276,1289,W,121,104,17
2579,214,1290,W,104,101,3
2580,213,1290,L,101,104,-3
2581,481,1291,W,111,102,9
2582,482,1291,L,102,111,-9
2583,220,1292,W,101,96,5
2584,219,1292,L,96,101,-5
2585,277,1293,L,94,105,-11
2586,278,1293,W,105,94,11
2587,555,1294,W,122,114,8
2588,556,1294,L,114,122,-8
2589,459,1295,L,95,99,-4
2590,460,1295,W,99,95,4
2591,411,1296,W,127,116,11
2592,412,1296,L,116,127,-11
2593,315,1297,L,131,136,-5
2594,316,1297,W,136,131,5
2595,729,1298,L,137,143,-6
2596,730,1298,W,143,137,6
2597,295,1299,W,115,89,26
2598,296,1299,L,89,115,-26
2599,513,1300,L,109,125,-16
2600,514,1300,W,125,109,16
2601,396,1301,L,94,113,-19
2602,395,1301,W,113,94,19
2603,663,1302,L,117,132,-15
2604,664,1302,W,132,117,15
2605,707,1303,W,135,134,1
2606,708,1303,L,134,135,-1
2607,134,1304,L,111,112,-1
2608,133,1304,W,112,111,1
2609,156,1305,W,116,110,6
2610,155,1305,L,110,116,-6
2611,400,1306,W,96,86,10
2612,399,1306,L,86,96,-10
2613,508,1307,W,120,100,20
2614,507,1307,L,100,120,-20
2615,550,1308,L,93,100,-7
2616,549,1308,W,100,93,7
2617,557,1309,L,99,122,-23
2618,558,1309,W,122,99,23
2619,118,1310,L,109,120,-11
2620,117,1310,W,120,109,11
2621,450,1311,W,112,103,9
2622,449,1311,L,103,112,-9
2623,45,1312,W,104,101,3
2624,46,1312,L,101,104,-3
2625,103,1313,W,124,97,27
2626,104,1313,L,97,124,-27
2627,136,1314,L,108,118,-10
2628,135,1314,W,118,108,10
2629,195,1315,W,116,108,8
2630,196,1315,L,108,116,-8
2631,210,1316,L,108,115,-7
2632,209,1316,W,115,108,7
2633,230,1317,L,109,113,-4
2634,229,1317,W,113,109,4
2635,530,1318,L,113,149,-36
2636,529,1318,W,149,113,36
2637,736,1319,L,107,115,-8
2638,735,1319,W,115,107,8
2639,334,1320,W,129,127,2
2640,333,1320,L,127,129,-2
2641,232,1321,L,109,117,-8
2642,231,1321,W,117,109,8
2643,275,1322,L,104,131,-27
2644,276,1322,W,131,104,27
2645,501,1323,W,108,96,12
2646,502,1323,L,96,108,-12
2647,593,1324,W,132,126,6
2648,594,1324,L,126,132,-6
2649,177,1325,W,133,129,4
2650,178,1325,L,129,133,-4
2651,301,1326,W,112,90,22
2652,302,1326,L,90,112,-22
2653,505,1327,W,104,91,13
2654,506,1327,L,91,104,-13
2655,280,1328,L,110,113,-3
2656,279,1328,W,113,110,3
2657,227,1329,W,133,128,5
2658,228,1329,L,128,133,-5
2659,514,1330,W,116,96,20
2660,513,1330,L,96,116,-20
2661,120,1331,W,122,117,5
2662,119,1331,L,117,122,-5
2663,835,1332,W,129,112,17
2664,836,1332,L,112,129,-17
2665,209,1333,L,110,119,-9
2666,210,1333,W,119,110,9
2667,41,1334,W,117,97,20
2668,42,1334,L,97,117,-20
2669,416,1335,L,111,113,-2
2670,415,1335,W,113,111,2
2671,27,1336,L,126,133,-7
2672,28,1336,W,133,126,7
2673,428,1337,L,113,149,-36
2674,427,1337,W,149,113,36
2675,564,1338,L,114,120,-6
2676,563,1338,W,120,114,6
2677,432,1339,L,109,111,-2
2678,431,1339,W,111,109,2
2679,627,1340,L,98,119,-21
2680,628,1340,W,119,98,21
2681,333,1341,W,122,112,10
2682,334,1341,L,112,122,-10
2683,372,1342,L,96,120,-24
2684,371,1342,W,120,96,24
2685,356,1343,L,110,123,-13
2686,355,1343,W,123,110,13
2687,422,1344,W,108,90,18
2688,421,1344,L,90,108,-18
2689,466,1345,W,128,122,6
2690,465,1345,L,122,128,-6
2691,861,1346,L,104,117,-13
2692,862,1346,W,117,104,13
2693,125,1347,W,112,102,10
2694,126,1347,L,102,112,-10
2695,141,1348,W,115,105,10
2696,142,1348,L,105,115,-10
2697,2,1349,W,118,97,21
2698,1,1349,L,97,118,-21
2699,848,1350,W,115,109,6
2700,847,1350,L,109,115,-6
2701,536,1351,L,100,114,-14
2702,535,1351,W,114,100,14
2703,220,1352,L,85,113,-28
2704,219,1352,W,113,85,28
2705,446,1353,L,122,130,-8
2706,445,1353,W,130,122,8
2707,791,1354,W,108,89,19
2708,792,1354,L,89,108,-19
2709,9,1355,W,115,114,1
2710,10,1355,L,114,115,-1
2711,382,1356,W,110,108,2
2712,381,1356,L,108,110,-2
2713,346,1357,W,135,103,32
2714,345,1357,L,103,135,-32
2715,145,1358,L,89,116,-27
2716,146,1358,W,116,89,27
2717,218,1359,L,103,119,-16
2718,217,1359,W,119,103,16
2719,633,1360,L,111,117,-6
2720,634,1360,W,117,111,6
2721,370,1361,L,102,116,-14
2722,369,1361,W,116,102,14
2723,8,1362,W,130,105,25
2724,7,1362,L,105,130,-25
2725,126,1363,L,105,110,-5
2726,125,1363,W,110,105,5
2727,399,1364,L,105,113,-8
2728,400,1364,W,113,105,8
2729,667,1365,L,102,122,-20
2730,668,1365,W,122,102,20
2731,863,1366,L,113,122,-9
2732,864,1366,W,122,113,9
2733,228,1367,W,131,121,10
2734,227,1367,L,121,131,-10
2735,673,1368,L,102,111,-9
2736,674,1368,W,111,102,9
2737,792,1369,L,102,111,-9
2738,791,1369,W,111,102,9
2739,214,1370,L,109,121,-12
2740,213,1370,W,121,109,12
2741,679,1371,W,132,122,10
2742,680,1371,L,122,132,-10
2743,804,1372,L,90,137,-47
2744,803,1372,W,137,90,47
2745,581,1373,W,106,103,3
2746,582,1373,L,103,106,-3
2747,261,1374,W,113,106,7
2748,262,1374,L,106,113,-7
2749,443,1375,L,96,113,-17
2750,444,1375,W,113,96,17
2751,735,1376,L,135,136,-1
2752,736,1376,W,136,135,1
2753,383,1377,W,130,102,28
2754,384,1377,L,102,130,-28
2755,706,1378,W,95,90,5
2756,705,1378,L,90,95,-5
2757,665,1379,W,100,92,8
2758,666,1379,L,92,100,-8
2759,452,1380,L,90,99,-9
2760,451,1380,W,99,90,9
2761,225,1381,W,121,116,5
2762,226,1381,L,116,121,-5
2763,560,1382,W,124,101,23
2764,559,1382,L,101,124,-23
2765,586,1383,W,120,115,5
2766,585,1383,L,115,120,-5
2767,92,1384,L,96,110,-14
2768,91,1384,W,110,96,14
2769,518,1385,L,108,132,-24
2770,517,1385,W,132,108,24
2771,854,1386,W,118,109,9
2772,853,1386,L,109,118,-9
2773,7,1387,L,108,119,-11
2774,8,1387,W,119,108,11
2775,859,1388,L,115,129,-14
2776,860,1388,W,129,115,14
2777,713,1389,L,130,131,-1
2778,714,1389,W,131,130,1
2779,397,1390,W,118,98,20
2780,398,1390,L,98,118,-20
2781,42,1391,L,112,114,-2
2782,41,1391,W,114,112,2
2783,409,1392,L,124,128,-4
2784,410,1392,W,128,124,4
2785,239,1393,W,115,105,10
2786,240,1393,L,105,115,-10
2787,481,1394,L,110,123,-13
2788,482,1394,W,123,110,13
2789,50,1395,L,85,112,-27
2790,49,1395,W,112,85,27
2791,14,1396,W,117,92,25
2792,13,1396,L,92,117,-25
2793,302,1397,L,110,116,-6
2794,301,1397,W,116,110,6
2795,492,1398,L,98,115,-17
2796,491,1398,W,115,98,17
2797,417,1399,L,99,105,-6
2798,418,1399,W,105,99,6
2799,789,1400,L,118,128,-10
2800,790,1400,W,128,118,10
2801,178,1401,L,118,121,-3
2802,177,1401,W,121,118,3
2803,801,1402,L,99,107,-8
2804,802,1402,W,107,99,8
2805,663,1403,W,118,103,15
2806,664,1403,L,103,118,-15
2807,816,1404,W,118,98,20
2808,815,1404,L,98,118,-20
2809,258,1405,W,124,121,3
2810,257,1405,L,121,124,-3
2811,229,1406,L,100,115,-15
2812,230,1406,W,115,100,15
2813,353,1407,W,116,106,10
2814,354,1407,L,106,116,-10
2815,559,1408,L,103,112,-9
2816,560,1408,W,112,103,9
2817,222,1409,W,125,121,4
2818,221,1409,L,121,125,-4
2819,813,1410,L,106,124,-18
2820,814,1410,W,124,106,18
2821,365,1411,L,116,125,-9
2822,366,1411,W,125,116,9
2823,116,1412,W,104,99,5
2824,115,1412,L,99,104,-5
2825,38,1413,W,122,111,11
2826,37,1413,L,111,122,-11
2827,865,1414,W,130,120,10
2828,866,1414,L,120,130,-10
2829,439,1415,L,92,95,-3
2830,440,1415,W,95,92,3
2831,242,1416,L,94,108,-14
2832,241,1416,W,108,94,14
2833,3,1417,L,98,119,-21
2834,4,1417,W,119,98,21
2835,207,1418,L,103,115,-12
2836,208,1418,W,115,103,12
2837,1,1419,L,92,125,-33
2838,2,1419,W,125,92,33
2839,164,1420,L,144,148,-4
2840,163,1420,W,148,144,4
2841,681,1421,W,115,96,19
2842,682,1421,L,96,115,-19
2843,159,1422,L,106,111,-5
2844,160,1422,W,111,106,5
2845,698,1423,W,124,113,11
2846,697,1423,L,113,124,-11
2847,763,1424,L,105,127,-22
2848,764,1424,W,127,105,22
2849,415,1425,W,115,114,1
2850,416,1425,L,114,115,-1
2851,34,1426,L,114,121,-7
2852,33,1426,W,121,114,7
2853,622,1427,L,88,124,-36
2854,621,1427,W,124,88,36
2855,562,1428,W,113,90,23
2856,561,1428,L,90,113,-23
2857,446,1429,L,127,129,-2
2858,445,1429,W,129,127,2
2859,685,1430,W,112,99,13
2860,686,1430,L,99,112,-13
2861,651,1431,W,126,91,35
2862,652,1431,L,91,126,-35
2863,307,1432,W,113,108,5
2864,308,1432,L,108,113,-5
2865,451,1433,L,112,117,-5
2866,452,1433,W,117,112,5
2867,711,1434,W,114,83,31
2868,712,1434,L,83,114,-31
2869,723,1435,L,117,124,-7
2870,724,1435,W,124,117,7
2871,53,1436,L,103,112,-9
2872,54,1436,W,112,103,9
2873,285,1437,W,111,106,5
2874,286,1437,L,106,111,-5
2875,517,1438,W,110,108,2
2876,518,1438,L,108,110,-2
2877,756,1439,W,111,93,18
2878,755,1439,L,93,111,-18
2879,170,1440,L,105,111,-6
2880,169,1440,W,111,105,6
2881,282,1441,L,119,123,-4
2882,281,1441,W,123,119,4
2883,644,1442,W,116,109,7
2884,643,1442,L,109,116,-7
2885,26,1443,L,87,116,-29
2886,25,1443,W,116,87,29
2887,221,1444,L,100,116,-16
2888,222,1444,W,116,100,16
2889,705,1445,W,113,108,5
2890,706,1445,L,108,113,-5
2891,413,1446,W,118,98,20
2892,414,1446,L,98,118,-20
2893,595,1447,L,89,112,-23
2894,596,1447,W,112,89,23
2895,743,1448,L,114,117,-3
2896,744,1448,W,117,114,3
2897,496,1449,L,106,113,-7
2898,495,1449,W,113,106,7
2899,174,1450,L,118,126,-8
2900,173,1450,W,126,118,8
2901,764,1451,L,102,107,-5
2902,763,1451,W,107,102,5
2903,153,1452,L,96,119,-23
2904,154,1452,W,119,96,23
2905,143,1453,L,115,118,-3
2906,144,1453,W,118,115,3
2907,10,1454,L,120,126,-6
2908,9,1454,W,126,120,6
2909,643,1455,W,123,114,9
2910,644,1455,L,114,123,-9
2911,434,1456,L,125,126,-1
2912,433,1456,W,126,125,1
2913,619,1457,W,110,105,5
2914,620,1457,L,105,110,-5
2915,347,1458,W,137,116,21
2916,348,1458,L,116,137,-21
2917,206,1459,W,123,121,2
2918,205,1459,L,121,123,-2
2919,683,1460,W,121,105,16
2920,684,1460,L,105,121,-16
2921,713,1461,W,117,107,10
2922,714,1461,L,107,117,-10
2923,782,1462,L,109,115,-6
2924,781,1462,W,115,109,6
2925,844,1463,W,118,114,4
2926,843,1463,L,114,118,-4
2927,338,1464,L,101,115,-14
2928,337,1464,W,115,101,14
2929,424,1465,L,98,106,-8
2930,423,1465,W,106,98,8
2931,410,1466,W,116,95,21
2932,409,1466,L,95,116,-21
2933,72,1467,L,119,126,-7
2934,71,1467,W,126,119,7
2935,721,1468,L,105,111,-6
2936,722,1468,W,111,105,6
2937,793,1469,W,114,105,9
2938,794,1469,L,105,114,-9
2939,13,1470,L,92,128,-36
2940,14,1470,W,128,92,36
2941,468,1471,W,116,101,15
2942,467,1471,L,101,116,-15
2943,167,1472,W,116,107,9
2944,168,1472,L,107,116,-9
2945,357,1473,W,129,125,4
2946,358,1473,L,125,129,-4
2947,287,1474,L,102,117,-15
2948,288,1474,W,117,102,15
2949,269,1475,L,75,93,-18
2950,270,1475,W,93,75,18
2951,428,1476,L,91,101,-10
2952,427,1476,W,101,91,10
2953,598,1477,L,102,129,-27
2954,597,1477,W,129,102,27
2955,609,1478,L,123,124,-1
2956,610,1478,W,124,123,1
2957,193,1479,L,116,119,-3
2958,194,1479,W,119,116,3
2959,465,1480,W,130,125,5
2960,466,1480,L,125,130,-5
2961,565,1481,L,107,110,-3
2962,566,1481,W,110,107,3
2963,648,1482,L,98,114,-16
2964,647,1482,W,114,98,16
2965,828,1483,W,110,88,22
2966,827,1483,L,88,110,-22
2967,28,1484,W,138,136,2
2968,27,1484,L,136,138,-2
2969,523,1485,L,120,129,-9
2970,524,1485,W,129,120,9
2971,534,1486,L,103,108,-5
2972,533,1486,W,108,103,5
2973,515,1487,L,128,135,-7
2974,516,1487,W,135,128,7
2975,621,1488,L,100,102,-2
2976,622,1488,W,102,100,2
2977,833,1489,L,116,121,-5
2978,834,1489,W,121,116,5
2979,476,1490,W,122,110,12
2980,475,1490,L,110,122,-12
2981,762,1491,L,121,128,-7
2982,761,1491,W,128,121,7
2983,569,1492,W,116,110,6
2984,570,1492,L,110,116,-6
2985,342,1493,L,114,123,-9
2986,341,1493,W,123,114,9
2987,830,1494,L,83,109,-26
2988,829,1494,W,109,83,26
2989,702,1495,L,97,111,-14
2990,701,1495,W,111,97,14
2991,530,1496,L,102,108,-6
2992,529,1496,W,108,102,6
2993,25,1497,W,113,98,15
2994,26,1497,L,98,113,-15
2995,251,1498,L,98,111,-13
2996,252,1498,W,111,98,13
2997,268,1499,L,99,100,-1
2998,267,1499,W,100,99,1
2999,79,1500,L,100,120,-20
3000,80,1500,W,120,100,20
3001,802,1501,L,106,108,-2
3002,801,1501,W,108,106,2
3003,825,1502,L,120,126,-6
3004,826,1502,W,126,120,6
3005,796,1503,L,91,120,-29
3006,795,1503,W,120,91,29
3007,78,1504,L,111,132,-21
3008,77,1504,W,132,111,21
3009,841,1505,L,74,108,-34
3010,842,1505,W,108,74,34
3011,688,1506,L,96,108,-12
3012,687,1506,W,108,96,12
3013,484,1507,W,106,104,2
3014,483,1507,L,104,106,-2
3015,57,1508,L,90,100,-10
3016,58,1508,W,100,90,10
3017,2,1509,W,114,97,17
3018,1,1509,L,97,114,-17
3019,459,1510,L,107,133,-26
3020,460,1510,W,133,107,26
3021,278,1511,W,112,105,7
3022,277,1511,L,105,112,-7
3023,107,1512,L,98,103,-5
3024,108,1512,W,103,98,5
3025,545,1513,W,130,113,17
3026,546,1513,L,113,130,-17
3027,17,1514,W,125,104,21
3028,18,1514,L,104,125,-21
3029,851,1515,W,123,107,16
3030,852,1515,L,107,123,-16
3031,70,1516,L,99,106,-7
3032,69,1516,W,106,99,7
3033,362,1517,L,115,121,-6
3034,361,1517,W,121,115,6
3035,571,1518,L,101,126,-25
3036,572,1518,W,126,101,25
3037,52,1519,W,98,89,9
3038,51,1519,L,89,98,-9
3039,575,1520,L,75,103,-28
3040,576,1520,W,103,75,28
3041,318,1521,L,106,118,-12
3042,317,1521,W,118,106,12
3043,490,1522,L,115,140,-25
3044,489,1522,W,140,115,25
3045,866,1523,L,116,128,-12
3046,865,1523,W,128,116,12
3047,669,1524,L,108,131,-23
3048,670,1524,W,131,108,23
3049,867,1525,L,92,103,-11
3050,868,1525,W,103,92,11
3051,281,1526,L,97,105,-8
3052,282,1526,W,105,97,8
3053,402,1527,W,115,111,4
3054,401,1527,L,111,115,-4
3055,250,1528,L,89,106,-17
3056,249,1528,W,106,89,17
3057,231,1529,W,125,104,21
3058,232,1529,L,104,125,-21
3059,259,1530,W,94,93,1
3060,260,1530,L,93,94,-1
3061,695,1531,L,114,121,-7
3062,696,1531,W,121,114,7
3063,283,1532,L,120,127,-7
3064,284,1532,W,127,120,7
3065,455,1533,W,120,107,13
3066,456,1533,L,107,120,-13
3067,837,1534,L,130,135,-5
3068,838,1534,W,135,130,5
3069,766,1535,W,102,94,8
3070,765,1535,L,94,102,-8
3071,22,1536,W,114,112,2
3072,21,1536,L,112,114,-2
3073,388,1537,L,114,131,-17
3074,387,1537,W,131,114,17
3075,114,1538,W,127,104,23
3076,113,1538,L,104,127,-23
3077,473,1539,L,106,111,-5
3078,474,1539,W,111,106,5
3079,570,1540,L,111,112,-1
3080,569,1540,W,112,111,1
3081,670,1541,W,112,104,8
3082,669,1541,L,104,112,-8
3083,151,1542,L,91,107,-16
3084,152,1542,W,107,91,16
3085,147,1543,L,110,118,-8
3086,148,1543,W,118,110,8
3087,216,1544,L,104,114,-10
3088,215,1544,W,114,104,10
3089,448,1545,L,110,126,-16
3090,447,1545,W,126,110,16
3091,370,1546,L,105,122,-17
3092,369,1546,W,122,105,17
3093,630,1547,W,129,121,8
3094,629,1547,L,121,129,-8
3095,359,1548,L,98,117,-19
3096,360,1548,W,117,98,19
3097,514,1549,L,107,108,-1
3098,513,1549,W,108,107,1
3099,127,1550,W,115,99,16
3100,128,1550,L,99,115,-16
3101,826,1551,W,111,109,2
3102,825,1551,L,109,111,-2
3103,640,1552,L,96,107,-11
3104,639,1552,W,107,96,11
3105,525,1553,L,123,132,-9
3106,526,1553,W,132,123,9
3107,822,1554,L,107,113,-6
3108,821,1554,W,113,107,6
3109,112,1555,L,114,131,-17
3110,111,1555,W,131,114,17
3111,270,1556,W,91,84,7
3112,269,1556,L,84,91,-7
3113,634,1557,W,111,104,7
3114,633,1557,L,104,111,-7
3115,263,1558,W,114,104,10
3116,264,1558,L,104,114,-10
3117,76,1559,L,96,105,-9
3118,75,1559,W,105,96,9
3119,593,1560,L,120,131,-11
3120,594,1560,W,131,120,11
3121,146,1561,L,111,120,-9
3122,145,1561,W,120,111,9
3123,4,1562,L,106,114,-8
3124,3,1562,W,114,106,8
3125,568,1563,W,128,95,33
3126,567,1563,L,95,128,-33
3127,797,1564,W,107,95,12
3128,798,1564,L,95,107,-12
3129,264,1565,W,115,112,3
3130,263,1565,L,112,115,-3
3131,480,1566,L,113,114,-1
3132,479,1566,W,114,113,1
3133,765,1567,L,108,115,-7
3134,766,1567,W,115,108,7
3135,309,1568,L,105,114,-9
3136,310,1568,W,114,105,9
3137,119,1569,W,113,105,8
3138,120,1569,L,105,113,-8
3139,219,1570,L,103,104,-1
3140,220,1570,W,104,103,1
3141,710,1571,L,88,127,-39
3142,709,1571,W,127,88,39
3143,405,1572,W,115,104,11
3144,406,1572,L,104,115,-11
3145,656,1573,W,118,108,10
3146,655,1573,L,108,118,-10
3147,795,1574,L,93,107,-14
3148,796,1574,W,107,93,14
3149,101,1575,W,123,118,5
3150,102,1575,L,118,123,-5
3151,697,1576,L,107,128,-21
3152,698,1576,W,128,107,21
3153,208,1577,L,95,99,-4
3154,207,1577,W,99,95,4
3155,838,1578,L,121,135,-14
3156,837,1578,W,135,121,14
3157,565,1579,L,107,112,-5
3158,566,1579,W,112,107,5
3159,333,1580,W,111,81,30
3160,334,1580,L,81,111,-30
3161,458,1581,L,102,116,-14
3162,457,1581,W,116,102,14
3163,395,1582,L,88,117,-29
3164,396,1582,W,117,88,29
3165,504,1583,L,109,118,-9
3166,503,1583,W,118,109,9
3167,72,1584,W,129,93,36
3168,71,1584,L,93,129,-36
3169,324,1585,W,120,117,3
3170,323,1585,L,117,120,-3
3171,824,1586,L,111,115,-4
3172,823,1586,W,115,111,4
3173,225,1587,W,117,112,5
3174,226,1587,L,112,117,-5
3175,604,1588,W,120,112,8
3176,603,1588,L,112,120,-8
3177,470,1589,W,116,109,7
3178,469,1589,L,109,116,-7
3179,27,1590,W,130,116,14
3180,28,1590,L,116,130,-14
3181,60,1591,W,123,112,11
3182,59,1591,L,112,123,-11
3183,689,1592,L,117,119,-2
3184,690,1592,W,119,117,2
3185,337,1593,W,131,120,11
3186,338,1593,L,120,131,-11
3187,155,1594,L,96,107,-11
3188,156,1594,W,107,96,11
3189,102,1595,W,168,161,7
3190,101,1595,L,161,168,-7
3191,135,1596,W,111,104,7
3192,136,1596,L,104,111,-7
3193,30,1597,W,125,118,7
3194,29,1597,L,118,125,-7
3195,624,1598,L,96,103,-7
3196,623,1598,W,103,96,7
3197,692,1599,W,108,104,4
3198,691,1599,L,104,108,-4
3199,819,1600,L,118,121,-3
3200,820,1600,W,121,118,3
3201,635,1601,L,115,122,-7
3202,636,1601,W,122,115,7
3203,510,1602,W,141,140,1
3204,509,1602,L,140,141,-1
3205,544,1603,L,123,131,-8
3206,543,1603,W,131,123,8
3207,247,1604,W,97,92,5
3208,248,1604,L,92,97,-5
3209,317,1605,W,118,113,5
3210,318,1605,L,113,118,-5
3211,730,1606,L,105,111,-6
3212,729,1606,W,111,105,6
3213,311,1607,L,101,110,-9
3214,312,1607,W,110,101,9
3215,500,1608,L,125,126,-1
3216,499,1608,W,126,125,1
3217,731,1609,L,93,105,-12
3218,732,1609,W,105,93,12
3219,384,1610,L,119,125,-6
3220,383,1610,W,125,119,6
3221,800,1611,W,109,107,2
3222,799,1611,L,107,109,-2
3223,243,1612,W,125,116,9
3224,244,1612,L,116,125,-9
3225,131,1613,L,95,118,-23
3226,132,1613,W,118,95,23
3227,240,1614,L,112,121,-9
3228,239,1614,W,121,112,9
3229,535,1615,L,103,108,-5
3230,536,1615,W,108,103,5
3231,65,1616,L,112,121,-9
3232,66,1616,W,121,112,9
3233,684,1617,L,111,119,-8
3234,683,1617,W,119,111,8
3235,403,1618,L,105,110,-5
3236,404,1618,W,110,105,5
3237,201,1619,W,124,121,3
3238,202,1619,L,121,124,-3
3239,327,1620,L,85,101,-16
3240,328,1620,W,101,85,16
3241,831,1621,W,123,110,13
3242,832,1621,L,110,123,-13
3243,791,1622,L,109,113,-4
3244,792,1622,W,113,109,4
3245,803,1623,W,121,110,11
3246,804,1623,L,110,121,-11
3247,554,1624,L,105,112,-7
3248,553,1624,W,112,105,7
3249,616,1625,W,117,106,11
3250,615,1625,L,106,117,-11
3251,768,1626,W,111,110,1
3252,767,1626,L,110,111,-1
3253,829,1627,L,118,130,-12
3254,830,1627,W,130,118,12
3255,214,1628,W,113,98,15
3256,213,1628,L,98,113,-15
3257,87,1629,L,96,123,-27
3258,88,1629,W,123,96,27
3259,632,1630,L,107,112,-5
3260,631,1630,W,112,107,5
3261,841,1631,W,119,96,23
3262,842,1631,L,96,119,-23
3263,654,1632,L,116,126,-10
3264,653,1632,W,126,116,10
3265,192,1633,W,130,115,15
3266,191,1633,L,115,130,-15
3267,425,1634,W,119,116,3
3268,426,1634,L,116,119,-3
3269,483,1635,W,118,112,6
3270,484,1635,L,112,118,-6
3271,59,1636,W,117,115,2
3272,60,1636,L,115,117,-2
3273,237,1637,W,119,112,7
3274,238,1637,L,112,119,-7
3275,383,1638,L,115,128,-13
3276,384,1638,W,128,115,13
3277,649,1639,L,112,120,-8
3278,650,1639,W,120,112,8
3279,717,1640,L,128,140,-12
3280,718,1640,W,140,128,12
3281,183,1641,L,109,125,-16
3282,184,1641,W,125,109,16
3283,444,1642,W,112,106,6
3284,443,1642,L,106,112,-6
3285,82,1643,L,117,120,-3
3286,81,1643,W,120,117,3
3287,51,1644,L,147,148,-1
3288,52,1644,W,148,147,1
3289,570,1645,L,110,123,-13
3290,569,1645,W,123,110,13
3291,267,1646,W,114,104,10
3292,268,1646,L,104,114,-10
3293,521,1647,L,111,126,-15
3294,522,1647,W,126,111,15
3295,43,1648,W,125,122,3
3296,44,1648,L,122,125,-3
3297,737,1649,W,110,109,1
3298,738,1649,L,109,110,-1
3299,868,1650,W,115,104,11
3300,867,1650,L,104,115,-11
3301,100,1651,L,97,98,-1
3302,99,1651,W,98,97,1
3303,864,1652,L,98,111,-13
3304,863,1652,W,111,98,13
3305,129,1653,L,106,111,-5
3306,130,1653,W,111,106,5
3307,163,1654,W,113,99,14
3308,164,1654,L,99,113,-14
3309,558,1655,L,102,106,-4
3310,557,1655,W,106,102,4
3311,435,1656,L,123,125,-2
3312,436,1656,W,125,123,2
3313,6,1657,L,122,131,-9
3314,5,1657,W,131,122,9
3315,556,1658,L,89,127,-38
3316,555,1658,W,127,89,38
3317,271,1659,W,106,91,15
3318,272,1659,L,91,106,-15
3319,83,1660,W,126,111,15
3320,84,1660,L,111,126,-15
3321,821,1661,W,148,139,9
3322,822,1661,L,139,148,-9
3323,418,1662,W,112,101,11
3324,417,1662,L,101,112,-11
3325,288,1663,L,111,121,-10
3326,287,1663,W,121,111,10
3327,360,1664,W,106,97,9
3328,359,1664,L,97,106,-9
3329,799,1665,L,110,122,-12
3330,800,1665,W,122,110,12
3331,611,1666,L,107,129,-22
3332,612,1666,W,129,107,22
3333,32,1667,L,118,120,-2
3334,31,1667,W,120,118,2
3335,641,1668,L,110,118,-8
3336,642,1668,W,118,110,8
3337,223,1669,L,107,134,-27
3338,224,1669,W,134,107,27
3339,637,1670,L,120,129,-9
3340,638,1670,W,129,120,9
3341,109,1671,W,108,107,1
3342,110,1671,L,107,108,-1
3343,143,1672,W,112,109,3
3344,144,1672,L,109,112,-3
3345,757,1673,L,113,117,-4
3346,758,1673,W,117,113,4
3347,154,1674,W,118,88,30
3348,153,1674,L,88,118,-30
3349,607,1675,L,108,115,-7
3350,608,1675,W,115,108,7
3351,616,1676,W,112,99,13
3352,615,1676,L,99,112,-13
3353,437,1677,L,90,99,-9
3354,438,1677,W,99,90,9
3355,260,1678,L,104,120,-16
3356,259,1678,W,120,104,16
3357,142,1679,L,125,127,-2
3358,141,1679,W,127,125,2
3359,29,1680,L,104,107,-3
3360,30,1680,W,107,104,3
3361,629,1681,L,111,120,-9
3362,630,1681,W,120,111,9
3363,255,1682,L,87,103,-16
3364,256,1682,W,103,87,16
3365,618,1683,L,112,121,-9
3366,617,1683,W,121,112,9
3367,38,1684,L,120,130,-10
3368,37,1684,W,130,120,10
3369,499,1685,L,118,120,-2
3370,500,1685,W,120,118,2
3371,53,1686,L,104,117,-13
3372,54,1686,W,117,104,13
3373,173,1687,L,101,102,-1
3374,174,1687,W,102,101,1
3375,427,1688,W,124,108,16
3376,428,1688,L,108,124,-16
3377,368,1689,L,120,143,-23
3378,367,1689,W,143,120,23
3379,157,1690,L,105,125,-20
3380,158,1690,W,125,105,20
3381,137,1691,W,103,83,20
3382,138,1691,L,83,103,-20
3383,234,1692,L,90,99,-9
3384,233,1692,W,99,90,9
3385,291,1693,W,129,120,9
3386,292,1693,L,120,129,-9
3387,14,1694,W,104,99,5
3388,13,1694,L,99,104,-5
3389,489,1695,W,123,112,11
3390,490,1695,L,112,123,-11
3391,133,1696,W,117,112,5
3392,134,1696,L,112,117,-5
3393,11,1697,L,90,105,-15
3394,12,1697,W,105,90,15
3395,10,1698,W,134,125,9
3396,9,1698,L,125,134,-9
3397,304,1699,L,117,122,-5
3398,303,1699,W,122,117,5
3399,297,1700,W,125,106,19
3400,298,1700,L,106,125,-19
3401,296,1701,L,103,120,-17
3402,295,1701,W,120,103,17
3403,401,1702,W,117,107,10
3404,402,1702,L,107,117,-10
3405,197,1703,W,122,107,15
3406,198,1703,L,107,122,-15
3407,777,1704,L,110,117,-7
3408,778,1704,W,117,110,7
3409,527,1705,L,96,102,-6
3410,528,1705,W,102,96,6
3411,471,1706,L,106,119,-13
3412,472,1706,W,119,106,13
3413,208,1707,L,95,117,-22
3414,207,1707,W,117,95,22
3415,580,1708,W,119,101,18
3416,579,1708,L,101,119,-18
3417,456,1709,W,129,128,1
3418,455,1709,L,128,129,-1
3419,533,1710,L,118,127,-9
3420,534,1710,W,127,118,9
3421,332,1711,L,112,122,-10
3422,331,1711,W,122,112,10
3423,781,1712,L,92,116,-24
3424,782,1712,W,116,92,24
3425,19,1713,L,93,99,-6
3426,20,1713,W,99,93,6
3427,1,1714,L,88,116,-28
3428,2,1714,W,116,88,28
3429,785,1715,L,130,135,-5
3430,786,1715,W,135,130,5
3431,176,1716,L,129,148,-19
3432,175,1716,W,148,129,19
3433,537,1717,W,125,120,5
3434,538,1717,L,120,125,-5
3435,8,1718,W,127,101,26
3436,7,1718,L,101,127,-26
3437,722,1719,L,102,141,-39
3438,721,1719,W,141,102,39
3439,685,1720,L,106,108,-2
3440,686,1720,W,108,106,2
3441,511,1721,W,118,108,10
3442,512,1721,L,108,118,-10
3443,39,1722,W,119,107,12
3444,40,1722,L,107,119,-12
3445,35,1723,L,122,132,-10
3446,36,1723,W,132,122,10
3447,353,1724,W,103,96,7
3448,354,1724,L,96,103,-7
3449,199,1725,L,94,136,-42
3450,200,1725,W,136,94,42
3451,858,1726,W,117,115,2
3452,857,1726,L,115,117,-2
3453,295,1727,W,105,92,13
3454,296,1727,L,92,105,-13
3455,262,1728,L,112,127,-15
3456,261,1728,W,127,112,15
3457,325,1729,W,137,129,8
3458,326,1729,L,129,137,-8
3459,228,1730,W,113,94,19
3460,227,1730,L,94,113,-19
3461,440,1731,L,103,129,-26
3462,439,1731,W,129,103,26
3463,529,1732,W,118,110,8
3464,530,1732,L,110,118,-8
3465,522,1733,W,109,107,2
3466,521,1733,L,107,109,-2
3467,299,1734,L,129,134,-5
3468,300,1734,W,134,129,5
3469,573,1735,W,96,84,12
3470,574,1735,L,84,96,-12
3471,775,1736,L,103,121,-18
3472,776,1736,W,121,103,18
3473,834,1737,W,111,98,13
3474,833,1737,L,98,111,-13
3475,650,1738,W,118,112,6
3476,649,1738,L,112,118,-6
3477,461,1739,W,125,98,27
3478,462,1739,L,98,125,-27
3479,488,1740,L,118,125,-7
3480,487,1740,W,125,118,7
3481,716,1741,W,111,101,10
3482,715,1741,L,101,111,-10
3483,56,1742,L,108,113,-5
3484,55,1742,W,113,108,5
3485,175,1743,W,131,115,16
3486,176,1743,L,115,131,-16
3487,139,1744,W,95,88,7
3488,140,1744,L,88,95,-7
3489,460,1745,W,107,106,1
3490,459,1745,L,106,107,-1
3491,179,1746,L,89,102,-13
3492,180,1746,W,102,89,13
3493,341,1747,L,108,115,-7
3494,342,1747,W,115,108,7
3495,421,1748,L,101,115,-14
3496,422,1748,W,115,101,14
3497,49,1749,L,122,136,-14
3498,50,1749,W,136,122,14
3499,744,1750,L,112,128,-16
3500,743,1750,W,128,112,16
3501,811,1751,W,113,99,14
3502,812,1751,L,99,113,-14
3503,728,1752,L,92,100,-8
3504,727,1752,W,100,92,8
3505,168,1753,W,118,102,16
3506,167,1753,L,102,118,-16
3507,226,1754,L,100,107,-7
3508,225,1754,W,107,100,7
3509,328,1755,L,114,117,-3
3510,327,1755,W,117,114,3
3511,323,1756,W,113,104,9
3512,324,1756,L,104,113,-9
3513,186,1757,W,105,92,13
3514,185,1757,L,92,105,-13
3515,769,1758,L,89,93,-4
3516,770,1758,W,93,89,4
3517,120,1759,W,123,120,3
3518,119,1759,L,120,123,-3
3519,839,1760,W,114,90,24
3520,840,1760,L,90,114,-24
3521,237,1761,L,89,107,-18
3522,238,1761,W,107,89,18
3523,787,1762,W,105,89,16
3524,788,1762,L,89,105,-16
3525,686,1763,L,97,99,-2
3526,685,1763,W,99,97,2
3527,97,1764,L,105,132,-27
3528,98,1764,W,132,105,27
3529,603,1765,W,105,99,6
3530,604,1765,L,99,105,-6
3531,724,1766,L,94,126,-32
3532,723,1766,W,126,94,32
3533,850,1767,L,113,135,-22
3534,849,1767,W,135,113,22
3535,485,1768,W,115,105,10
3536,486,1768,L,105,115,-10
3537,367,1769,W,121,105,16
3538,368,1769,L,105,121,-16
3539,561,1770,W,121,116,5
3540,562,1770,L,116,121,-5
3541,472,1771,L,113,116,-3
3542,471,1771,W,116,113,3
3543,601,1772,L,124,126,-2
3544,602,1772,W,126,124,2
3545,297,1773,L,117,122,-5
3546,298,1773,W,122,117,5
3547,36,1774,W,126,117,9
3548,35,1774,L,117,126,-9
3549,91,1775,L,104,112,-8
3550,92,1775,W,112,104,8
3551,577,1776,W,95,92,3
3552,578,1776,L,92,95,-3
3553,429,1777,L,92,101,-9
3554,430,1777,W,101,92,9
3555,596,1778,W,132,100,32
3556,595,1778,L,100,132,-32
3557,606,1779,W,123,118,5
3558,605,1779,L,118,123,-5
3559,80,1780,W,125,111,14
3560,79,1780,L,111,125,-14
3561,665,1781,W,106,97,9
3562,666,1781,L,97,106,-9
3563,503,1782,L,102,116,-14
3564,504,1782,W,116,102,14
3565,469,1783,L,108,122,-14
3566,470,1783,W,122,108,14
3567,313,1784,L,98,103,-5
3568,314,1784,W,103,98,5
3569,740,1785,W,123,120,3
3570,739,1785,L,120,123,-3
3571,273,1786,W,104,101,3
3572,274,1786,L,101,104,-3
3573,412,1787,L,112,118,-6
3574,411,1787,W,118,112,6
3575,836,1788,L,119,132,-13
3576,835,1788,W,132,119,13
3577,778,1789,L,110,126,-16
3578,777,1789,W,126,110,16
3579,398,1790,L,111,120,-9
3580,397,1790,W,120,111,9
3581,567,1791,W,115,111,4
3582,568,1791,L,111,115,-4
3583,55,1792,W,126,114,12
3584,56,1792,L,114,126,-12
3585,809,1793,L,103,106,-3
3586,810,1793,W,106,103,3
3587,592,1794,L,99,109,-10
3588,591,1794,W,109,99,10
3589,520,1795,L,95,132,-37
3590,519,1795,W,132,95,37
3591,447,1796,W,100,94,6
3592,448,1796,L,94,100,-6
3593,407,1797,W,99,96,3
3594,408,1797,L,96,99,-3
3595,79,1798,L,102,106,-4
3596,80,1798,W,106,102,4
3597,761,1799,W,106,101,5
3598,762,1799,L,101,106,-5
3599,58,1800,W,95,91,4
3600,57,1800,L,91,95,-4
3601,798,1801,L,119,121,-2
3602,797,1801,W,121,119,2
3603,770,1802,L,101,106,-5
3604,769,1802,W,106,101,5
3605,388,1803,L,99,108,-9
3606,387,1803,W,108,99,9
3607,5,1804,L,116,122,-6
3608,6,1804,W,122,116,6
3609,386,1805,W,126,118,8
3610,385,1805,L,118,126,-8
3611,284,1806,W,120,106,14
3612,283,1806,L,106,120,-14
3613,63,1807,W,120,105,15
3614,64,1807,L,105,120,-15
3615,371,1808,W,114,110,4
3616,372,1808,L,110,114,-4
3617,235,1809,L,120,122,-2
3618,236,1809,W,122,120,2
3619,354,1810,L,103,123,-20
3620,353,1810,W,123,103,20
3621,136,1811,L,108,114,-6
3622,135,1811,W,114,108,6
3623,660,1812,W,98,94,4
3624,659,1812,L,94,98,-4
3625,454,1813,L,106,110,-4
3626,453,1813,W,110,106,4
3627,542,1814,W,111,99,12
3628,541,1814,L,99,111,-12
3629,727,1815,W,118,107,11
3630,728,1815,L,107,118,-11
3631,180,1816,L,110,114,-4
3632,179,1816,W,114,110,4
3633,101,1817,W,121,101,20
3634,102,1817,L,101,121,-20
3635,66,1818,L,98,106,-8
3636,65,1818,W,106,98,8
3637,629,1819,L,114,123,-9
3638,630,1819,W,123,114,9
3639,779,1820,W,118,91,27
3640,780,1820,L,91,118,-27
3641,306,1821,L,105,120,-15
3642,305,1821,W,120,105,15
3643,205,1822,L,94,123,-29
3644,206,1822,W,123,94,29
3645,274,1823,W,104,88,16
3646,273,1823,L,88,104,-16
3647,98,1824,W,109,104,5
3648,97,1824,L,104,109,-5
3649,152,1825,L,93,121,-28
3650,151,1825,W,121,93,28
3651,422,1826,W,130,111,19
3652,421,1826,L,111,130,-19
3653,617,1827,L,87,101,-14
3654,618,1827,W,101,87,14
3655,198,1828,L,106,116,-10
3656,197,1828,W,116,106,10
3657,234,1829,W,105,85,20
3658,233,1829,L,85,105,-20
3659,427,1830,W,122,103,19
3660,428,1830,L,103,122,-19
3661,126,1831,L,99,107,-8
3662,125,1831,W,107,99,8
3663,329,1832,W,127,109,18
3664,330,1832,L,109,127,-18
3665,437,1833,L,95,120,-25
3666,438,1833,W,120,95,25
3667,780,1834,L,114,116,-2
3668,779,1834,W,116,114,2
3669,548,1835,W,103,95,8
3670,547,1835,L,95,103,-8
3671,524,1836,W,113,105,8
3672,523,1836,L,105,113,-8
3673,189,1837,L,90,119,-29
3674,190,1837,W,119,90,29
3675,138,1838,W,118,108,10
3676,137,1838,L,108,118,-10
3677,390,1839,W,103,101,2
3678,389,1839,L,101,103,-2
3679,320,1840,L,102,124,-22
3680,319,1840,W,124,102,22
3681,662,1841,L,115,135,-20
3682,661,1841,W,135,115,20
3683,130,1842,L,134,138,-4
3684,129,1842,W,138,134,4
3685,788,1843,W,117,103,14
3686,787,1843,L,103,117,-14
3687,691,1844,W,117,115,2
3688,692,1844,L,115,117,-2
3689,312,1845,L,99,111,-12
3690,311,1845,W,111,99,12
3691,276,1846,W,112,94,18
3692,275,1846,L,94,112,-18
3693,842,1847,L,93,98,-5
3694,841,1847,W,98,93,5
3695,475,1848,L,112,128,-16
3696,476,1848,W,128,112,16
3697,376,1849,L,99,115,-16
3698,375,1849,W,115,99,16
3699,818,1850,W,116,113,3
3700,817,1850,L,113,116,-3
3701,179,1851,W,117,115,2
3702,180,1851,L,115,117,-2
3703,23,1852,L,116,122,-6
3704,24,1852,W,122,116,6
3705,249,1853,W,120,96,24
3706,250,1853,L,96,120,-24
3707,364,1854,L,109,111,-2
3708,363,1854,W,111,109,2
3709,751,1855,L,95,114,-19
3710,752,1855,W,114,95,19
3711,218,1856,W,138,128,10
3712,217,1856,L,128,138,-10
3713,279,1857,L,100,101,-1
3714,280,1857,W,101,100,1
3715,869,1858,L,105,135,-30
3716,870,1858,W,135,105,30
3717,132,1859,L,108,117,-9
3718,131,1859,W,117,108,9
3719,733,1860,W,145,142,3
3720,734,1860,L,142,145,-3
3721,832,1861,L,112,129,-17
3722,831,1861,W,129,112,17
3723,161,1862,W,111,101,10
3724,162,1862,L,101,111,-10
3725,492,1863,L,115,120,-5
3726,491,1863,W,120,115,5
3727,449,1864,L,140,147,-7
3728,450,1864,W,147,140,7
3729,729,1865,W,129,109,20
3730,730,1865,L,109,129,-20
3731,278,1866,W,105,101,4
3732,277,1866,L,101,105,-4
3733,852,1867,L,100,107,-7
3734,851,1867,W,107,100,7
3735,212,1868,L,97,131,-34
3736,211,1868,W,131,97,34
3737,853,1869,L,107,149,-42
3738,854,1869,W,149,107,42
3739,600,1870,L,126,142,-16
3740,599,1870,W,142,126,16
3741,26,1871,L,86,124,-38
3742,25,1871,W,124,86,38
3743,369,1872,W,142,111,31
3744,370,1872,L,111,142,-31
3745,433,1873,L,94,112,-18
3746,434,1873,W,112,94,18
3747,253,1874,W,121,117,4
3748,254,1874,L,117,121,-4
3749,366,1875,W,108,93,15
3750,365,1875,L,93,108,-15
3751,92,1876,L,102,109,-7
3752,91,1876,W,109,102,7
3753,322,1877,L,94,100,-6
3754,321,1877,W,100,94,6
3755,316,1878,L,107,115,-8
3756,315,1878,W,115,107,8
3757,638,1879,W,140,138,2
3758,637,1879,L,138,140,-2
3759,735,1880,W,133,114,19
3760,736,1880,L,114,133,-19
3761,209,1881,L,113,116,-3
3762,210,1881,W,116,113,3
3763,657,1882,W,101,95,6
3764,658,1882,L,95,101,-6
3765,83,1883,W,108,105,3
3766,84,1883,L,105,108,-3
3767,652,1884,W,119,114,5
3768,651,1884,L,114,119,-5
3769,314,1885,L,109,116,-7
3770,313,1885,W,116,109,7
3771,712,1886,L,102,110,-8
3772,711,1886,W,110,102,8
3773,715,1887,W,109,104,5
3774,716,1887,L,104,109,-5
3775,303,1888,L,106,110,-4
3776,304,1888,W,110,106,4
3777,519,1889,L,93,102,-9
3778,520,1889,W,102,93,9
3779,457,1890,L,112,122,-10
3780,458,1890,W,122,112,10
3781,754,1891,L,108,112,-4
3782,753,1891,W,112,108,4
3783,752,1892,L,97,104,-7
3784,751,1892,W,104,97,7
3785,196,1893,L,103,105,-2
3786,195,1893,W,105,103,2
3787,108,1894,W,121,106,15
3788,107,1894,L,106,121,-15
3789,381,1895,W,119,115,4
3790,382,1895,L,115,119,-4
3791,774,1896,L,113,141,-28
3792,773,1896,W,141,113,28
3793,445,1897,W,123,121,2
3794,446,1897,L,121,123,-2
3795,142,1898,L,105,122,-17
3796,141,1898,W,122,105,17
3797,175,1899,L,106,113,-7
3798,176,1899,W,113,106,7
3799,229,1900,L,95,113,-18
3800,230,1900,W,113,95,18
3801,62,1901,L,109,146,-37
3802,61,1901,W,146,109,37
3803,655,1902,L,96,127,-31
3804,656,1902,W,127,96,31
3805,87,1903,L,100,121,-21
3806,88,1903,W,121,100,21
3807,458,1904,L,147,154,-7
3808,457,1904,W,154,147,7
3809,125,1905,L,99,115,-16
3810,126,1905,W,115,99,16
3811,389,1906,L,102,112,-10
3812,390,1906,W,112,102,10
3813,815,1907,L,112,124,-12
3814,816,1907,W,124,112,12
3815,106,1908,L,106,123,-17
3816,105,1908,W,123,106,17
3817,701,1909,L,100,113,-13
3818,702,1909,W,113,100,13
3819,109,1910,L,86,96,-10
3820,110,1910,W,96,86,10
3821,118,1911,L,94,104,-10
3822,117,1911,W,104,94,10
3823,419,1912,L,124,140,-16
3824,420,1912,W,140,124,16
3825,42,1913,L,108,135,-27
3826,41,1913,W,135,108,27
3827,21,1914,L,100,116,-16
3828,22,1914,W,116,100,16
3829,241,1915,W,116,109,7
3830,242,1915,L,109,116,-7
3831,704,1916,L,93,106,-13
3832,703,1916,W,106,93,13
3833,256,1917,W,103,99,4
3834,255,1917,L,99,103,-4
3835,594,1918,W,119,117,2
3836,593,1918,L,117,119,-2
3837,12,1919,W,123,115,8
3838,11,1919,L,115,123,-8
3839,579,1920,L,101,104,-3
3840,580,1920,W,104,101,3
3841,54,1921,L,111,115,-4
3842,53,1921,W,115,111,4
3843,857,1922,L,109,128,-19
3844,858,1922,W,128,109,19
3845,105,1923,L,115,132,-17
3846,106,1923,W,132,115,17
3847,771,1924,L,95,122,-27
3848,772,1924,W,122,95,27
3849,823,1925,L,102,114,-12
3850,824,1925,W,114,102,12
3851,50,1926,L,113,125,-12
3852,49,1926,W,125,113,12
3853,94,1927,W,107,97,10
3854,93,1927,L,97,107,-10
3855,720,1928,L,101,111,-10
3856,719,1928,W,111,101,10
3857,246,1929,L,95,111,-16
3858,245,1929,W,111,95,16
3859,233,1930,L,95,114,-19
3860,234,1930,W,114,95,19
3861,732,1931,W,119,107,12
3862,731,1931,L,107,119,-12
3863,91,1932,L,95,116,-21
3864,92,1932,W,116,95,21
3865,187,1933,W,116,98,18
3866,188,1933,L,98,116,-18
3867,661,1934,W,119,113,6
3868,662,1934,L,113,119,-6
3869,590,1935,L,96,106,-10
3870,589,1935,W,106,96,10
3871,453,1936,L,105,121,-16
3872,454,1936,W,121,105,16
3873,64,1937,L,86,108,-22
3874,63,1937,W,108,86,22
3875,479,1938,L,82,106,-24
3876,480,1938,W,106,82,24
3877,298,1939,W,117,100,17
3878,297,1939,L,100,117,-17
3879,185,1940,W,123,116,7
3880,186,1940,L,116,123,-7
3881,668,1941,L,100,106,-6
3882,667,1941,W,106,100,6
3883,110,1942,L,88,108,-20
3884,109,1942,W,108,88,20
3885,436,1943,W,127,123,4
3886,435,1943,L,123,127,-4
3887,321,1944,W,110,105,5
3888,322,1944,L,105,110,-5
3889,420,1945,W,133,98,35
3890,419,1945,L,98,133,-35
3891,73,1946,L,101,110,-9
3892,74,1946,W,110,101,9
3893,340,1947,L,110,123,-13
3894,339,1947,W,123,110,13
3895,224,1948,W,121,111,10
3896,223,1948,L,111,121,-10
3897,746,1949,L,93,114,-21
3898,745,1949,W,114,93,21
3899,75,1950,W,119,116,3
3900,76,1950,L,116,119,-3
3901,610,1951,W,119,112,7
3902,609,1951,L,112,119,-7
3903,375,1952,W,117,91,26
3904,376,1952,L,91,117,-26
3905,331,1953,L,103,120,-17
3906,332,1953,W,120,103,17
3907,630,1954,W,111,109,2
3908,629,1954,L,109,111,-2
3909,48,1955,W,109,100,9
3910,47,1955,L,100,109,-9
3911,736,1956,L,112,144,-32
3912,735,1956,W,144,112,32
3913,308,1957,L,109,115,-6
3914,307,1957,W,115,109,6
3915,31,1958,W,117,113,4
3916,32,1958,L,113,117,-4
3917,81,1959,L,107,125,-18
3918,82,1959,W,125,107,18
3919,483,1960,W,135,134,1
3920,484,1960,L,134,135,-1
3921,750,1961,L,121,126,-5
3922,749,1961,W,126,121,5
3923,20,1962,W,122,84,38
3924,19,1962,L,84,122,-38
3925,172,1963,W,132,127,5
3926,171,1963,L,127,132,-5
3927,478,1964,L,102,115,-13
3928,477,1964,W,115,102,13
3929,738,1965,W,112,84,28
3930,737,1965,L,84,112,-28
3931,549,1966,W,101,94,7
3932,550,1966,L,94,101,-7
3933,325,1967,L,98,114,-16
3934,326,1967,W,114,98,16
3935,447,1968,W,117,92,25
3936,448,1968,L,92,117,-25
3937,217,1969,W,107,100,7
3938,218,1969,L,100,107,-7
3939,391,1970,W,119,113,6
3940,392,1970,L,113,119,-6
3941,316,1971,W,113,108,5
3942,315,1971,L,108,113,-5
3943,294,1972,L,116,122,-6
3944,293,1972,W,122,116,6
3945,755,1973,L,108,115,-7
3946,756,1973,W,115,108,7
3947,486,1974,L,98,121,-23
3948,485,1974,W,121,98,23
3949,401,1975,W,132,109,23
3950,402,1975,L,109,132,-23
3951,682,1976,L,111,120,-9
3952,681,1976,W,120,111,9
3953,581,1977,L,102,122,-20
3954,582,1977,W,122,102,20
3955,304,1978,L,114,123,-9
3956,303,1978,W,123,114,9
3957,708,1979,L,108,116,-8
3958,707,1979,W,116,108,8
3959,555,1980,L,100,125,-25
3960,556,1980,W,125,100,25
3961,433,1981,L,101,113,-12
3962,434,1981,W,113,101,12
3963,159,1982,L,114,121,-7
3964,160,1982,W,121,114,7
3965,191,1983,L,95,129,-34
3966,192,1983,W,129,95,34
3967,559,1984,L,89,95,-6
3968,560,1984,W,95,89,6
3969,431,1985,W,113,104,9
3970,432,1985,L,104,113,-9
3971,582,1986,L,103,105,-2
3972,581,1986,W,105,103,2
3973,491,1987,L,107,109,-2
3974,492,1987,W,109,107,2
3975,519,1988,W,122,118,4
3976,520,1988,L,118,122,-4
3977,611,1989,W,115,105,10
3978,612,1989,L,105,115,-10
3979,24,1990,W,112,103,9
3980,23,1990,L,103,112,-9
3981,562,1991,W,108,104,4
3982,561,1991,L,104,108,-4
3983,547,1992,W,122,111,11
3984,548,1992,L,111,122,-11
3985,348,1993,L,97,129,-32
3986,347,1993,W,129,97,32
3987,227,1994,L,115,129,-14
3988,228,1994,W,129,115,14
3989,494,1995,L,108,111,-3
3990,493,1995,W,111,108,3
3991,569,1996,L,126,130,-4
3992,570,1996,W,130,126,4
3993,543,1997,W,123,120,3
3994,544,1997,L,120,123,-3
3995,358,1998,L,112,114,-2
3996,357,1998,W,114,112,2
3997,119,1999,W,118,107,11
3998,120,1999,L,107,118,-11
3999,213,2000,L,87,116,-29
4000,214,2000,W,116,87,29
4001,181,2001,W,118,102,16
4002,182,2001,L,102,118,-16
4003,9,2002,W,101,92,9
4004,10,2002,L,92,101,-9
4005,220,2003,L,99,102,-3
4006,219,2003,W,102,99,3
4007,59,2004,L,87,100,-13
4008,60,2004,W,100,87,13
4009,448,2005,L,94,118,-24
4010,447,2005,W,118,94,24
4011,792,2006,L,88,125,-37
4012,791,2006,W,125,88,37
4013,68,2007,L,96,112,-16
4014,67,2007,W,112,96,16
4015,612,2008,W,110,109,1
4016,611,2008,L,109,110,-1
4017,806,2009,W,114,97,17
4018,805,2009,L,97,114,-17
4019,160,2010,L,116,117,-1
4020,159,2010,W,117,116,1
4021,406,2011,L,113,127,-14
4022,405,2011,W,127,113,14
4023,357,2012,L,119,122,-3
4024,358,2012,W,122,119,3
4025,618,2013,L,95,106,-11
4026,617,2013,W,106,95,11
4027,678,2014,W,122,120,2
4028,677,2014,L,120,122,-2
4029,219,2015,L,103,111,-8
4030,220,2015,W,111,103,8
4031,60,2016,L,132,134,-2
4032,59,2016,W,134,132,2
4033,707,2017,W,129,121,8
4034,708,2017,L,121,129,-8
4035,350,2018,W,119,94,25
4036,349,2018,L,94,119,-25
4037,231,2019,W,106,104,2
4038,232,2019,L,104,106,-2
4039,631,2020,L,87,95,-8
4040,632,2020,W,95,87,8
4041,469,2021,L,118,127,-9
4042,470,2021,W,127,118,9
4043,144,2022,L,114,121,-7
4044,143,2022,W,121,114,7
4045,67,2023,W,109,95,14
4046,68,2023,L,95,109,-14
4047,98,2024,L,96,117,-21
4048,97,2024,W,117,96,21
4049,421,2025,W,127,101,26
4050,422,2025,L,101,127,-26
4051,133,2026,L,109,113,-4
4052,134,2026,W,113,109,4
4053,44,2027,W,98,95,3
4054,43,2027,L,95,98,-3
4055,404,2028,W,107,99,8
4056,403,2028,L,99,107,-8
4057,594,2029,W,114,112,2
4058,593,2029,L,112,114,-2
4059,551,2030,L,103,111,-8
4060,552,2030,W,111,103,8
4061,115,2031,W,115,91,24
4062,116,2031,L,91,115,-24
4063,275,2032,L,127,129,-2
4064,276,2032,W,129,127,2
4065,274,2033,W,112,92,20
4066,273,2033,L,92,112,-20
4067,238,2034,L,89,105,-16
4068,237,2034,W,105,89,16
4069,174,2035,L,118,121,-3
4070,173,2035,W,121,118,3
4071,177,2036,L,117,122,-5
4072,178,2036,W,122,117,5
4073,724,2037,L,103,119,-16
4074,723,2037,W,119,103,16
4075,39,2038,L,101,126,-25
4076,40,2038,W,126,101,25
4077,25,2039,L,87,94,-7
4078,26,2039,W,94,87,7
4079,651,2040,L,116,120,-4
4080,652,2040,W,120,116,4
4081,257,2041,L,146,149,-3
4082,258,2041,W,149,146,3
4083,170,2042,L,101,108,-7
4084,169,2042,W,108,101,7
4085,88,2043,L,111,132,-21
4086,87,2043,W,132,111,21
4087,52,2044,W,107,106,1
4088,51,2044,L,106,107,-1
4089,502,2045,W,114,106,8
4090,501,2045,L,106,114,-8
4091,506,2046,L,86,98,-12
4092,505,2046,W,98,86,12
4093,97,2047,W,120,90,30
4094,98,2047,L,90,120,-30
4095,408,2048,L,99,102,-3
4096,407,2048,W,102,99,3
4097,384,2049,L,104,112,-8
4098,383,2049,W,112,104,8
4099,572,2050,L,110,126,-16
4100,571,2050,W,126,110,16
4101,817,2051,L,98,124,-26
4102,818,2051,W,124,98,26
4103,738,2052,L,80,90,-10
4104,737,2052,W,90,80,10
4105,272,2053,W,114,107,7
4106,271,2053,L,107,114,-7
4107,99,2054,W,120,107,13
4108,100,2054,L,107,120,-13
4109,820,2055,L,99,101,-2
4110,819,2055,W,101,99,2
4111,65,2056,L,121,125,-4
4112,66,2056,W,125,121,4
4113,453,2057,L,96,99,-3
4114,454,2057,W,99,96,3
4115,84,2058,L,109,131,-22
4116,83,2058,W,131,109,22
4117,298,2059,W,96,93,3
4118,297,2059,L,93,96,-3
4119,625,2060,W,111,103,8
4120,626,2060,L,103,111,-8
4121,608,2061,L,103,108,-5
4122,607,2061,W,108,103,5
4123,104,2062,L,99,110,-11
4124,103,2062,W,110,99,11
4125,856,2063,L,118,136,-18
4126,855,2063,W,136,118,18
4127,111,2064,W,129,123,6
4128,112,2064,L,123,129,-6
4129,145,2065,L,92,99,-7
4130,146,2065,W,99,92,7
4131,394,2066,W,129,90,39
4132,393,2066,L,90,129,-39
4133,426,2067,W,132,113,19
4134,425,2067,L,113,132,-19
4135,546,2068,L,115,123,-8
4136,545,2068,W,123,115,8
4137,326,2069,L,110,118,-8
4138,325,2069,W,118,110,8
4139,268,2070,L,118,126,-8
4140,267,2070,W,126,118,8
4141,286,2071,L,110,115,-5
4142,285,2071,W,115,110,5
4143,11,2072,W,92,91,1
4144,12,2072,L,91,92,-1
4145,462,2073,L,97,102,-5
4146,461,2073,W,102,97,5
4147,639,2074,W,128,110,18
4148,640,2074,L,110,128,-18
4149,17,2075,W,131,127,4
4150,18,2075,L,127,131,-4
4151,442,2076,L,96,121,-25
4152,441,2076,W,121,96,25
4153,236,2077,L,96,123,-27
4154,235,2077,W,123,96,27
4155,664,2078,L,93,110,-17
4156,663,2078,W,110,93,17
4157,554,2079,L,105,132,-27
4158,553,2079,W,132,105,27
4159,485,2080,W,107,104,3
4160,486,2080,L,104,107,-3
4161,222,2081,W,120,113,7
4162,221,2081,L,113,120,-7
4163,814,2082,L,110,128,-18
4164,813,2082,W,128,110,18
4165,107,2083,L,99,110,-11
4166,108,2083,W,110,99,11
4167,21,2084,L,127,144,-17
4168,22,2084,W,144,127,17
4169,69,2085,W,128,105,23
4170,70,2085,L,105,128,-23
4171,150,2086,L,86,95,-9
4172,149,2086,W,95,86,9
4173,90,2087,W,102,96,6
4174,89,2087,L,96,102,-6
4175,703,2088,L,89,96,-7
4176,704,2088,W,96,89,7
4177,584,2089,W,98,93,5
4178,583,2089,L,93,98,-5
4179,434,2090,W,105,97,8
4180,433,2090,L,97,105,-8
4181,148,2091,L,104,110,-6
4182,147,2091,W,110,104,6
4183,642,2092,L,104,113,-9
4184,641,2092,W,113,104,9
4185,779,2093,L,99,107,-8
4186,780,2093,W,107,99,8
4187,860,2094,W,128,100,28
4188,859,2094,L,100,128,-28
4189,690,2095,L,122,128,-6
4190,689,2095,W,128,122,6
4191,523,2096,L,108,129,-21
4192,524,2096,W,129,108,21
4193,243,2097,L,118,125,-7
4194,244,2097,W,125,118,7
4195,240,2098,L,98,109,-11
4196,239,2098,W,109,98,11
4197,250,2099,W,113,101,12
4198,249,2099,L,101,113,-12
4199,436,2100,W,130,125,5
4200,435,2100,L,125,130,-5
4201,764,2101,W,114,102,12
4202,763,2101,L,102,114,-12
4203,753,2102,W,100,97,3
4204,754,2102,L,97,100,-3
4205,429,2103,W,126,124,2
4206,430,2103,L,124,126,-2
4207,737,2104,L,91,97,-6
4208,738,2104,W,97,91,6
4209,117,2105,L,89,99,-10
4210,118,2105,W,99,89,10
4211,548,2106,L,87,125,-38
4212,547,2106,W,125,87,38
4213,130,2107,L,111,126,-15
4214,129,2107,W,126,111,15
4215,506,2108,L,107,108,-1
4216,505,2108,W,108,107,1
4217,360,2109,L,97,113,-16
4218,359,2109,W,113,97,16
4219,464,2110,L,107,114,-7
4220,463,2110,W,114,107,7
4221,497,2111,L,84,111,-27
4222,498,2111,W,111,84,27
4223,481,2112,W,127,124,3
4224,482,2112,L,124,127,-3
4225,146,2113,L,83,92,-9
4226,145,2113,W,92,83,9
4227,6,2114,L,114,118,-4
4228,5,2114,W,118,114,4
4229,553,2115,L,130,141,-11
4230,554,2115,W,141,130,11
4231,156,2116,W,130,125,5
4232,155,2116,L,125,130,-5
4233,29,2117,L,106,113,-7
4234,30,2117,W,113,106,7
4235,343,2118,W,113,93,20
4236,344,2118,L,93,113,-20
4237,74,2119,L,104,111,-7
4238,73,2119,W,111,104,7
4239,776,2120,W,123,99,24
4240,775,2120,L,99,123,-24
4241,601,2121,L,86,111,-25
4242,602,2121,W,111,86,25
4243,265,2122,L,102,116,-14
4244,266,2122,W,116,102,14
4245,124,2123,L,105,108,-3
4246,123,2123,W,108,105,3
4247,763,2124,L,92,108,-16
4248,764,2124,W,108,92,16
4249,597,2125,W,108,89,19
4250,598,2125,L,89,108,-19
4251,714,2126,L,108,116,-8
4252,713,2126,W,116,108,8
4253,474,2127,L,76,101,-25
4254,473,2127,W,101,76,25
4255,224,2128,W,123,119,4
4256,223,2128,L,119,123,-4
4257,51,2129,L,113,122,-9
4258,52,2129,W,122,113,9
4259,588,2130,L,100,113,-13
4260,587,2130,W,113,100,13
4261,238,2131,L,101,109,-8
4262,237,2131,W,109,101,8
4263,578,2132,L,99,105,-6
4264,577,2132,W,105,99,6
4265,158,2133,L,97,110,-13
4266,157,2133,W,110,97,13
4267,659,2134,W,116,108,8
4268,660,2134,L,108,116,-8
4269,430,2135,W,119,107,12
4270,429,2135,L,107,119,-12
4271,186,2136,W,104,99,5
4272,185,2136,L,99,104,-5
4273,472,2137,L,101,116,-15
4274,471,2137,W,116,101,15
4275,403,2138,W,111,88,23
4276,404,2138,L,88,111,-23
4277,680,2139,L,105,113,-8
4278,679,2139,W,113,105,8
4279,741,2140,L,97,107,-10
4280,742,2140,W,107,97,10
4281,259,2141,L,104,107,-3
4282,260,2141,W,107,104,3
4283,654,2142,W,133,77,56
4284,653,2142,L,77,133,-56
4285,591,2143,W,112,104,8
4286,592,2143,L,104,112,-8
4287,693,2144,L,98,106,-8
4288,694,2144,W,106,98,8
4289,541,2145,W,121,98,23
4290,542,2145,L,98,121,-23
4291,226,2146,W,112,90,22
4292,225,2146,L,90,112,-22
4293,441,2147,L,112,114,-2
4294,442,2147,W,114,112,2
4295,862,2148,W,129,110,19
4296,861,2148,L,110,129,-19
4297,141,2149,L,105,106,-1
4298,142,2149,W,106,105,1
4299,202,2150,W,115,98,17
4300,201,2150,L,98,115,-17
4301,339,2151,L,107,113,-6
4302,340,2151,W,113,107,6
4303,266,2152,W,117,111,6
4304,265,2152,L,111,117,-6
4305,95,2153,W,105,95,10
4306,96,2153,L,95,105,-10
4307,15,2154,L,120,133,-13
4308,16,2154,W,133,120,13
4309,233,2155,W,107,103,4
4310,234,2155,L,103,107,-4
4311,283,2156,L,86,108,-22
4312,284,2156,W,108,86,22
4313,812,2157,L,100,128,-28
4314,811,2157,W,128,100,28
4315,461,2158,L,91,118,-27
4316,462,2158,W,118,91,27
4317,687,2159,W,114,112,2
4318,688,2159,L,112,114,-2
4319,444,2160,L,86,96,-10
4320,443,2160,W,96,86,10
4321,358,2161,L,106,132,-26
4322,357,2161,W,132,106,26
4323,486,2162,L,92,115,-23
4324,485,2162,W,115,92,23
4325,748,2163,W,124,118,6
4326,747,2163,L,118,124,-6
4327,495,2164,L,104,121,-17
4328,496,2164,W,121,104,17
4329,40,2165,L,102,113,-11
4330,39,2165,W,113,102,11
4331,326,2166,W,131,117,14
4332,325,2166,L,117,131,-14
4333,16,2167,L,113,121,-8
4334,15,2167,W,121,113,8
4335,563,2168,W,129,105,24
4336,564,2168,L,105,129,-24
4337,76,2169,L,90,96,-6
4338,75,2169,W,96,90,6
4339,157,2170,L,105,139,-34
4340,158,2170,W,139,105,34
4341,116,2171,W,105,90,15
4342,115,2171,L,90,105,-15
4343,54,2172,W,122,105,17
4344,53,2172,L,105,122,-17
4345,173,2173,L,102,111,-9
4346,174,2173,W,111,102,9
4347,280,2174,W,110,107,3
4348,279,2174,L,107,110,-3
4349,807,2175,W,128,111,17
4350,808,2175,L,111,128,-17
4351,288,2176,L,91,103,-12
4352,287,2176,W,103,91,12
4353,149,2177,W,106,103,3
4354,150,2177,L,103,106,-3
4355,822,2178,W,99,97,2
4356,821,2178,L,97,99,-2
4357,254,2179,W,129,126,3
4358,253,2179,L,126,129,-3
4359,355,2180,W,110,83,27
4360,356,2180,L,83,110,-27
4361,498,2181,L,100,102,-2
4362,497,2181,W,102,100,2
4363,534,2182,L,118,131,-13
4364,533,2182,W,131,118,13
4365,847,2183,W,119,109,10
4366,848,2183,L,109,119,-10
4367,66,2184,L,110,114,-4
4368,65,2184,W,114,110,4
4369,503,2185,L,96,120,-24
4370,504,2185,W,120,96,24
4371,531,2186,L,95,103,-8
4372,532,2186,W,103,95,8
4373,244,2187,L,88,102,-14
4374,243,2187,W,102,88,14
4375,742,2188,L,110,111,-1
4376,741,2188,W,111,110,1
4377,571,2189,W,106,95,11
4378,572,2189,L,95,106,-11
4379,33,2190,L,102,111,-9
4380,34,2190,W,111,102,9
4381,846,2191,L,105,121,-16
4382,845,2191,W,121,105,16
4383,67,2192,L,134,136,-2
4384,68,2192,W,136,134,2
4385,477,2193,W,118,109,9
4386,478,2193,L,109,118,-9
4387,677,2194,W,99,85,14
4388,678,2194,L,85,99,-14
4389,89,2195,L,101,106,-5
4390,90,2195,W,106,101,5
4391,169,2196,W,136,105,31
4392,170,2196,L,105,136,-31
4393,669,2197,L,88,107,-19
4394,670,2197,W,107,88,19
4395,93,2198,L,103,114,-11
4396,94,2198,W,114,103,11
4397,354,2199,L,95,128,-33
4398,353,2199,W,128,95,33
4399,105,2200,L,98,123,-25
4400,106,2200,W,123,98,25
4401,674,2201,W,119,111,8
4402,673,2201,L,111,119,-8
4403,47,2202,W,131,125,6
4404,48,2202,L,125,131,-6
4405,599,2203,L,109,124,-15
4406,600,2203,W,124,109,15
4407,210,2204,W,113,112,1
4408,209,2204,L,112,113,-1
4409,200,2205,L,96,104,-8
4410,199,2205,W,104,96,8
4411,344,2206,L,128,131,-3
4412,343,2206,W,131,128,3
4413,470,2207,W,133,121,12
4414,469,2207,L,121,133,-12
4415,84,2208,L,91,117,-26
4416,83,2208,W,117,91,26
4417,374,2209,L,112,115,-3
4418,373,2209,W,115,112,3
4419,539,2210,L,83,100,-17
4420,540,2210,W,100,83,17
4421,615,2211,L,113,116,-3
4422,616,2211,W,116,113,3
4423,223,2212,L,99,115,-16
4424,224,2212,W,115,99,16
4425,818,2213,L,89,128,-39
4426,817,2213,W,128,89,39
4427,260,2214,W,128,108,20
4428,259,2214,L,108,128,-20
4429,647,2215,W,101,91,10
4430,648,2215,L,91,101,-10
4431,292,2216,L,94,108,-14
4432,291,2216,W,108,94,14
4433,203,2217,L,104,125,-21
4434,204,2217,W,125,104,21
4435,128,2218,L,85,117,-32
4436,127,2218,W,117,85,32
4437,480,2219,W,115,113,2
4438,479,2219,L,113,115,-2
4439,190,2220,W,122,114,8
4440,189,2220,L,114,122,-8
4441,296,2221,L,108,115,-7
4442,295,2221,W,115,108,7
4443,211,2222,W,109,104,5
4444,212,2222,L,104,109,-5
4445,623,2223,L,110,116,-6
4446,624,2223,W,116,110,6
4447,613,2224,W,121,88,33
4448,614,2224,L,88,121,-33
4449,587,2225,W,124,107,17
4450,588,2225,L,107,124,-17
4451,699,2226,W,102,95,7
4452,700,2226,L,95,102,-7
4453,855,2227,L,131,135,-4
4454,856,2227,W,135,131,4
4455,387,2228,L,107,110,-3
4456,388,2228,W,110,107,3
4457,583,2229,W,108,107,1
4458,584,2229,L,107,108,-1
4459,18,2230,W,104,100,4
4460,17,2230,L,100,104,-4
4461,232,2231,L,115,125,-10
4462,231,2231,W,125,115,10
4463,645,2232,W,108,104,4
4464,646,2232,L,104,108,-4
4465,574,2233,W,103,98,5
4466,573,2233,L,98,103,-5
4467,482,2234,W,127,125,2
4468,481,2234,L,125,127,-2
4469,291,2235,L,123,124,-1
4470,292,2235,W,124,123,1
4471,628,2236,W,133,112,21
4472,627,2236,L,112,133,-21
4473,414,2237,L,107,118,-11
4474,413,2237,W,118,107,11
4475,773,2238,L,108,117,-9
4476,774,2238,W,117,108,9
4477,435,2239,L,116,117,-1
4478,436,2239,W,117,116,1
4479,239,2240,W,105,98,7
4480,240,2240,L,98,105,-7
4481,349,2241,L,96,111,-15
4482,350,2241,W,111,96,15
4483,745,2242,L,104,113,-9
4484,746,2242,W,113,104,9
4485,204,2243,L,114,124,-10
4486,203,2243,W,124,114,10
4487,696,2244,L,129,135,-6
4488,695,2244,W,135,129,6
4489,86,2245,L,104,109,-5
4490,85,2245,W,109,104,5
4491,637,2246,L,107,125,-18
4492,638,2246,W,125,107,18
4493,747,2247,L,87,112,-25
4494,748,2247,W,112,87,25
4495,310,2248,W,116,114,2
4496,309,2248,L,114,116,-2
4497,788,2249,W,103,96,7
4498,787,2249,L,96,103,-7
4499,524,2250,W,114,96,18
4500,523,2250,L,96,114,-18
4501,760,2251,L,111,116,-5
4502,759,2251,W,116,111,5
4503,675,2252,L,109,114,-5
4504,676,2252,W,114,109,5
4505,378,2253,W,111,100,11
4506,377,2253,L,100,111,-11
4507,230,2254,L,83,90,-7
4508,229,2254,W,90,83,7
4509,443,2255,L,107,112,-5
4510,444,2255,W,112,107,5
4511,612,2256,L,97,125,-28
4512,611,2256,W,125,97,28
4513,70,2257,W,121,112,9
4514,69,2257,L,112,121,-9
4515,726,2258,W,112,102,10
4516,725,2258,L,102,112,-10
4517,658,2259,W,109,105,4
4518,657,2259,L,105,109,-4
4519,812,2260,W,117,109,8
4520,811,2260,L,109,117,-8
4521,827,2261,W,123,95,28
4522,828,2261,L,95,123,-28
4523,767,2262,L,120,121,-1
4524,768,2262,W,121,120,1
4525,672,2263,L,100,143,-43
4526,671,2263,W,143,100,43
4527,580,2264,W,124,108,16
4528,579,2264,L,108,124,-16
4529,759,2265,L,124,126,-2
4530,760,2265,W,126,124,2
4531,709,2266,L,113,119,-6
4532,710,2266,W,119,113,6
4533,110,2267,W,104,103,1
4534,109,2267,L,103,104,-1
4535,627,2268,W,119,110,9
4536,628,2268,L,110,119,-9
4537,467,2269,L,116,124,-8
4538,468,2269,W,124,116,8
4539,460,2270,W,103,101,2
4540,459,2270,L,101,103,-2
4541,438,2271,L,109,127,-18
4542,437,2271,W,127,109,18
4543,395,2272,W,104,92,12
4544,396,2272,L,92,104,-12
4545,783,2273,L,118,125,-7
4546,784,2273,W,125,118,7
4547,213,2274,W,93,91,2
4548,214,2274,L,91,93,-2
4549,719,2275,W,118,114,4
4550,720,2275,L,114,118,-4
4551,71,2276,L,102,113,-11
4552,72,2276,W,113,102,11
4553,605,2277,W,127,119,8
4554,606,2277,L,119,127,-8
4555,723,2278,L,112,117,-5
4556,724,2278,W,117,112,5
4557,171,2279,L,114,119,-5
4558,172,2279,W,119,114,5
4559,614,2280,L,94,121,-27
4560,613,2280,W,121,94,27
4561,334,2281,L,88,98,-10
4562,333,2281,W,98,88,10
4563,290,2282,L,98,104,-6
4564,289,2282,W,104,98,6
4565,55,2283,L,126,140,-14
4566,56,2283,W,140,126,14
4567,426,2284,L,113,117,-4
4568,425,2284,W,117,113,4
4569,536,2285,L,117,131,-14
4570,535,2285,W,131,117,14
4571,686,2286,W,100,87,13
4572,685,2286,L,87,100,-13
4573,721,2287,L,92,104,-12
4574,722,2287,W,104,92,12
4575,352,2288,W,119,109,10
4576,351,2288,L,109,119,-10
4577,123,2289,W,113,97,16
4578,124,2289,L,97,113,-16
4579,560,2290,W,122,83,39
4580,559,2290,L,83,122,-39
4581,708,2291,L,89,97,-8
4582,707,2291,W,97,89,8
4583,194,2292,W,127,119,8
4584,193,2292,L,119,127,-8
4585,652,2293,L,109,112,-3
4586,651,2293,W,112,109,3
4587,844,2294,W,122,119,3
4588,843,2294,L,119,122,-3
4589,7,2295,L,112,132,-20
4590,8,2295,W,132,112,20
4591,181,2296,W,110,100,10
4592,182,2296,L,100,110,-10
4593,335,2297,W,98,86,12
4594,336,2297,L,86,98,-12
4595,603,2298,L,115,125,-10
4596,604,2298,W,125,115,10
4597,646,2299,L,117,130,-13
4598,645,2299,W,130,117,13
4599,676,2300,L,124,129,-5
4600,675,2300,W,129,124,5
4601,140,2301,L,91,99,-8
4602,139,2301,W,99,91,8
4603,244,2302,W,115,104,11
4604,243,2302,L,104,115,-11
4605,805,2303,L,107,113,-6
4606,806,2303,W,113,107,6
4607,615,2304,L,104,123,-19
4608,616,2304,W,123,104,19
4609,407,2305,L,104,112,-8
4610,408,2305,W,112,104,8
4611,132,2306,L,116,123,-7
4612,131,2306,W,123,116,7
4613,679,2307,L,96,112,-16
4614,680,2307,W,112,96,16
4615,694,2308,L,93,138,-45
4616,693,2308,W,138,93,45
4617,484,2309,L,86,107,-21
4618,483,2309,W,107,86,21
4619,547,2310,L,111,116,-5
4620,548,2310,W,116,111,5
4621,471,2311,L,95,119,-24
4622,472,2311,W,119,95,24
4623,396,2312,W,120,107,13
4624,395,2312,L,107,120,-13
4625,602,2313,L,96,116,-20
4626,601,2313,W,116,96,20
4627,303,2314,L,100,107,-7
4628,304,2314,W,107,100,7
4629,162,2315,W,116,113,3
4630,161,2315,L,113,116,-3
4631,184,2316,L,68,118,-50
4632,183,2316,W,118,68,50
4633,3,2317,L,106,111,-5
4634,4,2317,W,111,106,5
4635,45,2318,L,117,126,-9
4636,46,2318,W,126,117,9
4637,330,2319,L,103,128,-25
4638,329,2319,W,128,103,25
4639,653,2320,L,82,111,-29
4640,654,2320,W,111,82,29
4641,566,2321,W,106,104,2
4642,565,2321,L,104,106,-2
4643,808,2322,L,103,110,-7
4644,807,2322,W,110,103,7
4645,103,2323,L,89,113,-24
4646,104,2323,W,113,89,24
4647,49,2324,W,109,99,10
4648,50,2324,L,99,109,-10
4649,276,2325,L,116,121,-5
4650,275,2325,W,121,116,5
4651,57,2326,L,109,117,-8
4652,58,2326,W,117,109,8
4653,379,2327,W,103,98,5
4654,380,2327,L,98,103,-5
4655,113,2328,W,126,110,16
4656,114,2328,L,110,126,-16
4657,557,2329,W,124,114,10
4658,558,2329,L,114,124,-10
4659,216,2330,W,96,88,8
4660,215,2330,L,88,96,-8
4661,725,2331,L,113,120,-7
4662,726,2331,W,120,113,7
4663,182,2332,L,101,118,-17
4664,181,2332,W,118,101,17
4665,262,2333,L,99,104,-5
4666,261,2333,W,104,99,5
4667,758,2334,L,106,107,-1
4668,757,2334,W,107,106,1
4669,505,2335,W,113,103,10
4670,506,2335,L,103,113,-10
4671,535,2336,W,115,89,26
4672,536,2336,L,89,115,-26
4673,248,2337,L,94,100,-6
4674,247,2337,W,100,94,6
4675,289,2338,W,121,114,7
4676,290,2338,L,114,121,-7
4677,165,2339,L,103,115,-12
4678,166,2339,W,115,103,12
4679,790,2340,L,126,128,-2
4680,789,2340,W,128,126,2
4681,273,2341,L,98,99,-1
4682,274,2341,W,99,98,1
4683,122,2342,L,100,116,-16
4684,121,2342,W,116,100,16
4685,308,2343,W,116,110,6
4686,307,2343,L,110,116,-6
4687,28,2344,L,99,119,-20
4688,27,2344,W,119,99,20
4689,532,2345,L,106,112,-6
4690,531,2345,W,112,106,6
4691,160,2346,W,101,86,15
4692,159,2346,L,86,101,-15
4693,13,2347,L,112,128,-16
4694,14,2347,W,128,112,16
4695,169,2348,L,89,96,-7
4696,170,2348,W,96,89,7
4697,582,2349,L,96,111,-15
4698,581,2349,W,111,96,15
4699,843,2350,L,132,133,-1
4700,844,2350,W,133,132,1
4701,139,2351,W,110,102,8
4702,140,2351,L,102,110,-8
4703,58,2352,L,108,117,-9
4704,57,2352,W,117,108,9
4705,786,2353,W,112,110,2
4706,785,2353,L,110,112,-2
4707,336,2354,L,115,123,-8
4708,335,2354,W,123,115,8
4709,43,2355,W,124,109,15
4710,44,2355,L,109,124,-15
4711,553,2356,L,110,121,-11
4712,554,2356,W,121,110,11
4713,96,2357,W,134,111,23
4714,95,2357,L,111,134,-23
4715,626,2358,W,116,109,7
4716,625,2358,L,109,116,-7
4717,134,2359,L,80,98,-18
4718,133,2359,W,98,80,18
4719,18,2360,L,105,116,-11
4720,17,2360,W,116,105,11
4721,183,2361,L,102,117,-15
4722,184,2361,W,117,102,15
4723,271,2362,W,112,107,5
4724,272,2362,L,107,112,-5
4725,63,2363,L,110,114,-4
4726,64,2363,W,114,110,4
4727,620,2364,L,88,95,-7
4728,619,2364,W,95,88,7
4729,538,2365,L,98,107,-9
4730,537,2365,W,107,98,9
4731,577,2366,L,87,89,-2
4732,578,2366,W,89,87,2
4733,249,2367,W,100,94,6
4734,250,2367,L,94,100,-6
4735,305,2368,W,114,105,9
4736,306,2368,L,105,114,-9
4737,491,2369,W,103,96,7
4738,492,2369,L,96,103,-7
4739,540,2370,W,95,86,9
4740,539,2370,L,86,95,-9
4741,671,2371,L,103,118,-15
4742,672,2371,W,118,103,15
4743,292,2372,L,102,113,-11
4744,291,2372,W,113,102,11
4745,526,2373,L,100,119,-19
4746,525,2373,W,119,100,19
4747,552,2374,W,104,82,22
4748,551,2374,L,82,104,-22
4749,37,2375,L,109,120,-11
4750,38,2375,W,120,109,11
4751,842,2376,W,120,115,5
4752,841,2376,L,115,120,-5
4753,664,2377,L,101,117,-16
4754,663,2377,W,117,101,16
4755,399,2378,W,116,115,1
4756,400,2378,L,115,116,-1
4757,293,2379,W,124,111,13
4758,294,2379,L,111,124,-13
4759,796,2380,L,100,102,-2
4760,795,2380,W,102,100,2
4761,794,2381,L,107,115,-8
4762,793,2381,W,115,107,8
4763,166,2382,W,98,94,4
4764,165,2382,L,94,98,-4
4765,5,2383,L,116,122,-6
4766,6,2383,W,122,116,6
4767,252,2384,W,121,107,14
4768,251,2384,L,107,121,-14
4769,393,2385,W,117,110,7
4770,394,2385,L,110,117,-7
4771,586,2386,L,100,102,-2
4772,585,2386,W,102,100,2
4773,482,2387,L,97,122,-25
4774,481,2387,W,122,97,25
4775,509,2388,L,109,144,-35
4776,510,2388,W,144,109,35
4777,680,2389,L,81,111,-30
4778,679,2389,W,111,81,30
4779,279,2390,L,95,108,-13
4780,280,2390,W,108,95,13
4781,56,2391,L,95,109,-14
4782,55,2391,W,109,95,14
4783,41,2392,L,101,102,-1
4784,42,2392,W,102,101,1
4785,845,2393,W,96,88,8
4786,846,2393,L,88,96,-8
4787,265,2394,L,99,109,-10
4788,266,2394,W,109,99,10
4789,46,2395,W,114,110,4
4790,45,2395,L,110,114,-4
4791,135,2396,L,88,103,-15
4792,136,2396,W,103,88,15
4793,479,2397,L,118,123,-5
4794,480,2397,W,123,118,5
4795,104,2398,L,94,126,-32
4796,103,2398,W,126,94,32
4797,840,2399,W,118,106,12
4798,839,2399,L,106,118,-12
4799,75,2400,W,107,105,2
4800,76,2400,L,105,107,-2
4801,188,2401,W,134,111,23
4802,187,2401,L,111,134,-23
4803,734,2402,W,119,111,8
4804,733,2402,L,111,119,-8
4805,363,2403,W,107,98,9
4806,364,2403,L,98,107,-9
4807,215,2404,W,110,100,10
4808,216,2404,L,100,110,-10
4809,589,2405,W,120,95,25
4810,590,2405,L,95,120,-25
4811,714,2406,L,99,116,-17
4812,713,2406,W,116,99,17
4813,849,2407,W,146,115,31
4814,850,2407,L,115,146,-31
4815,85,2408,W,111,107,4
4816,86,2408,L,107,111,-4
4817,475,2409,L,119,132,-13
4818,476,2409,W,132,119,13
4819,99,2410,L,113,117,-4
4820,100,2410,W,117,113,4
4821,392,2411,L,113,122,-9
4822,391,2411,W,122,113,9
4823,319,2412,W,110,91,19
4824,320,2412,L,91,110,-19
4825,93,2413,L,113,114,-1
4826,94,2413,W,114,113,1
4827,449,2414,L,121,131,-10
4828,450,2414,W,131,121,10
4829,80,2415,L,125,128,-3
4830,79,2415,W,128,125,3
4831,575,2416,L,119,120,-1
4832,576,2416,W,120,119,1
4833,602,2417,W,120,90,30
4834,601,2417,L,90,120,-30
4835,870,2418,W,108,107,1
4836,869,2418,L,107,108,-1
4837,108,2419,W,107,101,6
4838,107,2419,L,101,107,-6
4839,493,2420,L,114,136,-22
4840,494,2420,W,136,114,22
4841,40,2421,L,112,129,-17
4842,39,2421,W,129,112,17
4843,245,2422,W,107,99,8
4844,246,2422,L,99,107,-8
4845,516,2423,L,95,107,-12
4846,515,2423,W,107,95,12
4847,74,2424,W,104,85,19
4848,73,2424,L,85,104,-19
4849,270,2425,L,113,125,-12
4850,269,2425,W,125,113,12
4851,641,2426,L,105,108,-3
4852,642,2426,W,108,105,3
4853,148,2427,L,110,128,-18
4854,147,2427,W,128,110,18
4855,445,2428,L,92,113,-21
4856,446,2428,W,113,92,21
4857,64,2429,L,120,124,-4
4858,63,2429,W,124,120,4
4859,528,2430,W,123,113,10
4860,527,2430,L,113,123,-10
4861,423,2431,W,103,93,10
4862,424,2431,L,93,103,-10
4863,61,2432,W,149,124,25
4864,62,2432,L,124,149,-25
4865,277,2433,L,108,113,-5
4866,278,2433,W,113,108,5
4867,591,2434,L,96,115,-19
4868,592,2434,W,115,96,19
4869,185,2435,L,109,124,-15
4870,186,2435,W,124,109,15
4871,604,2436,L,111,116,-5
4872,603,2436,W,116,111,5
4873,784,2437,L,104,136,-32
4874,783,2437,W,136,104,32
4875,184,2438,W,113,104,9
4876,183,2438,L,104,113,-9
4877,121,2439,W,120,114,6
4878,122,2439,L,114,120,-6
4879,182,2440,L,110,117,-7
4880,181,2440,W,117,110,7
4881,12,2441,W,119,107,12
4882,11,2441,L,107,119,-12
4883,843,2442,L,103,105,-2
4884,844,2442,W,105,103,2
4885,642,2443,W,109,89,20
4886,641,2443,L,89,109,-20
4887,102,2444,W,97,85,12
4888,101,2444,L,85,97,-12
4889,15,2445,L,106,110,-4
4890,16,2445,W,110,106,4
4891,263,2446,W,132,111,21
4892,264,2446,L,111,132,-21
4893,585,2447,L,96,117,-21
4894,586,2447,W,117,96,21
4895,137,2448,L,91,113,-22
4896,138,2448,W,113,91,22
4897,512,2449,L,111,120,-9
4898,511,2449,W,120,111,9
4899,718,2450,W,125,95,30
4900,717,2450,L,95,125,-30
4901,749,2451,L,115,117,-2
4902,750,2451,W,117,115,2
4903,345,2452,W,133,113,20
4904,346,2452,L,113,133,-20
4905,488,2453,L,106,135,-29
4906,487,2453,W,135,106,29
4907,772,2454,W,128,100,28
4908,771,2454,L,100,128,-28
4909,361,2455,L,112,116,-4
4910,362,2455,W,116,112,4
4911,739,2456,L,107,116,-9
4912,740,2456,W,116,107,9
4913,127,2457,L,114,121,-7
4914,128,2457,W,121,114,7
4915,300,2458,W,101,95,6
4916,299,2458,L,95,101,-6
4917,373,2459,W,128,114,14
4918,374,2459,L,114,128,-14
4919,71,2460,L,103,110,-7
4920,72,2460,W,110,103,7
4921,507,2461,L,105,112,-7
4922,508,2461,W,112,105,7
4923,385,2462,L,122,144,-22
4924,386,2462,W,144,122,22
4925,821,2463,W,102,86,16
4926,822,2463,L,86,102,-16
4927,487,2464,L,110,112,-2
4928,488,2464,W,112,110,2
4929,377,2465,W,116,96,20
4930,378,2465,L,96,116,-20
4931,666,2466,L,87,110,-23
4932,665,2466,W,110,87,23
4933,462,2467,W,100,89,11
4934,461,2467,L,89,100,-11
4935,465,2468,L,108,123,-15
4936,466,2468,W,123,108,15
4937,408,2469,L,92,97,-5
4938,407,2469,W,97,92,5
4939,504,2470,W,131,113,18
4940,503,2470,L,113,131,-18
4941,463,2471,L,104,111,-7
4942,464,2471,W,111,104,7
4943,254,2472,L,109,116,-7
4944,253,2472,W,116,109,7
4945,32,2473,L,112,126,-14
4946,31,2473,W,126,112,14
4947,266,2474,L,132,133,-1
4948,265,2474,W,133,132,1
4949,415,2475,L,106,127,-21
4950,416,2475,W,127,106,21
4951,351,2476,W,125,124,1
4952,352,2476,L,124,125,-1
4953,68,2477,L,113,124,-11
4954,67,2477,W,124,113,11
4955,215,2478,W,92,84,8
4956,216,2478,L,84,92,-8
4957,636,2479,L,91,101,-10
4958,635,2479,W,101,91,10
4959,380,2480,L,109,115,-6
4960,379,2480,W,115,109,6
4961,402,2481,L,103,123,-20
4962,401,2481,W,123,103,20
4963,195,2482,W,93,90,3
4964,196,2482,L,90,93,-3
4965,16,2483,W,143,142,1
4966,15,2483,L,142,143,-1
4967,369,2484,L,98,100,-2
4968,370,2484,W,100,98,2
4969,346,2485,L,112,115,-3
4970,345,2485,W,115,112,3
4971,425,2486,W,131,120,11
4972,426,2486,L,120,131,-11
4973,493,2487,W,133,111,22
4974,494,2487,L,111,133,-22
4975,382,2488,L,136,140,-4
4976,381,2488,W,140,136,4
4977,638,2489,W,117,113,4
4978,637,2489,L,113,117,-4
4979,670,2490,W,118,116,2
4980,669,2490,L,116,118,-2
4981,4,2491,L,115,116,-1
4982,3,2491,W,116,115,1
4983,533,2492,L,108,121,-13
4984,534,2492,W,121,108,13
4985,269,2493,W,113,112,1
4986,270,2493,L,112,113,-1
4987,129,2494,W,124,115,9
4988,130,2494,L,115,124,-9
4989,501,2495,L,112,132,-20
4990,502,2495,W,132,112,20
4991,811,2496,W,103,101,2
4992,812,2496,L,101,103,-2
4993,520,2497,L,91,119,-28
4994,519,2497,W,119,91,28
4995,700,2498,L,123,131,-8
4996,699,2498,W,131,123,8
4997,359,2499,L,101,118,-17
4998,360,2499,W,118,101,17
4999,592,2500,L,105,107,-2
5000,591,2500,W,107,105,2
5001,178,2501,L,129,149,-20
5002,177,2501,W,149,129,20
5003,556,2502,W,120,88,32
5004,555,2502,L,88,120,-32
5005,608,2503,W,124,123,1
5006,607,2503,L,123,124,-1
5007,131,2504,L,101,113,-12
5008,132,2504,W,113,101,12
5009,147,2505,L,92,108,-16
5010,148,2505,W,108,92,16
5011,77,2506,L,117,131,-14
5012,78,2506,W,131,117,14
5013,46,2507,L,119,128,-9
5014,45,2507,W,128,119,9
5015,513,2508,L,108,127,-19
5016,514,2508,W,127,108,19
5017,307,2509,W,113,112,1
5018,308,2509,L,112,113,-1
5019,117,2510,L,100,121,-21
5020,118,2510,W,121,100,21
5021,88,2511,W,107,98,9
5022,87,2511,L,98,107,-9
5023,387,2512,W,113,112,1
5024,388,2512,L,112,113,-1
5025,817,2513,L,108,112,-4
5026,818,2513,W,112,108,4
5027,572,2514,L,104,116,-12
5028,571,2514,W,116,104,12
5029,576,2515,L,100,103,-3
5030,575,2515,W,103,100,3
5031,628,2516,W,123,117,6
5032,627,2516,L,117,123,-6
5033,272,2517,L,107,126,-19
5034,271,2517,W,126,107,19
5035,810,2518,L,83,111,-28
5036,809,2518,W,111,83,28
5037,561,2519,W,131,112,19
5038,562,2519,L,112,131,-19
5039,115,2520,L,101,104,-3
5040,116,2520,W,104,101,3
5041,827,2521,L,100,108,-8
5042,828,2521,W,108,100,8
5043,144,2522,L,87,105,-18
5044,143,2522,W,105,87,18
5045,563,2523,W,108,85,23
5046,564,2523,L,85,108,-23
5047,563,2524,W,110,102,8
5048,564,2524,L,102,110,-8
5049,564,2525,L,103,122,-19
5050,563,2525,W,122,103,19
5051,564,2526,L,114,124,-10
5052,563,2526,W,124,114,10
5053,484,2527,W,101,92,9
5054,483,2527,L,92,101,-9
5055,354,2528,W,87,79,8
5056,353,2528,L,79,87,-8
5057,483,2529,L,86,115,-29
5058,484,2529,W,115,86,29
5059,353,2530,L,99,109,-10
5060,354,2530,W,109,99,10
5061,484,2531,L,94,98,-4
5062,483,2531,W,98,94,4
5063,354,2532,L,83,96,-13
5064,353,2532,W,96,83,13
5065,483,2533,W,95,92,3
5066,484,2533,L,92,95,-3
5067,353,2534,L,102,111,-9
5068,354,2534,W,111,102,9
5069,483,2535,L,85,126,-41
5070,484,2535,W,126,85,41
5071,353,2536,L,86,116,-30
5072,354,2536,W,116,86,30
5073,484,2537,L,105,127,-22
5074,483,2537,W,127,105,22
5075,354,2538,L,94,107,-13
5076,353,2538,W,107,94,13
5077,484,2539,W,119,106,13
5078,483,2539,L,106,119,-13
5079,354,2540,L,83,108,-25
5080,353,2540,W,108,83,25
5081,144,2541,L,112,114,-2
5082,143,2541,W,114,112,2
5083,449,2542,L,104,113,-9
5084,450,2542,W,113,104,9
5085,462,2543,L,102,112,-10
5086,461,2543,W,112,102,10
5087,143,2544,L,92,103,-11
5088,144,2544,W,103,92,11
5089,571,2545,L,93,128,-35
5090,572,2545,W,128,93,35
5091,461,2546,W,100,87,13
5092,462,2546,L,87,100,-13
5093,450,2547,W,118,92,26
5094,449,2547,L,92,118,-26
5095,143,2548,W,101,98,3
5096,144,2548,L,98,101,-3
5097,571,2549,L,103,105,-2
5098,572,2549,W,105,103,2
5099,450,2550,L,100,119,-19
5100,449,2550,W,119,100,19
5101,461,2551,W,113,92,21
5102,462,2551,L,92,113,-21
5103,144,2552,L,103,108,-5
5104,143,2552,W,108,103,5
5105,572,2553,W,128,110,18
5106,571,2553,L,110,128,-18
5107,462,2554,W,116,108,8
5108,461,2554,L,108,116,-8
5109,449,2555,L,116,121,-5
5110,450,2555,W,121,116,5
5111,572,2556,W,113,112,1
5112,571,2556,L,112,113,-1
5113,144,2557,L,101,117,-16
5114,143,2557,W,117,101,16
5115,462,2558,L,96,110,-14
5116,461,2558,W,110,96,14
5117,12,2559,L,101,105,-4
5118,11,2559,W,105,101,4
5119,99,2560,L,96,112,-16
5120,100,2560,W,112,96,16
5121,449,2561,L,101,123,-22
5122,450,2561,W,123,101,22
5123,52,2562,L,91,96,-5
5124,51,2562,W,96,91,5
5125,638,2563,W,102,92,10
5126,637,2563,L,92,102,-10
5127,11,2564,L,87,121,-34
5128,12,2564,W,121,87,34
5129,100,2565,L,86,97,-11
5130,99,2565,W,97,86,11
5131,51,2566,L,99,107,-8
5132,52,2566,W,107,99,8
5133,637,2567,L,98,108,-10
5134,638,2567,W,108,98,10
5135,287,2568,L,104,122,-18
5136,288,2568,W,122,104,18
5137,12,2569,L,95,98,-3
5138,11,2569,W,98,95,3
5139,722,2570,L,91,99,-8
5140,721,2570,W,99,91,8
5141,558,2571,L,91,104,-13
5142,557,2571,W,104,91,13
5143,99,2572,L,87,92,-5
5144,100,2572,W,92,87,5
5145,52,2573,L,96,113,-17
5146,51,2573,W,113,96,17
5147,288,2574,W,119,100,19
5148,287,2574,L,100,119,-19
5149,100,2575,L,102,104,-2
5150,99,2575,W,104,102,2
5151,11,2576,W,104,100,4
5152,12,2576,L,100,104,-4
5153,638,2577,L,98,106,-8
5154,637,2577,W,106,98,8
5155,721,2578,L,90,103,-13
5156,722,2578,W,103,90,13
5157,557,2579,W,106,102,4
5158,558,2579,L,102,106,-4
5159,476,2580,L,123,131,-8
5160,475,2580,W,131,123,8
5161,288,2581,L,105,121,-16
5162,287,2581,W,121,105,16
5163,52,2582,L,102,115,-13
5164,51,2582,W,115,102,13
5165,100,2583,L,92,116,-24
5166,99,2583,W,116,92,24
5167,11,2584,L,90,92,-2
5168,12,2584,W,92,90,2
5169,638,2585,L,103,122,-19
5170,637,2585,W,122,103,19
5171,476,2586,L,102,119,-17
5172,475,2586,W,119,102,17
5173,721,2587,W,110,97,13
5174,722,2587,L,97,110,-13
5175,557,2588,W,128,108,20
5176,558,2588,L,108,128,-20
5177,51,2589,W,102,95,7
5178,52,2589,L,95,102,-7
5179,12,2590,L,97,100,-3
5180,11,2590,W,100,97,3
5181,287,2591,L,82,102,-20
5182,288,2591,W,102,82,20
5183,637,2592,L,119,130,-11
5184,638,2592,W,130,119,11
5185,99,2593,L,106,120,-14
5186,100,2593,W,120,106,14
5187,475,2594,W,111,102,9
5188,476,2594,L,102,111,-9
5189,722,2595,L,101,116,-15
5190,721,2595,W,116,101,15
5191,558,2596,W,113,103,10
5192,557,2596,L,103,113,-10
5193,51,2597,L,108,116,-8
5194,52,2597,W,116,108,8
5195,287,2598,L,101,104,-3
5196,288,2598,W,104,101,3
5197,12,2599,W,98,80,18
5198,11,2599,L,80,98,-18
5199,99,2600,L,107,113,-6
5200,100,2600,W,113,107,6
5201,722,2601,L,92,113,-21
5202,721,2601,W,113,92,21
5203,637,2602,L,106,114,-8
5204,638,2602,W,114,106,8
5205,558,2603,L,103,130,-27
5206,557,2603,W,130,103,27
5207,475,2604,W,97,95,2
5208,476,2604,L,95,97,-2
5209,97,2605,L,93,102,-9
5210,98,2605,W,102,93,9
5211,8,2606,L,83,96,-13
5212,7,2606,W,96,83,13
5213,460,2607,L,106,112,-6
5214,459,2607,W,112,106,6
5215,55,2608,L,98,122,-24
5216,56,2608,W,122,98,24
5217,670,2609,W,119,87,32
5218,669,2609,L,87,119,-32
5219,58,2610,L,92,101,-9
5220,57,2610,W,101,92,9
5221,231,2611,L,109,116,-7
5222,232,2611,W,116,109,7
5223,29,2612,W,110,98,12
5224,30,2612,L,98,110,-12
5225,120,2613,W,115,100,15
5226,119,2613,L,100,115,-15
5227,91,2614,L,97,110,-13
5228,92,2614,W,110,97,13
5229,466,2615,L,95,130,-35
5230,465,2615,W,130,95,35
5231,208,2616,L,123,137,-14
5232,207,2616,W,137,123,14
5233,118,2617,W,124,97,27
5234,117,2617,L,97,124,-27
5235,608,2618,L,79,119,-40
5236,607,2618,W,119,79,40
5237,156,2619,L,101,113,-12
5238,155,2619,W,113,101,12
5239,437,2620,W,119,93,26
5240,438,2620,L,93,119,-26
5241,446,2621,W,121,113,8
5242,445,2621,L,113,121,-8
5243,129,2622,W,105,99,6
5244,130,2622,L,99,105,-6
5245,253,2623,W,113,100,13
5246,254,2623,L,100,113,-13
5247,209,2624,L,82,88,-6
5248,210,2624,W,88,82,6
5249,137,2625,L,86,102,-16
5250,138,2625,W,102,86,16
5251,30,2626,W,123,109,14
5252,29,2626,L,109,123,-14
5253,686,2627,L,94,113,-19
5254,685,2627,W,113,94,19
5255,261,2628,L,85,98,-13
5256,262,2628,W,98,85,13
5257,297,2629,L,105,114,-9
5258,298,2629,W,114,105,9
5259,565,2630,W,108,98,10
5260,566,2630,L,98,108,-10
5261,168,2631,W,115,93,22
5262,167,2631,L,93,115,-22
5263,668,2632,L,97,109,-12
5264,667,2632,W,109,97,12
5265,230,2633,W,112,97,15
5266,229,2633,L,97,112,-15
5267,549,2634,L,117,130,-13
5268,550,2634,W,130,117,13
5269,214,2635,L,101,112,-11
5270,213,2635,W,112,101,11
5271,401,2636,W,117,100,17
5272,402,2636,L,100,117,-17
5273,438,2637,W,123,117,6
5274,437,2637,L,117,123,-6
5275,523,2638,W,112,106,6
5276,524,2638,L,106,112,-6
5277,67,2639,W,115,102,13
5278,68,2639,L,102,115,-13
5279,133,2640,W,108,102,6
5280,134,2640,L,102,108,-6
5281,449,2641,W,126,120,6
5282,450,2641,L,120,126,-6
5283,88,2642,W,134,115,19
5284,87,2642,L,115,134,-19
5285,534,2643,L,105,116,-11
5286,533,2643,W,116,105,11
5287,298,2644,W,124,96,28
5288,297,2644,L,96,124,-28
5289,70,2645,L,130,132,-2
5290,69,2645,W,132,130,2
5291,63,2646,W,113,96,17
5292,64,2646,L,96,113,-17
5293,407,2647,W,94,93,1
5294,408,2647,L,93,94,-1
5295,556,2648,W,137,100,37
5296,555,2648,L,100,137,-37
5297,653,2649,L,104,111,-7
5298,654,2649,W,111,104,7
5299,665,2650,L,98,122,-24
5300,666,2650,W,122,98,24
5301,325,2651,W,103,97,6
5302,326,2651,L,97,103,-6
5303,769,2652,L,106,113,-7
5304,770,2652,W,113,106,7
5305,27,2653,W,122,103,19
5306,28,2653,L,103,122,-19
5307,453,2654,L,73,92,-19
5308,454,2654,W,92,73,19
5309,596,2655,L,106,126,-20
5310,595,2655,W,126,106,20
5311,472,2656,L,115,119,-4
5312,471,2656,W,119,115,4
5313,459,2657,L,96,100,-4
5314,460,2657,W,100,96,4
5315,74,2658,L,94,96,-2
5316,73,2658,W,96,94,2
5317,730,2659,L,95,117,-22
5318,729,2659,W,117,95,22
5319,227,2660,W,119,111,8
5320,228,2660,L,111,119,-8
5321,266,2661,W,115,108,7
5322,265,2661,L,108,115,-7
5323,233,2662,L,95,123,-28
5324,234,2662,W,123,95,28
5325,473,2663,L,100,105,-5
5326,474,2663,W,105,100,5
5327,16,2664,L,112,122,-10
5328,15,2664,W,122,112,10
5329,479,2665,W,115,86,29
5330,480,2665,L,86,115,-29
5331,131,2666,L,78,96,-18
5332,132,2666,W,96,78,18
5333,480,2667,L,98,101,-3
5334,479,2667,W,101,98,3
5335,856,2668,L,104,120,-16
5336,855,2668,W,120,104,16
5337,621,2669,L,104,107,-3
5338,622,2669,W,107,104,3
5339,535,2670,W,97,73,24
5340,536,2670,L,73,97,-24
5341,571,2671,L,106,112,-6
5342,572,2671,W,112,106,6
5343,481,2672,L,95,121,-26
5344,482,2672,W,121,95,26
5345,487,2673,L,114,120,-6
5346,488,2673,W,120,114,6
5347,54,2674,L,94,97,-3
5348,53,2674,W,97,94,3
5349,229,2675,L,110,117,-7
5350,230,2675,W,117,110,7
5351,100,2676,L,102,106,-4
5352,99,2676,W,106,102,4
5353,173,2677,L,109,115,-6
5354,174,2677,W,115,109,6
5355,828,2678,W,111,107,4
5356,827,2678,L,107,111,-4
5357,547,2679,L,110,113,-3
5358,548,2679,W,113,110,3
5359,145,2680,L,98,113,-15
5360,146,2680,W,113,98,15
5361,6,2681,W,109,104,5
5362,5,2681,L,104,109,-5
5363,159,2682,W,84,83,1
5364,160,2682,L,83,84,-1
5365,80,2683,W,121,97,24
5366,79,2683,L,97,121,-24
5367,402,2684,L,107,117,-10
5368,401,2684,W,117,107,10
5369,834,2685,L,87,98,-11
5370,833,2685,W,98,87,11
5371,782,2686,W,111,104,7
5372,781,2686,L,104,111,-7
5373,169,2687,L,83,100,-17
5374,170,2687,W,100,83,17
5375,10,2688,L,94,113,-19
5376,9,2688,W,113,94,19
5377,844,2689,W,119,102,17
5378,843,2689,L,102,119,-17
5379,427,2690,L,88,94,-6
5380,428,2690,W,94,88,6
5381,289,2691,L,125,128,-3
5382,290,2691,W,128,125,3
5383,575,2692,W,108,96,12
5384,576,2692,L,96,108,-12
5385,436,2693,W,112,96,16
5386,435,2693,L,96,112,-16
5387,132,2694,L,99,110,-11
5388,131,2694,W,110,99,11
5389,569,2695,L,93,107,-14
5390,570,2695,W,107,93,14
5391,395,2696,W,110,109,1
5392,396,2696,L,109,110,-1
5393,295,2697,W,115,109,6
5394,296,2697,L,109,115,-6
5395,215,2698,L,97,107,-10
5396,216,2698,W,107,97,10
5397,239,2699,W,126,125,1
5398,240,2699,L,125,126,-1
5399,18,2700,L,96,105,-9
5400,17,2700,W,105,96,9
5401,337,2701,W,124,122,2
5402,338,2701,L,122,124,-2
5403,382,2702,W,93,92,1
5404,381,2702,L,92,93,-1
5405,446,2703,W,101,91,10
5406,445,2703,L,91,101,-10
5407,737,2704,W,90,82,8
5408,738,2704,L,82,90,-8
5409,530,2705,L,103,104,-1
5410,529,2705,W,104,103,1
5411,420,2706,L,102,107,-5
5412,419,2706,W,107,102,5
5413,742,2707,W,106,103,3
5414,741,2707,L,103,106,-3
5415,787,2708,L,92,103,-11
5416,788,2708,W,103,92,11
5417,96,2709,W,116,107,9
5418,95,2709,L,107,116,-9
5419,618,2710,L,92,103,-11
5420,617,2710,W,103,92,11
5421,458,2711,L,99,103,-4
5422,457,2711,W,103,99,4
5423,93,2712,L,93,103,-10
5424,94,2712,W,103,93,10
5425,84,2713,L,101,118,-17
5426,83,2713,W,118,101,17
5427,104,2714,W,118,105,13
5428,103,2714,L,105,118,-13
5429,224,2715,W,111,99,12
5430,223,2715,L,99,111,-12
5431,179,2716,W,111,104,7
5432,180,2716,L,104,111,-7
5433,336,2717,W,97,94,3
5434,335,2717,L,94,97,-3
5435,146,2718,L,103,108,-5
5436,145,2718,W,108,103,5
5437,543,2719,L,114,126,-12
5438,544,2719,W,126,114,12
5439,846,2720,L,86,118,-32
5440,845,2720,W,118,86,32
5441,835,2721,L,106,116,-10
5442,836,2721,W,116,106,10
5443,221,2722,W,103,97,6
5444,222,2722,L,97,103,-6
5445,476,2723,W,107,103,4
5446,475,2723,L,103,107,-4
5447,448,2724,L,79,98,-19
5448,447,2724,W,98,79,19
5449,790,2725,L,98,105,-7
5450,789,2725,W,105,98,7
5451,149,2726,L,110,114,-4
5452,150,2726,W,114,110,4
5453,595,2727,W,92,81,11
5454,596,2727,L,81,92,-11
5455,777,2728,L,104,123,-19
5456,778,2728,W,123,104,19
5457,702,2729,L,106,112,-6
5458,701,2729,W,112,106,6
5459,429,2730,L,128,137,-9
5460,430,2730,W,137,128,9
5461,686,2731,W,101,93,8
5462,685,2731,L,93,101,-8
5463,626,2732,W,102,94,8
5464,625,2732,L,94,102,-8
5465,696,2733,L,103,106,-3
5466,695,2733,W,106,103,3
5467,629,2734,W,108,105,3
5468,630,2734,L,105,108,-3
5469,775,2735,W,117,106,11
5470,776,2735,L,106,117,-11
5471,140,2736,L,107,113,-6
5472,139,2736,W,113,107,6
5473,607,2737,W,110,91,19
5474,608,2737,L,91,110,-19
5475,279,2738,W,101,97,4
5476,280,2738,L,97,101,-4
5477,822,2739,W,121,114,7
5478,821,2739,L,114,121,-7
5479,826,2740,W,104,93,11
5480,825,2740,L,93,104,-11
5481,684,2741,L,99,118,-19
5482,683,2741,W,118,99,19
5483,678,2742,L,99,105,-6
5484,677,2742,W,105,99,6
5485,561,2743,L,91,114,-23
5486,562,2743,W,114,91,23
5487,669,2744,L,95,117,-22
5488,670,2744,W,117,95,22
5489,403,2745,W,100,93,7
5490,404,2745,L,93,100,-7
5491,19,2746,W,102,98,4
5492,20,2746,L,98,102,-4
5493,853,2747,L,108,120,-12
5494,854,2747,W,120,108,12
5495,248,2748,W,105,100,5
5496,247,2748,L,100,105,-5
5497,864,2749,L,95,120,-25
5498,863,2749,W,120,95,25
5499,158,2750,L,120,124,-4
5500,157,2750,W,124,120,4
5501,616,2751,W,118,105,13
5502,615,2751,L,105,118,-13
5503,781,2752,L,104,109,-5
5504,782,2752,W,109,104,5
5505,167,2753,L,99,105,-6
5506,168,2753,W,105,99,6
5507,868,2754,W,108,104,4
5508,867,2754,L,104,108,-4
5509,142,2755,L,112,116,-4
5510,141,2755,W,116,112,4
5511,808,2756,L,94,106,-12
5512,807,2756,W,106,94,12
5513,705,2757,W,108,100,8
5514,706,2757,L,100,108,-8
5515,759,2758,L,96,100,-4
5516,760,2758,W,100,96,4
5517,728,2759,L,79,140,-61
5518,727,2759,W,140,79,61
5519,383,2760,L,125,128,-3
5520,384,2760,W,128,125,3
5521,3,2761,W,118,98,20
5522,4,2761,L,98,118,-20
5523,850,2762,L,90,105,-15
5524,849,2762,W,105,90,15
5525,184,2763,W,119,112,7
5526,183,2763,L,112,119,-7
5527,571,2764,L,129,132,-3
5528,572,2764,W,132,129,3
5529,836,2765,L,90,98,-8
5530,835,2765,W,98,90,8
5531,870,2766,W,135,102,33
5532,869,2766,L,102,135,-33
5533,60,2767,W,111,105,6
5534,59,2767,L,105,111,-6
5535,522,2768,L,92,96,-4
5536,521,2768,W,96,92,4
5537,531,2769,L,105,119,-14
5538,532,2769,W,119,105,14
5539,789,2770,W,127,120,7
5540,790,2770,L,120,127,-7
5541,666,2771,L,98,119,-21
5542,665,2771,W,119,98,21
5543,413,2772,W,115,88,27
5544,414,2772,L,88,115,-27
5545,299,2773,L,99,100,-1
5546,300,2773,W,100,99,1
5547,73,2774,W,115,111,4
5548,74,2774,L,111,115,-4
5549,744,2775,W,99,94,5
5550,743,2775,L,94,99,-5
5551,358,2776,L,105,115,-10
5552,357,2776,W,115,105,10
5553,38,2777,L,109,123,-14
5554,37,2777,W,123,109,14
5555,213,2778,W,93,86,7
5556,214,2778,L,86,93,-7
5557,764,2779,L,117,124,-7
5558,763,2779,W,124,117,7
5559,843,2780,L,94,108,-14
5560,844,2780,W,108,94,14
5561,399,2781,L,92,110,-18
5562,400,2781,W,110,92,18
5563,721,2782,L,75,89,-14
5564,722,2782,W,89,75,14
5565,47,2783,L,115,118,-3
5566,48,2783,W,118,115,3
5567,199,2784,L,100,110,-10
5568,200,2784,W,110,100,10
5569,256,2785,L,141,149,-8
5570,255,2785,W,149,141,8
5571,389,2786,W,106,90,16
5572,390,2786,L,90,106,-16
5573,17,2787,W,122,109,13
5574,18,2787,L,109,122,-13
5575,288,2788,W,129,120,9
5576,287,2788,L,120,129,-9
5577,587,2789,L,89,108,-19
5578,588,2789,W,108,89,19
5579,644,2790,W,132,125,7
5580,643,2790,L,125,132,-7
5581,736,2791,L,117,122,-5
5582,735,2791,W,122,117,5
5583,451,2792,L,87,100,-13
5584,452,2792,W,100,87,13
5585,430,2793,L,101,124,-23
5586,429,2793,W,124,101,23
5587,401,2794,W,124,109,15
5588,402,2794,L,109,124,-15
5589,817,2795,L,101,117,-16
5590,818,2795,W,117,101,16
5591,627,2796,L,97,103,-6
5592,628,2796,W,103,97,6
5593,577,2797,L,94,101,-7
5594,578,2797,W,101,94,7
5595,273,2798,W,114,109,5
5596,274,2798,L,109,114,-5
5597,237,2799,L,102,109,-7
5598,238,2799,W,109,102,7
5599,710,2800,L,106,114,-8
5600,709,2800,W,114,106,8
5601,562,2801,W,107,101,6
5602,561,2801,L,101,107,-6
5603,481,2802,L,116,120,-4
5604,482,2802,W,120,116,4
5605,196,2803,W,92,83,9
5606,195,2803,L,83,92,-9
5607,739,2804,L,115,122,-7
5608,740,2804,W,122,115,7
5609,148,2805,L,113,121,-8
5610,147,2805,W,121,113,8
5611,435,2806,W,98,93,5
5612,436,2806,L,93,98,-5
5613,124,2807,W,92,91,1
5614,123,2807,L,91,92,-1
5615,291,2808,W,129,117,12
5616,292,2808,L,117,129,-12
5617,800,2809,W,111,110,1
5618,799,2809,L,110,111,-1
5619,439,2810,L,113,120,-7
5620,440,2810,W,120,113,7
5621,454,2811,W,106,99,7
5622,453,2811,L,99,106,-7
5623,1,2812,L,88,116,-28
5624,2,2812,W,116,88,28
5625,345,2813,L,96,101,-5
5626,346,2813,W,101,96,5
5627,56,2814,L,93,98,-5
5628,55,2814,W,98,93,5
5629,832,2815,L,105,113,-8
5630,831,2815,W,113,105,8
5631,83,2816,W,118,110,8
5632,84,2816,L,110,118,-8
5633,421,2817,L,106,117,-11
5634,422,2817,W,117,106,11
5635,155,2818,W,125,124,1
5636,156,2818,L,124,125,-1
5637,527,2819,L,119,123,-4
5638,528,2819,W,123,119,4
5639,138,2820,L,117,126,-9
5640,137,2820,W,126,117,9
5641,393,2821,L,72,108,-36
5642,394,2821,W,108,72,36
5643,600,2822,W,119,107,12
5644,599,2822,L,107,119,-12
5645,848,2823,L,115,119,-4
5646,847,2823,W,119,115,4
5647,141,2824,W,116,102,14
5648,142,2824,L,102,116,-14
5649,127,2825,L,103,112,-9
5650,128,2825,W,112,103,9
5651,838,2826,W,116,111,5
5652,837,2826,L,111,116,-5
5653,863,2827,W,129,107,22
5654,864,2827,L,107,129,-22
5655,322,2828,L,79,110,-31
5656,321,2828,W,110,79,31
5657,839,2829,W,110,97,13
5658,840,2829,L,97,110,-13
5659,761,2830,W,112,106,6
5660,762,2830,L,106,112,-6
5661,250,2831,W,101,98,3
5662,249,2831,L,98,101,-3
5663,161,2832,W,121,103,18
5664,162,2832,L,103,121,-18
5665,511,2833,L,99,115,-16
5666,512,2833,W,115,99,16
5667,170,2834,L,93,109,-16
5668,169,2834,W,109,93,16
5669,425,2835,L,101,106,-5
5670,426,2835,W,106,101,5
5671,263,2836,W,116,99,17
5672,264,2836,L,99,116,-17
5673,482,2837,W,120,97,23
5674,481,2837,L,97,120,-23
5675,14,2838,W,132,106,26
5676,13,2838,L,106,132,-26
5677,102,2839,W,129,122,7
5678,101,2839,L,122,129,-7
5679,713,2840,L,103,109,-6
5680,714,2840,W,109,103,6
5681,259,2841,W,105,82,23
5682,260,2841,L,82,105,-23
5683,657,2842,L,113,127,-14
5684,658,2842,W,127,113,14
5685,42,2843,W,99,97,2
5686,41,2843,L,97,99,-2
5687,32,2844,L,104,130,-26
5688,31,2844,W,130,104,26
5689,590,2845,L,105,113,-8
5690,589,2845,W,113,105,8
5691,457,2846,L,94,104,-10
5692,458,2846,W,104,94,10
5693,662,2847,L,115,122,-7
5694,661,2847,W,122,115,7
5695,333,2848,L,80,114,-34
5696,334,2848,W,114,80,34
5697,308,2849,L,102,129,-27
5698,307,2849,W,129,102,27
5699,708,2850,L,87,112,-25
5700,707,2850,W,112,87,25
5701,216,2851,W,95,78,17
5702,215,2851,L,78,95,-17
5703,797,2852,L,105,108,-3
5704,798,2852,W,108,105,3
5705,518,2853,L,102,116,-14
5706,517,2853,W,116,102,14
5707,128,2854,L,116,125,-9
5708,127,2854,W,125,116,9
5709,246,2855,L,88,94,-6
5710,245,2855,W,94,88,6
5711,669,2856,L,83,99,-16
5712,670,2856,W,99,83,16
5713,611,2857,L,108,125,-17
5714,612,2857,W,125,108,17
5715,203,2858,W,116,97,19
5716,204,2858,L,97,116,-19
5717,68,2859,L,112,120,-8
5718,67,2859,W,120,112,8
5719,59,2860,W,125,111,14
5720,60,2860,L,111,125,-14
5721,722,2861,L,107,110,-3
5722,721,2861,W,110,107,3
5723,477,2862,W,117,109,8
5724,478,2862,L,109,117,-8
5725,182,2863,L,87,115,-28
5726,181,2863,W,115,87,28
5727,557,2864,L,99,108,-9
5728,558,2864,W,108,99,9
5729,565,2865,W,121,119,2
5730,566,2865,L,119,121,-2
5731,799,2866,L,110,119,-9
5732,800,2866,W,119,110,9
5733,177,2867,W,114,101,13
5734,178,2867,L,101,114,-13
5735,242,2868,W,110,99,11
5736,241,2868,L,99,110,-11
5737,614,2869,W,104,84,20
5738,613,2869,L,84,104,-20
5739,645,2870,L,107,108,-1
5740,646,2870,W,108,107,1
5741,320,2871,W,113,108,5
5742,319,2871,L,108,113,-5
5743,720,2872,L,87,111,-24
5744,719,2872,W,111,87,24
5745,844,2873,W,128,114,14
5746,843,2873,L,114,128,-14
5747,134,2874,W,122,112,10
5748,133,2874,L,112,122,-10
5749,579,2875,L,90,106,-16
5750,580,2875,W,106,90,16
5751,122,2876,L,101,114,-13
5752,121,2876,W,114,101,13
5753,307,2877,L,113,117,-4
5754,308,2877,W,117,113,4
5755,253,2878,W,121,116,5
5756,254,2878,L,116,121,-5
5757,267,2879,L,107,118,-11
5758,268,2879,W,118,107,11
5759,72,2880,L,90,112,-22
5760,71,2880,W,112,90,22
5761,110,2881,L,98,100,-2
5762,109,2881,W,100,98,2
5763,654,2882,W,105,89,16
5764,653,2882,L,89,105,-16
5765,704,2883,L,80,94,-14
5766,703,2883,W,94,80,14
5767,360,2884,L,89,92,-3
5768,359,2884,W,92,89,3
5769,201,2885,L,103,125,-22
5770,202,2885,W,125,103,22
5771,45,2886,W,108,103,5
5772,46,2886,L,103,108,-5
5773,357,2887,W,126,109,17
5774,358,2887,L,109,126,-17
5775,765,2888,L,99,102,-3
5776,766,2888,W,102,99,3
5777,465,2889,L,110,118,-8
5778,466,2889,W,118,110,8
5779,649,2890,L,112,113,-1
5780,650,2890,W,113,112,1
5781,237,2891,W,98,95,3
5782,238,2891,L,95,98,-3
5783,415,2892,L,98,103,-5
5784,416,2892,W,103,98,5
5785,193,2893,L,120,123,-3
5786,194,2893,W,123,120,3
5787,282,2894,L,100,107,-7
5788,281,2894,W,107,100,7
5789,406,2895,L,120,123,-3
5790,405,2895,W,123,120,3
5791,630,2896,L,100,108,-8
5792,629,2896,W,108,100,8
5793,841,2897,L,96,105,-9
5794,842,2897,W,105,96,9
5795,628,2898,W,98,91,7
5796,627,2898,L,91,98,-7
5797,319,2899,W,126,117,9
5798,320,2899,L,117,126,-9
5799,15,2900,W,116,112,4
5800,16,2900,L,112,116,-4
5801,359,2901,W,103,96,7
5802,360,2901,L,96,103,-7
5803,638,2902,W,102,95,7
5804,637,2902,L,95,102,-7
5805,843,2903,L,99,110,-11
5806,844,2903,W,110,99,11
5807,807,2904,W,114,109,5
5808,808,2904,L,109,114,-5
5809,697,2905,L,105,128,-23
5810,698,2905,W,128,105,23
5811,79,2906,L,108,116,-8
5812,80,2906,W,116,108,8
5813,577,2907,W,108,102,6
5814,578,2907,L,102,108,-6
5815,491,2908,L,106,115,-9
5816,492,2908,W,115,106,9
5817,379,2909,L,100,108,-8
5818,380,2909,W,108,100,8
5819,181,2910,W,124,116,8
5820,182,2910,L,116,124,-8
5821,680,2911,L,99,108,-9
5822,679,2911,W,108,99,9
5823,206,2912,L,111,116,-5
5824,205,2912,W,116,111,5
5825,123,2913,W,131,113,18
5826,124,2913,L,113,131,-18
5827,69,2914,W,108,97,11
5828,70,2914,L,97,108,-11
5829,707,2915,L,102,107,-5
5830,708,2915,W,107,102,5
5831,485,2916,L,87,110,-23
5832,486,2916,W,110,87,23
5833,582,2917,W,111,110,1
5834,581,2917,L,110,111,-1
5835,724,2918,L,106,134,-28
5836,723,2918,W,134,106,28
5837,56,2919,W,121,116,5
5838,55,2919,L,116,121,-5
5839,213,2920,W,117,104,13
5840,214,2920,L,104,117,-13
5841,386,2921,W,109,101,8
5842,385,2921,L,101,109,-8
5843,346,2922,W,105,92,13
5844,345,2922,L,92,105,-13
5845,585,2923,W,110,102,8
5846,586,2923,L,102,110,-8
5847,315,2924,L,99,116,-17
5848,316,2924,W,116,99,17
5849,821,2925,L,123,129,-6
5850,822,2925,W,129,123,6
5851,488,2926,L,103,118,-15
5852,487,2926,W,118,103,15
5853,557,2927,L,101,102,-1
5854,558,2927,W,102,101,1
5855,176,2928,W,107,104,3
5856,175,2928,L,104,107,-3
5857,87,2929,W,122,120,2
5858,88,2929,L,120,122,-2
5859,35,2930,L,105,112,-7
5860,36,2930,W,112,105,7
5861,772,2931,W,125,111,14
5862,771,2931,L,111,125,-14
5863,23,2932,L,98,109,-11
5864,24,2932,W,109,98,11
5865,311,2933,L,103,109,-6
5866,312,2933,W,109,103,6
5867,553,2934,W,118,100,18
5868,554,2934,L,100,118,-18
5869,757,2935,W,123,104,19
5870,758,2935,L,104,123,-19
5871,28,2936,L,116,125,-9
5872,27,2936,W,125,116,9
5873,297,2937,L,87,104,-17
5874,298,2937,W,104,87,17
5875,461,2938,W,96,85,11
5876,462,2938,L,85,96,-11
5877,566,2939,L,94,123,-29
5878,565,2939,W,123,94,29
5879,49,2940,W,119,114,5
5880,50,2940,L,114,119,-5
5881,546,2941,W,123,121,2
5882,545,2941,L,121,123,-2
5883,301,2942,W,110,94,16
5884,302,2942,L,94,110,-16
5885,506,2943,L,98,114,-16
5886,505,2943,W,114,98,16
5887,106,2944,L,94,109,-15
5888,105,2944,W,109,94,15
5889,160,2945,W,113,108,5
5890,159,2945,L,108,113,-5
5891,183,2946,L,90,97,-7
5892,184,2946,W,97,90,7
5893,349,2947,L,104,122,-18
5894,350,2947,W,122,104,18
5895,827,2948,L,80,112,-32
5896,828,2948,W,112,80,32
5897,811,2949,W,121,112,9
5898,812,2949,L,112,121,-9
5899,754,2950,L,89,115,-26
5900,753,2950,W,115,89,26
5901,4,2951,L,105,116,-11
5902,3,2951,W,116,105,11
5903,284,2952,W,106,104,2
5904,283,2952,L,104,106,-2
5905,224,2953,W,128,117,11
5906,223,2953,L,117,128,-11
5907,569,2954,W,122,105,17
5908,570,2954,L,105,122,-17
5909,186,2955,W,122,119,3
5910,185,2955,L,119,122,-3
5911,98,2956,W,100,81,19
5912,97,2956,L,81,100,-19
5913,642,2957,W,110,98,12
5914,641,2957,L,98,110,-12
5915,220,2958,L,119,122,-3
5916,219,2958,W,122,119,3
5917,631,2959,W,112,89,23
5918,632,2959,L,89,112,-23
5919,93,2960,L,102,124,-22
5920,94,2960,W,124,102,22
5921,90,2961,L,123,124,-1
5922,89,2961,W,124,123,1
5923,287,2962,L,102,120,-18
5924,288,2962,W,120,102,18
5925,708,2963,L,93,116,-23
5926,707,2963,W,116,93,23
5927,514,2964,W,116,115,1
5928,513,2964,L,115,116,-1
5929,536,2965,W,120,113,7
5930,535,2965,L,113,120,-7
5931,472,2966,W,110,103,7
5932,471,2966,L,103,110,-7
5933,275,2967,L,127,134,-7
5934,276,2967,W,134,127,7
5935,59,2968,L,96,111,-15
5936,60,2968,W,111,96,15
5937,426,2969,W,110,107,3
5938,425,2969,L,107,110,-3
5939,64,2970,L,111,119,-8
5940,63,2970,W,119,111,8
5941,290,2971,W,134,123,11
5942,289,2971,L,123,134,-11
5943,502,2972,W,108,103,5
5944,501,2972,L,103,108,-5
5945,556,2973,W,104,102,2
5946,555,2973,L,102,104,-2
5947,560,2974,W,122,98,24
5948,559,2974,L,98,122,-24
5949,207,2975,W,121,114,7
5950,208,2975,L,114,121,-7
5951,44,2976,L,98,104,-6
5952,43,2976,W,104,98,6
5953,489,2977,W,129,119,10
5954,490,2977,L,119,129,-10
5955,280,2978,W,118,113,5
5956,279,2978,L,113,118,-5
5957,7,2979,L,91,100,-9
5958,8,2979,W,100,91,9
5959,558,2980,L,102,104,-2
5960,557,2980,W,104,102,2
5961,611,2981,L,117,123,-6
5962,612,2981,W,123,117,6
5963,383,2982,L,117,139,-22
5964,384,2982,W,139,117,22
5965,1,2983,L,97,107,-10
5966,2,2983,W,107,97,10
5967,288,2984,W,126,108,18
5968,287,2984,L,108,126,-18
5969,220,2985,L,109,117,-8
5970,219,2985,W,117,109,8
5971,232,2986,L,112,115,-3
5972,231,2986,W,115,112,3
5973,539,2987,W,120,112,8
5974,540,2987,L,112,120,-8
5975,736,2988,L,92,97,-5
5976,735,2988,W,97,92,5
5977,222,2989,W,114,109,5
5978,221,2989,L,109,114,-5
5979,84,2990,L,92,108,-16
5980,83,2990,W,108,92,16
5981,738,2991,L,101,105,-4
5982,737,2991,W,105,101,4
5983,659,2992,W,118,103,15
5984,660,2992,L,103,118,-15
5985,194,2993,W,114,101,13
5986,193,2993,L,101,114,-13
5987,157,2994,L,99,101,-2
5988,158,2994,W,101,99,2
5989,402,2995,L,83,129,-46
5990,401,2995,W,129,83,46
5991,260,2996,L,97,104,-7
5992,259,2996,W,104,97,7
5993,208,2997,L,92,110,-18
5994,207,2997,W,110,92,18
5995,416,2998,W,123,103,20
5996,415,2998,L,103,123,-20
5997,97,2999,W,115,96,19
5998,98,2999,L,96,115,-19
5999,43,3000,L,115,118,-3
6000,44,3000,W,118,115,3
6001,107,3001,L,113,121,-8
6002,108,3001,W,121,113,8
6003,354,3002,W,121,99,22
6004,353,3002,L,99,121,-22
6005,554,3003,L,106,111,-5
6006,553,3003,W,111,106,5
6007,750,3004,W,138,128,10
6008,749,3004,L,128,138,-10
6009,138,3005,W,111,104,7
6010,137,3005,L,104,111,-7
6011,722,3006,L,105,122,-17
6012,721,3006,W,122,105,17
6013,10,3007,W,101,90,11
6014,9,3007,L,90,101,-11
6015,392,3008,L,98,112,-14
6016,391,3008,W,112,98,14
6017,94,3009,L,123,130,-7
6018,93,3009,W,130,123,7
6019,519,3010,W,123,113,10
6020,520,3010,L,113,123,-10
6021,42,3011,W,97,91,6
6022,41,3011,L,91,97,-6
6023,716,3012,W,108,95,13
6024,715,3012,L,95,108,-13
6025,494,3013,W,123,107,16
6026,493,3013,L,107,123,-16
6027,316,3014,W,118,100,18
6028,315,3014,L,100,118,-18
6029,673,3015,L,94,106,-12
6030,674,3015,W,106,94,12
6031,25,3016,L,85,91,-6
6032,26,3016,W,91,85,6
6033,350,3017,L,113,114,-1
6034,349,3017,W,114,113,1
6035,767,3018,L,82,100,-18
6036,768,3018,W,100,82,18
6037,50,3019,L,104,130,-26
6038,49,3019,W,130,104,26
6039,655,3020,L,103,109,-6
6040,656,3020,W,109,103,6
6041,428,3021,L,98,100,-2
6042,427,3021,W,100,98,2
6043,13,3022,L,88,113,-25
6044,14,3022,W,113,88,25
6045,651,3023,L,103,121,-18
6046,652,3023,W,121,103,18
6047,156,3024,W,110,104,6
6048,155,3024,L,104,110,-6
6049,217,3025,L,81,106,-25
6050,218,3025,W,106,81,25
6051,216,3026,W,92,88,4
6052,215,3026,L,88,92,-4
6053,576,3027,L,106,115,-9
6054,575,3027,W,115,106,9
6055,602,3028,W,129,81,48
6056,601,3028,L,81,129,-48
6057,699,3029,L,138,140,-2
6058,700,3029,W,140,138,2
6059,820,3030,W,109,101,8
6060,819,3030,L,101,109,-8
6061,131,3031,L,91,111,-20
6062,132,3031,W,111,91,20
6063,734,3032,W,123,113,10
6064,733,3032,L,113,123,-10
6065,503,3033,L,93,112,-19
6066,504,3033,W,112,93,19
6067,827,3034,W,125,105,20
6068,828,3034,L,105,125,-20
6069,67,3035,W,103,89,14
6070,68,3035,L,89,103,-14
6071,78,3036,L,82,108,-26
6072,77,3036,W,108,82,26
6073,105,3037,L,102,115,-13
6074,106,3037,W,115,102,13
6075,796,3038,L,98,116,-18
6076,795,3038,W,116,98,18
6077,263,3039,W,133,109,24
6078,264,3039,L,109,133,-24
6079,452,3040,L,91,111,-20
6080,451,3040,W,111,91,20
6081,65,3041,L,101,104,-3
6082,66,3041,W,104,101,3
6083,340,3042,L,104,121,-17
6084,339,3042,W,121,104,17
6085,238,3043,W,111,102,9
6086,237,3043,L,102,111,-9
6087,116,3044,W,111,109,2
6088,115,3044,L,109,111,-2
6089,598,3045,L,98,104,-6
6090,597,3045,W,104,98,6
6091,218,3046,W,108,104,4
6092,217,3046,L,104,108,-4
6093,272,3047,W,99,96,3
6094,271,3047,L,96,99,-3
6095,247,3048,L,96,97,-1
6096,248,3048,W,97,96,1
6097,661,3049,W,115,110,5
6098,662,3049,L,110,115,-5
6099,189,3050,L,86,101,-15
6100,190,3050,W,101,86,15
6101,228,3051,W,109,94,15
6102,227,3051,L,94,109,-15
6103,773,3052,W,120,88,32
6104,774,3052,L,88,120,-32
6105,58,3053,W,115,98,17
6106,57,3053,L,98,115,-17
6107,249,3054,L,92,100,-8
6108,250,3054,W,100,92,8
6109,158,3055,W,120,111,9
6110,157,3055,L,111,120,-9
6111,221,3056,W,106,99,7
6112,222,3056,L,99,106,-7
6113,303,3057,L,107,118,-11
6114,304,3057,W,118,107,11
6115,762,3058,L,103,113,-10
6116,761,3058,W,113,103,10
6117,369,3059,L,108,115,-7
6118,370,3059,W,115,108,7
6119,842,3060,L,107,111,-4
6120,841,3060,W,111,107,4
6121,558,3061,L,97,103,-6
6122,557,3061,W,103,97,6
6123,2,3062,W,129,97,32
6124,1,3062,L,97,129,-32
6125,523,3063,L,110,119,-9
6126,524,3063,W,119,110,9
6127,436,3064,W,119,104,15
6128,435,3064,L,104,119,-15
6129,5,3065,W,114,100,14
6130,6,3065,L,100,114,-14
6131,438,3066,L,126,133,-7
6132,437,3066,W,133,126,7
6133,689,3067,L,105,130,-25
6134,690,3067,W,130,105,25
6135,286,3068,W,102,99,3
6136,285,3068,L,99,102,-3
6137,68,3069,L,90,92,-2
6138,67,3069,W,92,90,2
6139,718,3070,L,89,108,-19
6140,717,3070,W,108,89,19
6141,550,3071,L,102,104,-2
6142,549,3071,W,104,102,2
6143,169,3072,W,102,91,11
6144,170,3072,L,91,102,-11
6145,240,3073,L,124,127,-3
6146,239,3073,W,127,124,3
6147,638,3074,L,119,122,-3
6148,637,3074,W,122,119,3
6149,447,3075,L,89,91,-2
6150,448,3075,W,91,89,2
6151,810,3076,L,101,105,-4
6152,809,3076,W,105,101,4
6153,812,3077,L,73,103,-30
6154,811,3077,W,103,73,30
6155,646,3078,L,105,127,-22
6156,645,3078,W,127,105,22
6157,482,3079,L,108,116,-8
6158,481,3079,W,116,108,8
6159,291,3080,W,123,110,13
6160,292,3080,L,110,123,-13
6161,117,3081,L,88,102,-14
6162,118,3081,W,102,88,14
6163,815,3082,L,108,124,-16
6164,816,3082,W,124,108,16
6165,178,3083,W,114,103,11
6166,177,3083,L,103,114,-11
6167,71,3084,L,114,125,-11
6168,72,3084,W,125,114,11
6169,507,3085,L,104,109,-5
6170,508,3085,W,109,104,5
6171,608,3086,L,99,129,-30
6172,607,3086,W,129,99,30
6173,188,3087,L,96,102,-6
6174,187,3087,W,102,96,6
6175,17,3088,W,104,96,8
6176,18,3088,L,96,104,-8
6177,591,3089,L,95,111,-16
6178,592,3089,W,111,95,16
6179,219,3090,L,104,106,-2
6180,220,3090,W,106,104,2
6181,313,3091,L,107,114,-7
6182,314,3091,W,114,107,7
6183,418,3092,W,95,88,7
6184,417,3092,L,88,95,-7
6185,465,3093,L,95,107,-12
6186,466,3093,W,107,95,12
6187,794,3094,W,111,110,1
6188,793,3094,L,110,111,-1
6189,585,3095,L,109,120,-11
6190,586,3095,W,120,109,11
6191,437,3096,L,96,105,-9
6192,438,3096,W,105,96,9
6193,544,3097,L,100,105,-5
6194,543,3097,W,105,100,5
6195,692,3098,L,112,122,-10
6196,691,3098,W,122,112,10
6197,616,3099,W,110,96,14
6198,615,3099,L,96,110,-14
6199,530,3100,L,102,113,-11
6200,529,3100,W,113,102,11
6201,72,3101,L,104,121,-17
6202,71,3101,W,121,104,17
6203,251,3102,L,111,123,-12
6204,252,3102,W,123,111,12
6205,261,3103,L,98,113,-15
6206,262,3103,W,113,98,15
6207,254,3104,W,112,103,9
6208,253,3104,L,103,112,-9
6209,225,3105,L,112,114,-2
6210,226,3105,W,114,112,2
6211,268,3106,L,89,91,-2
6212,267,3106,W,91,89,2
6213,725,3107,L,97,111,-14
6214,726,3107,W,111,97,14
6215,568,3108,L,105,109,-4
6216,567,3108,W,109,105,4
6217,269,3109,L,91,95,-4
6218,270,3109,W,95,91,4
6219,355,3110,W,121,108,13
6220,356,3110,L,108,121,-13
6221,326,3111,W,129,104,25
6222,325,3111,L,104,129,-25
6223,292,3112,L,110,121,-11
6224,291,3112,W,121,110,11
6225,227,3113,L,91,116,-25
6226,228,3113,W,116,91,25
6227,562,3114,L,113,115,-2
6228,561,3114,W,115,113,2
6229,173,3115,W,107,93,14
6230,174,3115,L,93,107,-14
6231,444,3116,W,109,100,9
6232,443,3116,L,100,109,-9
6233,294,3117,W,97,93,4
6234,293,3117,L,93,97,-4
6235,640,3118,W,107,85,22
6236,639,3118,L,85,107,-22
6237,851,3119,W,108,103,5
6238,852,3119,L,103,108,-5
6239,12,3120,L,108,115,-7
6240,11,3120,W,115,108,7
6241,236,3121,W,97,78,19
6242,235,3121,L,78,97,-19
6243,755,3122,L,118,130,-12
6244,756,3122,W,130,118,12
6245,714,3123,L,113,126,-13
6246,713,3123,W,126,113,13
6247,187,3124,L,112,121,-9
6248,188,3124,W,121,112,9
6249,528,3125,W,89,88,1
6250,527,3125,L,88,89,-1
6251,513,3126,L,101,115,-14
6252,514,3126,W,115,101,14
6253,321,3127,W,98,95,3
6254,322,3127,L,95,98,-3
6255,259,3128,W,104,97,7
6256,260,3128,L,97,104,-7
6257,490,3129,W,113,102,11
6258,489,3129,L,102,113,-11
6259,680,3130,L,114,123,-9
6260,679,3130,W,123,114,9
6261,580,3131,W,108,93,15
6262,579,3131,L,93,108,-15
6263,212,3132,L,101,116,-15
6264,211,3132,W,116,101,15
6265,847,3133,W,101,96,5
6266,848,3133,L,96,101,-5
6267,109,3134,W,108,85,23
6268,110,3134,L,85,108,-23
6269,455,3135,L,107,108,-1
6270,456,3135,W,108,107,1
6271,245,3136,W,105,99,6
6272,246,3136,L,99,105,-6
6273,302,3137,L,102,114,-12
6274,301,3137,W,114,102,12
6275,688,3138,L,108,109,-1
6276,687,3138,W,109,108,1
6277,771,3139,L,112,123,-11
6278,772,3139,W,123,112,11
6279,532,3140,L,101,105,-4
6280,531,3140,W,105,101,4
6281,37,3141,W,126,118,8
6282,38,3141,L,118,126,-8
6283,526,3142,L,75,98,-23
6284,525,3142,W,98,75,23
6285,751,3143,L,107,112,-5
6286,752,3143,W,112,107,5
6287,538,3144,L,128,132,-4
6288,537,3144,W,132,128,4
6289,819,3145,L,90,99,-9
6290,820,3145,W,99,90,9
6291,310,3146,L,105,109,-4
6292,309,3146,W,109,105,4
6293,743,3147,L,90,104,-14
6294,744,3147,W,104,90,14
6295,209,3148,L,101,104,-3
6296,210,3148,W,104,101,3
6297,576,3149,W,101,100,1
6298,575,3149,L,100,101,-1
6299,610,3150,L,107,127,-20
6300,609,3150,W,127,107,20
6301,195,3151,W,103,95,8
6302,196,3151,L,95,103,-8
6303,377,3152,W,94,86,8
6304,378,3152,L,86,94,-8
6305,540,3153,W,148,124,24
6306,539,3153,L,124,148,-24
6307,508,3154,L,109,115,-6
6308,507,3154,W,115,109,6
6309,484,3155,L,108,116,-8
6310,483,3155,W,116,108,8
6311,466,3156,L,94,116,-22
6312,465,3156,W,116,94,22
6313,730,3157,L,113,125,-12
6314,729,3157,W,125,113,12
6315,270,3158,W,106,105,1
6316,269,3158,L,105,106,-1
6317,233,3159,L,104,111,-7
6318,234,3159,W,111,104,7
6319,174,3160,L,108,117,-9
6320,173,3160,W,117,108,9
6321,102,3161,W,113,97,16
6322,101,3161,L,97,113,-16
6323,200,3162,L,86,99,-13
6324,199,3162,W,99,86,13
6325,407,3163,L,88,106,-18
6326,408,3163,W,106,88,18
6327,520,3164,W,108,100,8
6328,519,3164,L,100,108,-8
6329,396,3165,L,95,101,-6
6330,395,3165,W,101,95,6
6331,348,3166,W,117,115,2
6332,347,3166,L,115,117,-2
6333,618,3167,W,122,112,10
6334,617,3167,L,112,122,-10
6335,82,3168,L,83,86,-3
6336,81,3168,W,86,83,3
6337,424,3169,L,86,100,-14
6338,423,3169,W,100,86,14
6339,144,3170,W,89,80,9
6340,143,3170,L,80,89,-9
6341,287,3171,L,98,116,-18
6342,288,3171,W,116,98,18
6343,795,3172,L,103,104,-1
6344,796,3172,W,104,103,1
6345,866,3173,L,93,94,-1
6346,865,3173,W,94,93,1
6347,566,3174,L,91,96,-5
6348,565,3174,W,96,91,5
6349,574,3175,L,99,105,-6
6350,573,3175,W,105,99,6
6351,327,3176,W,100,95,5
6352,328,3176,L,95,100,-5
6353,628,3177,W,120,105,15
6354,627,3177,L,105,120,-15
6355,88,3178,L,104,109,-5
6356,87,3178,W,109,104,5
6357,218,3179,L,90,114,-24
6358,217,3179,W,114,90,24
6359,570,3180,L,109,133,-24
6360,569,3180,W,133,109,24
6361,61,3181,W,119,112,7
6362,62,3181,L,112,119,-7
6363,26,3182,W,106,101,5
6364,25,3182,L,101,106,-5
6365,283,3183,L,111,118,-7
6366,284,3183,W,118,111,7
6367,588,3184,W,116,113,3
6368,587,3184,L,113,116,-3
6369,268,3185,L,102,105,-3
6370,267,3185,W,105,102,3
6371,332,3186,L,102,108,-6
6372,331,3186,W,108,102,6
6373,425,3187,L,88,95,-7
6374,426,3187,W,95,88,7
6375,403,3188,L,114,123,-9
6376,404,3188,W,123,114,9
6377,592,3189,W,119,104,15
6378,591,3189,L,104,119,-15
6379,613,3190,W,109,94,15
6380,614,3190,L,94,109,-15
6381,788,3191,L,111,119,-8
6382,787,3191,W,119,111,8
6383,505,3192,W,118,107,11
6384,506,3192,L,107,118,-11
6385,346,3193,L,102,113,-11
6386,345,3193,W,113,102,11
6387,563,3194,W,118,108,10
6388,564,3194,L,108,118,-10
6389,634,3195,L,99,102,-3
6390,633,3195,W,102,99,3
6391,175,3196,W,104,95,9
6392,176,3196,L,95,104,-9
6393,39,3197,L,111,117,-6
6394,40,3197,W,117,111,6
6395,25,3198,L,79,97,-18
6396,26,3198,W,97,79,18
6397,679,3199,L,103,120,-17
6398,680,3199,W,120,103,17
6399,211,3200,W,120,97,23
6400,212,3200,L,97,120,-23
6401,675,3201,W,123,118,5
6402,676,3201,L,118,123,-5
6403,244,3202,L,113,119,-6
6404,243,3202,W,119,113,6
6405,219,3203,L,80,112,-32
6406,220,3203,W,112,80,32
6407,85,3204,W,101,91,10
6408,86,3204,L,91,101,-10
6409,469,3205,L,105,126,-21
6410,470,3205,W,126,105,21
6411,344,3206,W,127,125,2
6412,343,3206,L,125,127,-2
6413,670,3207,L,105,107,-2
6414,669,3207,W,107,105,2
6415,94,3208,W,107,101,6
6416,93,3208,L,101,107,-6
6417,22,3209,W,110,105,5
6418,21,3209,L,105,110,-5
6419,578,3210,L,78,87,-9
6420,577,3210,W,87,78,9
6421,674,3211,L,88,99,-11
6422,673,3211,W,99,88,11
6423,867,3212,L,108,118,-10
6424,868,3212,W,118,108,10
6425,11,3213,L,95,97,-2
6426,12,3213,W,97,95,2
6427,529,3214,W,112,95,17
6428,530,3214,L,95,112,-17
6429,476,3215,L,113,119,-6
6430,475,3215,W,119,113,6
6431,57,3216,L,119,125,-6
6432,58,3216,W,125,119,6
6433,95,3217,W,108,94,14
6434,96,3217,L,94,108,-14
6435,16,3218,L,81,93,-12
6436,15,3218,W,93,81,12
6437,572,3219,L,99,133,-34
6438,571,3219,W,133,99,34
6439,143,3220,W,114,103,11
6440,144,3220,L,103,114,-11
6441,470,3221,W,121,115,6
6442,469,3221,L,115,121,-6
6443,575,3222,W,114,80,34
6444,576,3222,L,80,114,-34
6445,74,3223,L,112,121,-9
6446,73,3223,W,121,112,9
6447,20,3224,W,115,111,4
6448,19,3224,L,111,115,-4
6449,234,3225,L,102,105,-3
6450,233,3225,W,105,102,3
6451,410,3226,W,107,104,3
6452,409,3226,L,104,107,-3
6453,399,3227,W,122,119,3
6454,400,3227,L,119,122,-3
6455,694,3228,W,110,97,13
6456,693,3228,L,97,110,-13
6457,137,3229,L,103,110,-7
6458,138,3229,W,110,103,7
6459,140,3230,W,114,106,8
6460,139,3230,L,106,114,-8
6461,275,3231,W,125,106,19
6462,276,3231,L,106,125,-19
6463,593,3232,L,88,104,-16
6464,594,3232,W,104,88,16
6465,474,3233,L,99,114,-15
6466,473,3233,W,114,99,15
6467,232,3234,W,90,89,1
6468,231,3234,L,89,90,-1
6469,159,3235,L,86,99,-13
6470,160,3235,W,99,86,13
6471,629,3236,W,117,106,11
6472,630,3236,L,106,117,-11
6473,845,3237,W,116,107,9
6474,846,3237,L,107,116,-9
6475,141,3238,W,114,113,1
6476,142,3238,L,113,114,-1
6477,360,3239,L,96,109,-13
6478,359,3239,W,109,96,13
6479,370,3240,L,114,124,-10
6480,369,3240,W,124,114,10
6481,262,3241,W,107,100,7
6482,261,3241,L,100,107,-7
6483,660,3242,L,109,112,-3
6484,659,3242,W,112,109,3
6485,606,3243,L,107,108,-1
6486,605,3243,W,108,107,1
6487,700,3244,L,99,127,-28
6488,699,3244,W,127,99,28
6489,840,3245,W,100,96,4
6490,839,3245,L,96,100,-4
6491,533,3246,L,110,111,-1
6492,534,3246,W,111,110,1
6493,758,3247,L,113,132,-19
6494,757,3247,W,132,113,19
6495,498,3248,L,102,103,-1
6496,497,3248,W,103,102,1
6497,181,3249,L,100,114,-14
6498,182,3249,W,114,100,14
6499,31,3250,L,98,106,-8
6500,32,3250,W,106,98,8
6501,92,3251,W,87,85,2
6502,91,3251,L,85,87,-2
6503,175,3252,W,110,103,7
6504,176,3252,L,103,110,-7
6505,303,3253,L,98,116,-18
6506,304,3253,W,116,98,18
6507,76,3254,L,86,125,-39
6508,75,3254,W,125,86,39
6509,796,3255,W,131,127,4
6510,795,3255,L,127,131,-4
6511,760,3256,L,101,108,-7
6512,759,3256,W,108,101,7
6513,276,3257,W,121,105,16
6514,275,3257,L,105,121,-16
6515,135,3258,L,91,99,-8
6516,136,3258,W,99,91,8
6517,265,3259,L,78,114,-36
6518,266,3259,W,114,78,36
6519,601,3260,L,89,103,-14
6520,602,3260,W,103,89,14
6521,666,3261,L,103,107,-4
6522,665,3261,W,107,103,4
6523,398,3262,L,89,110,-21
6524,397,3262,W,110,89,21
6525,516,3263,W,102,100,2
6526,515,3263,L,100,102,-2
6527,380,3264,W,127,124,3
6528,379,3264,L,124,127,-3
6529,478,3265,L,84,91,-7
6530,477,3265,W,91,84,7
6531,185,3266,W,129,110,19
6532,186,3266,L,110,129,-19
6533,859,3267,W,108,94,14
6534,860,3267,L,94,108,-14
6535,484,3268,W,124,114,10
6536,483,3268,L,114,124,-10
6537,147,3269,W,127,117,10
6538,148,3269,L,117,127,-10
6539,235,3270,L,106,112,-6
6540,236,3270,W,112,106,6
6541,726,3271,L,97,98,-1
6542,725,3271,W,98,97,1
6543,560,3272,W,124,115,9
6544,559,3272,L,115,124,-9
6545,279,3273,L,103,121,-18
6546,280,3273,W,121,103,18
6547,652,3274,W,125,122,3
6548,651,3274,L,122,125,-3
6549,354,3275,L,88,102,-14
6550,353,3275,W,102,88,14
6551,217,3276,W,133,96,37
6552,218,3276,L,96,133,-37
6553,520,3277,L,111,134,-23
6554,519,3277,W,134,111,23
6555,841,3278,L,104,111,-7
6556,842,3278,W,111,104,7
6557,314,3279,W,116,98,18
6558,313,3279,L,98,116,-18
6559,264,3280,W,108,98,10
6560,263,3280,L,98,108,-10
6561,359,3281,L,101,122,-21
6562,360,3281,W,122,101,21
6563,831,3282,L,110,127,-17
6564,832,3282,W,127,110,17
6565,829,3283,W,100,91,9
6566,830,3283,L,91,100,-9
6567,650,3284,L,103,104,-1
6568,649,3284,W,104,103,1
6569,752,3285,W,131,111,20
6570,751,3285,L,111,131,-20
6571,443,3286,L,105,113,-8
6572,444,3286,W,113,105,8
6573,64,3287,L,96,114,-18
6574,63,3287,W,114,96,18
6575,180,3288,L,95,98,-3
6576,179,3288,W,98,95,3
6577,186,3289,L,127,131,-4
6578,185,3289,W,131,127,4
6579,816,3290,W,124,120,4
6580,815,3290,L,120,124,-4
6581,581,3291,W,116,113,3
6582,582,3291,L,113,116,-3
6583,635,3292,W,107,90,17
6584,636,3292,L,90,107,-17
6585,130,3293,L,142,148,-6
6586,129,3293,W,148,142,6
6587,408,3294,W,114,96,18
6588,407,3294,L,96,114,-18
6589,9,3295,L,110,114,-4
6590,10,3295,W,114,110,4
6591,172,3296,W,123,110,13
6592,171,3296,L,110,123,-13
6593,91,3297,L,105,108,-3
6594,92,3297,W,108,105,3
6595,857,3298,L,98,106,-8
6596,858,3298,W,106,98,8
6597,676,3299,W,105,103,2
6598,675,3299,L,103,105,-2
6599,376,3300,L,101,104,-3
6600,375,3300,W,104,101,3
6601,664,3301,L,128,141,-13
6602,663,3301,W,141,128,13
6603,732,3302,L,79,93,-14
6604,731,3302,W,93,79,14
6605,115,3303,W,117,111,6
6606,116,3303,L,111,117,-6
6607,778,3304,W,107,102,5
6608,777,3304,L,102,107,-5
6609,397,3305,L,89,104,-15
6610,398,3305,W,104,89,15
6611,395,3306,W,111,87,24
6612,396,3306,L,87,111,-24
6613,855,3307,L,103,121,-18
6614,856,3307,W,121,103,18
6615,412,3308,W,97,95,2
6616,411,3308,L,95,97,-2
6617,75,3309,L,107,119,-12
6618,76,3309,W,119,107,12
6619,579,3310,L,98,111,-13
6620,580,3310,W,111,98,13
6621,804,3311,W,111,100,11
6622,803,3311,L,100,111,-11
6623,119,3312,W,121,106,15
6624,120,3312,L,106,121,-15
6625,358,3313,W,128,120,8
6626,357,3313,L,120,128,-8
6627,53,3314,W,111,101,10
6628,54,3314,L,101,111,-10
6629,491,3315,L,89,102,-13
6630,492,3315,W,102,89,13
6631,717,3316,L,96,102,-6
6632,718,3316,W,102,96,6
6633,405,3317,L,98,99,-1
6634,406,3317,W,99,98,1
6635,191,3318,L,110,114,-4
6636,192,3318,W,114,110,4
6637,830,3319,L,107,119,-12
6638,829,3319,W,119,107,12
6639,312,3320,W,98,94,4
6640,311,3320,L,94,98,-4
6641,404,3321,W,109,99,10
6642,403,3321,L,99,109,-10
6643,460,3322,L,125,128,-3
6644,459,3322,W,128,125,3
6645,749,3323,L,113,128,-15
6646,750,3323,W,128,113,15
6647,861,3324,L,95,109,-14
6648,862,3324,W,109,95,14
6649,607,3325,L,101,126,-25
6650,608,3325,W,126,101,25
6651,400,3326,L,87,92,-5
6652,399,3326,W,92,87,5
6653,326,3327,L,99,113,-14
6654,325,3327,W,113,99,14
6655,643,3328,L,107,124,-17
6656,644,3328,W,124,107,17
6657,723,3329,W,102,91,11
6658,724,3329,L,91,102,-11
6659,116,3330,L,89,107,-18
6660,115,3330,W,107,89,18
6661,135,3331,L,83,107,-24
6662,136,3331,W,107,83,24
6663,615,3332,W,115,106,9
6664,616,3332,L,106,115,-9
6665,586,3333,L,97,99,-2
6666,585,3333,W,99,97,2
6667,740,3334,L,93,98,-5
6668,739,3334,W,98,93,5
6669,328,3335,L,97,109,-12
6670,327,3335,W,109,97,12
6671,791,3336,L,83,107,-24
6672,792,3336,W,107,83,24
6673,469,3337,L,95,122,-27
6674,470,3337,W,122,95,27
6675,134,3338,L,107,112,-5
6676,133,3338,W,112,107,5
6677,155,3339,W,111,103,8
6678,156,3339,L,103,111,-8
6679,564,3340,L,92,99,-7
6680,563,3340,W,99,92,7
6681,63,3341,W,121,104,17
6682,64,3341,L,104,121,-17
6683,83,3342,W,105,98,7
6684,84,3342,L,98,105,-7
6685,463,3343,L,107,112,-5
6686,464,3343,W,112,107,5
6687,370,3344,W,96,81,15
6688,369,3344,L,81,96,-15
6689,262,3345,W,108,99,9
6690,261,3345,L,99,108,-9
6691,40,3346,L,86,102,-16
6692,39,3346,W,102,86,16
6693,52,3347,W,103,89,14
6694,51,3347,L,89,103,-14
6695,89,3348,W,109,94,15
6696,90,3348,L,94,109,-15
6697,779,3349,W,115,106,9
6698,780,3349,L,106,115,-9
6699,57,3350,L,103,130,-27
6700,58,3350,W,130,103,27
6701,444,3351,L,112,115,-3
6702,443,3351,W,115,112,3
6703,45,3352,W,95,92,3
6704,46,3352,L,92,95,-3
6705,387,3353,L,106,111,-5
6706,388,3353,W,111,106,5
6707,501,3354,L,119,123,-4
6708,502,3354,W,123,119,4
6709,653,3355,L,92,117,-25
6710,654,3355,W,117,92,25
6711,153,3356,W,111,97,14
6712,154,3356,L,97,111,-14
6713,599,3357,L,117,120,-3
6714,600,3357,W,120,117,3
6715,296,3358,L,101,104,-3
6716,295,3358,W,104,101,3
6717,243,3359,L,84,119,-35
6718,244,3359,W,119,84,35
6719,421,3360,L,106,113,-7
6720,422,3360,W,113,106,7
6721,388,3361,L,104,109,-5
6722,387,3361,W,109,104,5
6723,210,3362,W,102,85,17
6724,209,3362,L,85,102,-17
6725,345,3363,W,128,118,10
6726,346,3363,L,118,128,-10
6727,417,3364,L,101,113,-12
6728,418,3364,W,113,101,12
6729,274,3365,L,112,115,-3
6730,273,3365,W,115,112,3
6731,811,3366,L,93,102,-9
6732,812,3366,W,102,93,9
6733,157,3367,L,89,100,-11
6734,158,3367,W,100,89,11
6735,586,3368,L,95,97,-2
6736,585,3368,W,97,95,2
6737,39,3369,W,114,109,5
6738,40,3369,L,109,114,-5
6739,738,3370,L,94,112,-18
6740,737,3370,W,112,94,18
6741,416,3371,W,129,111,18
6742,415,3371,L,111,129,-18
6743,770,3372,L,93,110,-17
6744,769,3372,W,110,93,17
6745,223,3373,L,95,108,-13
6746,224,3373,W,108,95,13
6747,51,3374,L,79,107,-28
6748,52,3374,W,107,79,28
6749,664,3375,L,84,97,-13
6750,663,3375,W,97,84,13
6751,459,3376,W,112,104,8
6752,460,3376,L,104,112,-8
6753,130,3377,W,122,116,6
6754,129,3377,L,116,122,-6
6755,707,3378,W,105,95,10
6756,708,3378,L,95,105,-10
6757,126,3379,W,90,89,1
6758,125,3379,L,89,90,-1
6759,205,3380,W,104,99,5
6760,206,3380,L,99,104,-5
6761,533,3381,W,93,91,2
6762,534,3381,L,91,93,-2
6763,342,3382,W,101,95,6
6764,341,3382,L,95,101,-6
6765,204,3383,L,106,116,-10
6766,203,3383,W,116,106,10
6767,763,3384,L,116,119,-3
6768,764,3384,W,119,116,3
6769,479,3385,L,104,110,-6
6770,480,3385,W,110,104,6
6771,41,3386,W,112,111,1
6772,42,3386,L,111,112,-1
6773,422,3387,W,116,114,2
6774,421,3387,L,114,116,-2
6775,548,3388,L,91,109,-18
6776,547,3388,W,109,91,18
6777,118,3389,W,97,91,6
6778,117,3389,L,91,97,-6
6779,429,3390,L,91,109,-18
6780,430,3390,W,109,91,18
6781,239,3391,L,94,95,-1
6782,240,3391,W,95,94,1
6783,679,3392,L,107,108,-1
6784,680,3392,W,108,107,1
6785,462,3393,L,99,120,-21
6786,461,3393,W,120,99,21
6787,514,3394,L,115,117,-2
6788,513,3394,W,117,115,2
6789,502,3395,W,109,97,12
6790,501,3395,L,97,109,-12
6791,306,3396,L,93,108,-15
6792,305,3396,W,108,93,15
6793,492,3397,L,110,114,-4
6794,491,3397,W,114,110,4
6795,471,3398,W,106,99,7
6796,472,3398,L,99,106,-7
6797,24,3399,W,102,93,9
6798,23,3399,L,93,102,-9
6799,780,3400,W,108,106,2
6800,779,3400,L,106,108,-2
6801,329,3401,L,96,111,-15
6802,330,3401,W,111,96,15
6803,542,3402,L,85,90,-5
6804,541,3402,W,90,85,5
6805,656,3403,W,93,91,2
6806,655,3403,L,91,93,-2
6807,277,3404,L,96,98,-2
6808,278,3404,W,98,96,2
6809,241,3405,L,111,115,-4
6810,242,3405,W,115,111,4
6811,375,3406,L,100,109,-9
6812,376,3406,W,109,100,9
6813,604,3407,L,111,117,-6
6814,603,3407,W,117,111,6
6815,783,3408,L,91,100,-9
6816,784,3408,W,100,91,9
6817,142,3409,L,87,120,-33
6818,141,3409,W,120,87,33
6819,373,3410,W,95,88,7
6820,374,3410,L,88,95,-7
6821,77,3411,L,94,96,-2
6822,78,3411,W,96,94,2
6823,335,3412,W,107,95,12
6824,336,3412,L,95,107,-12
6825,615,3413,W,115,109,6
6826,616,3413,L,109,115,-6
6827,170,3414,L,109,124,-15
6828,169,3414,W,124,109,15
6829,691,3415,W,119,117,2
6830,692,3415,L,117,119,-2
6831,270,3416,W,104,98,6
6832,269,3416,L,98,104,-6
6833,792,3417,W,104,98,6
6834,791,3417,L,98,104,-6
6835,658,3418,L,112,121,-9
6836,657,3418,W,121,112,9
6837,651,3419,L,97,112,-15
6838,652,3419,W,112,97,15
6839,592,3420,W,111,104,7
6840,591,3420,L,104,111,-7
6841,554,3421,L,96,119,-23
6842,553,3421,W,119,96,23
6843,43,3422,W,105,91,14
6844,44,3422,L,91,105,-14
6845,793,3423,L,118,124,-6
6846,794,3423,W,124,118,6
6847,802,3424,W,100,95,5
6848,801,3424,L,95,100,-5
6849,589,3425,W,106,95,11
6850,590,3425,L,95,106,-11
6851,515,3426,L,87,93,-6
6852,516,3426,W,93,87,6
6853,545,3427,L,108,115,-7
6854,546,3427,W,115,108,7
6855,363,3428,W,115,109,6
6856,364,3428,L,109,115,-6
6857,512,3429,W,102,95,7
6858,511,3429,L,95,102,-7
6859,711,3430,L,100,103,-3
6860,712,3430,W,103,100,3
6861,318,3431,L,96,108,-12
6862,317,3431,W,108,96,12
6863,278,3432,L,89,95,-6
6864,277,3432,W,95,89,6
6865,493,3433,L,114,123,-9
6866,494,3433,W,123,114,9
6867,440,3434,W,103,84,19
6868,439,3434,L,84,103,-19
6869,854,3435,W,118,112,6
6870,853,3435,L,112,118,-6
6871,53,3436,L,92,99,-7
6872,54,3436,W,99,92,7
6873,609,3437,L,109,113,-4
6874,610,3437,W,113,109,4
6875,243,3438,L,98,103,-5
6876,244,3438,W,103,98,5
6877,561,3439,L,123,130,-7
6878,562,3439,W,130,123,7
6879,86,3440,W,116,103,13
6880,85,3440,L,103,116,-13
6881,612,3441,L,104,111,-7
6882,611,3441,W,111,104,7
6883,753,3442,W,107,82,25
6884,754,3442,L,82,107,-25
6885,776,3443,L,91,96,-5
6886,775,3443,W,96,91,5
6887,654,3444,L,85,108,-23
6888,653,3444,W,108,85,23
6889,272,3445,L,107,111,-4
6890,271,3445,W,111,107,4
6891,642,3446,W,91,81,10
6892,641,3446,L,81,91,-10
6893,622,3447,L,116,126,-10
6894,621,3447,W,126,116,10
6895,305,3448,W,102,87,15
6896,306,3448,L,87,102,-15
6897,381,3449,L,92,97,-5
6898,382,3449,W,97,92,5
6899,768,3450,L,124,131,-7
6900,767,3450,W,131,124,7
6901,207,3451,W,102,101,1
6902,208,3451,L,101,102,-1
6903,396,3452,W,101,89,12
6904,395,3452,L,89,101,-12
6905,69,3453,L,98,105,-7
6906,70,3453,W,105,98,7
6907,602,3454,W,104,101,3
6908,601,3454,L,101,104,-3
6909,784,3455,L,112,113,-1
6910,783,3455,W,113,112,1
6911,73,3456,W,124,117,7
6912,74,3456,L,117,124,-7
6913,400,3457,L,102,104,-2
6914,399,3457,W,104,102,2
6915,860,3458,W,110,99,11
6916,859,3458,L,99,110,-11
6917,427,3459,L,110,117,-7
6918,428,3459,W,117,110,7
6919,823,3460,L,100,117,-17
6920,824,3460,W,117,100,17
6921,748,3461,W,103,89,14
6922,747,3461,L,89,103,-14
6923,190,3462,W,116,107,9
6924,189,3462,L,107,116,-9
6925,178,3463,W,116,109,7
6926,177,3463,L,109,116,-7
6927,682,3464,L,102,105,-3
6928,681,3464,W,105,102,3
6929,198,3465,L,102,109,-7
6930,197,3465,W,109,102,7
6931,11,3466,L,102,106,-4
6932,12,3466,W,106,102,4
6933,33,3467,W,102,98,4
6934,34,3467,L,98,102,-4
6935,488,3468,W,119,111,8
6936,487,3468,L,111,119,-8
6937,461,3469,W,112,101,11
6938,462,3469,L,101,112,-11
6939,368,3470,W,107,104,3
6940,367,3470,L,104,107,-3
6941,687,3471,L,95,100,-5
6942,688,3471,W,100,95,5
6943,258,3472,W,109,99,10
6944,257,3472,L,99,109,-10
6945,803,3473,W,101,87,14
6946,804,3473,L,87,101,-14
6947,862,3474,L,95,101,-6
6948,861,3474,W,101,95,6
6949,37,3475,W,113,107,6
6950,38,3475,L,107,113,-6
6951,619,3476,L,105,117,-12
6952,620,3476,W,117,105,12
6953,573,3477,L,88,99,-11
6954,574,3477,W,99,88,11
6955,746,3478,L,90,97,-7
6956,745,3478,W,97,90,7
6957,603,3479,L,114,123,-9
6958,604,3479,W,123,114,9
6959,76,3480,L,96,98,-2
6960,75,3480,W,98,96,2
6961,486,3481,L,100,104,-4
6962,485,3481,W,104,100,4
6963,428,3482,L,106,110,-4
6964,427,3482,W,110,106,4
6965,51,3483,L,94,100,-6
6966,52,3483,W,100,94,6
6967,364,3484,L,113,126,-13
6968,363,3484,W,126,113,13
6969,351,3485,W,106,92,14
6970,352,3485,L,92,106,-14
6971,731,3486,L,93,96,-3
6972,732,3486,W,96,93,3
6973,685,3487,L,92,95,-3
6974,686,3487,W,95,92,3
6975,22,3488,W,110,90,20
6976,21,3488,L,90,110,-20
6977,273,3489,W,113,91,22
6978,274,3489,L,91,113,-22
6979,450,3490,W,125,115,10
6980,449,3490,L,115,125,-10
6981,409,3491,L,69,116,-47
6982,410,3491,W,116,69,47
6983,99,3492,L,100,111,-11
6984,100,3492,W,111,100,11
6985,555,3493,L,94,104,-10
6986,556,3493,W,104,94,10
6987,107,3494,L,97,115,-18
6988,108,3494,W,115,97,18
6989,171,3495,W,115,101,14
6990,172,3495,L,101,115,-14
6991,267,3496,L,105,122,-17
6992,268,3496,W,122,105,17
6993,535,3497,W,105,100,5
6994,536,3497,L,100,105,-5
6995,38,3498,L,106,112,-6
6996,37,3498,W,112,106,6
6997,129,3499,W,118,95,23
6998,130,3499,L,95,118,-23
6999,457,3500,L,87,90,-3
7000,458,3500,W,90,87,3
7001,500,3501,W,123,95,28
7002,499,3501,L,95,123,-28
7003,128,3502,L,100,115,-15
7004,127,3502,W,115,100,15
7005,509,3503,L,104,109,-5
7006,510,3503,W,109,104,5
7007,66,3504,L,82,108,-26
7008,65,3504,W,108,82,26
7009,625,3505,L,111,116,-5
7010,626,3505,W,116,111,5
7011,21,3506,W,114,102,12
7012,22,3506,L,102,114,-12
7013,265,3507,L,103,108,-5
7014,266,3507,W,108,103,5
7015,475,3508,W,123,116,7
7016,476,3508,L,116,123,-7
7017,632,3509,L,111,116,-5
7018,631,3509,W,116,111,5
7019,453,3510,L,115,120,-5
7020,454,3510,W,120,115,5
7021,264,3511,L,108,114,-6
7022,263,3511,W,114,108,6
7023,269,3512,L,100,105,-5
7024,270,3512,W,105,100,5
7025,617,3513,L,91,109,-18
7026,618,3513,W,109,91,18
7027,624,3514,W,133,112,21
7028,623,3514,L,112,133,-21
7029,594,3515,L,107,111,-4
7030,593,3515,W,111,107,4
7031,109,3516,W,95,79,16
7032,110,3516,L,79,95,-16
7033,597,3517,W,107,106,1
7034,598,3517,L,106,107,-1
7035,671,3518,W,103,91,12
7036,672,3518,L,91,103,-12
7037,729,3519,W,126,107,19
7038,730,3519,L,107,126,-19
7039,144,3520,L,97,108,-11
7040,143,3520,W,108,97,11
7041,869,3521,L,110,111,-1
7042,870,3521,W,111,110,1
7043,494,3522,W,121,114,7
7044,493,3522,L,114,121,-7
7045,105,3523,L,113,118,-5
7046,106,3523,W,118,113,5
7047,110,3524,L,95,104,-9
7048,109,3524,W,104,95,9
7049,414,3525,L,107,131,-24
7050,413,3525,W,131,107,24
7051,415,3526,L,113,126,-13
7052,416,3526,W,126,113,13
7053,422,3527,W,127,123,4
7054,421,3527,L,123,127,-4
7055,304,3528,W,120,102,18
7056,303,3528,L,102,120,-18
7057,36,3529,L,108,121,-13
7058,35,3529,W,121,108,13
7059,165,3530,L,97,118,-21
7060,166,3530,W,118,97,21
7061,665,3531,L,86,115,-29
7062,666,3531,W,115,86,29
7063,709,3532,W,109,104,5
7064,710,3532,L,104,109,-5
7065,510,3533,W,112,87,25
7066,509,3533,L,87,112,-25
7067,467,3534,W,104,99,5
7068,468,3534,L,99,104,-5
7069,447,3535,L,97,108,-11
7070,448,3535,W,108,97,11
7071,837,3536,W,92,89,3
7072,838,3536,L,89,92,-3
7073,136,3537,L,77,106,-29
7074,135,3537,W,106,77,29
7075,435,3538,W,110,106,4
7076,436,3538,L,106,110,-4
7077,641,3539,W,118,108,10
7078,642,3539,L,108,118,-10
7079,120,3540,L,115,120,-5
7080,119,3540,W,120,115,5
7081,277,3541,L,108,115,-7
7082,278,3541,W,115,108,7
7083,719,3542,W,103,91,12
7084,720,3542,L,91,103,-12
7085,733,3543,L,103,117,-14
7086,734,3543,W,117,103,14
7087,70,3544,W,113,91,22
7088,69,3544,L,91,113,-22
7089,225,3545,L,109,121,-12
7090,226,3545,W,121,109,12
7091,788,3546,W,100,93,7
7092,787,3546,L,93,100,-7
7093,780,3547,L,108,119,-11
7094,779,3547,W,119,108,11
7095,48,3548,W,98,88,10
7096,47,3548,L,88,98,-10
7097,449,3549,L,95,110,-15
7098,450,3549,W,110,95,15
7099,372,3550,L,102,117,-15
7100,371,3550,W,117,102,15
7101,4,3551,L,111,130,-19
7102,3,3551,W,130,111,19
7103,41,3552,W,108,98,10
7104,42,3552,L,98,108,-10
7105,824,3553,L,108,121,-13
7106,823,3553,W,121,108,13
7107,470,3554,W,97,95,2
7108,469,3554,L,95,97,-2
7109,352,3555,W,108,105,3
7110,351,3555,L,105,108,-3
7111,580,3556,W,112,78,34
7112,579,3556,L,78,112,-34
7113,365,3557,W,106,86,20
7114,366,3557,L,86,106,-20
7115,582,3558,L,81,97,-16
7116,581,3558,W,97,81,16
7117,432,3559,W,109,97,12
7118,431,3559,L,97,109,-12
7119,271,3560,L,104,116,-12
7120,272,3560,W,116,104,12
7121,356,3561,W,99,98,1
7122,355,3561,L,98,99,-1
7123,454,3562,L,104,107,-3
7124,453,3562,W,107,104,3
7125,578,3563,L,92,104,-12
7126,577,3563,W,104,92,12
7127,103,3564,L,99,100,-1
7128,104,3564,W,100,99,1
7129,27,3565,W,115,91,24
7130,28,3565,L,91,115,-24
7131,62,3566,L,94,143,-49
7132,61,3566,W,143,94,49
7133,195,3567,L,103,118,-15
7134,196,3567,W,118,103,15
7135,163,3568,W,127,125,2
7136,164,3568,L,125,127,-2
7137,309,3569,W,113,107,6
7138,310,3569,L,107,113,-6
7139,570,3570,L,124,129,-5
7140,569,3570,W,129,124,5
7141,334,3571,W,95,94,1
7142,333,3571,L,94,95,-1
7143,160,3572,L,102,113,-11
7144,159,3572,W,113,102,11
7145,331,3573,L,118,124,-6
7146,332,3573,W,124,118,6
7147,192,3574,L,81,101,-20
7148,191,3574,W,101,81,20
7149,828,3575,L,91,108,-17
7150,827,3575,W,108,91,17
7151,50,3576,L,95,125,-30
7152,49,3576,W,125,95,30
7153,821,3577,L,109,119,-10
7154,822,3577,W,119,109,10
7155,14,3578,L,100,108,-8
7156,13,3578,W,108,100,8
7157,125,3579,L,98,104,-6
7158,126,3579,W,104,98,6
7159,605,3580,W,116,103,13
7160,606,3580,L,103,116,-13
7161,712,3581,L,80,110,-30
7162,711,3581,W,110,80,30
7163,55,3582,L,90,107,-17
7164,56,3582,W,107,90,17
7165,852,3583,L,94,103,-9
7166,851,3583,W,103,94,9
7167,633,3584,L,85,96,-11
7168,634,3584,W,96,85,11
7169,745,3585,W,110,102,8
7170,746,3585,L,102,110,-8
7171,31,3586,W,114,98,16
7172,32,3586,L,98,114,-16
7173,805,3587,L,86,107,-21
7174,806,3587,W,107,86,21
7175,176,3588,W,99,88,11
7176,175,3588,L,88,99,-11
7177,698,3589,L,85,107,-22
7178,697,3589,W,107,85,22
7179,146,3590,W,100,92,8
7180,145,3590,L,92,100,-8
7181,226,3591,W,105,97,8
7182,225,3591,L,97,105,-8
7183,71,3592,W,116,88,28
7184,72,3592,L,88,116,-28
7185,6,3593,L,107,114,-7
7186,5,3593,W,114,107,7
7187,496,3594,L,102,118,-16
7188,495,3594,W,118,102,16
7189,121,3595,W,118,111,7
7190,122,3595,L,111,118,-7
7191,637,3596,L,91,100,-9
7192,638,3596,W,100,91,9
7193,111,3597,W,100,97,3
7194,112,3597,L,97,100,-3
7195,139,3598,W,120,95,25
7196,140,3598,L,95,120,-25
7197,127,3599,L,109,127,-18
7198,128,3599,W,127,109,18
7199,468,3600,L,105,113,-8
7200,467,3600,W,113,105,8
7201,703,3601,W,125,85,40
7202,704,3601,L,85,125,-40
7203,434,3602,W,105,83,22
7204,433,3602,L,83,105,-22
7205,524,3603,W,110,99,11
7206,523,3603,L,99,110,-11
7207,315,3604,L,90,102,-12
7208,316,3604,W,102,90,12
7209,858,3605,L,87,102,-15
7210,857,3605,W,102,87,15
7211,197,3606,L,79,111,-32
7212,198,3606,W,111,79,32
7213,324,3607,W,124,116,8
7214,323,3607,L,116,124,-8
7215,503,3608,W,122,113,9
7216,504,3608,L,113,122,-9
7217,458,3609,L,101,104,-3
7218,457,3609,W,104,101,3
7219,647,3610,L,107,118,-11
7220,648,3610,W,118,107,11
7221,487,3611,L,120,123,-3
7222,488,3611,W,123,120,3
7223,517,3612,L,113,118,-5
7224,518,3612,W,118,113,5
7225,316,3613,L,82,86,-4
7226,315,3613,W,86,82,4
7227,382,3614,W,111,87,24
7228,381,3614,L,87,111,-24
7229,604,3615,L,114,146,-32
7230,603,3615,W,146,114,32
7231,13,3616,L,84,107,-23
7232,14,3616,W,107,84,23
7233,792,3617,L,100,107,-7
7234,791,3617,W,107,100,7
7235,307,3618,W,91,88,3
7236,308,3618,L,88,91,-3
7237,529,3619,W,142,116,26
7238,530,3619,L,116,142,-26
7239,567,3620,L,88,92,-4
7240,568,3620,W,92,88,4
7241,818,3621,L,86,98,-12
7242,817,3621,W,98,86,12
7243,442,3622,L,79,92,-13
7244,441,3622,W,92,79,13
7245,114,3623,W,125,116,9
7246,113,3623,L,116,125,-9
7247,347,3624,L,101,106,-5
7248,348,3624,W,106,101,5
7249,809,3625,W,116,113,3
7250,810,3625,L,113,116,-3
7251,367,3626,W,115,109,6
7252,368,3626,L,109,115,-6
7253,849,3627,L,80,126,-46
7254,850,3627,W,126,80,46
7255,374,3628,L,94,99,-5
7256,373,3628,W,99,94,5
7257,308,3629,W,102,93,9
7258,307,3629,L,93,102,-9
7259,104,3630,W,115,107,8
7260,103,3630,L,107,115,-8
7261,486,3631,L,95,99,-4
7262,485,3631,W,99,95,4
7263,278,3632,W,97,91,6
7264,277,3632,L,91,97,-6
7265,92,3633,W,109,102,7
7266,91,3633,L,102,109,-7
7267,798,3634,W,129,113,16
7268,797,3634,L,113,129,-16
7269,391,3635,W,109,105,4
7270,392,3635,L,105,109,-4
7271,865,3636,L,105,106,-1
7272,866,3636,W,106,105,1
7273,210,3637,L,82,99,-17
7274,209,3637,W,99,82,17
7275,30,3638,W,104,101,3
7276,29,3638,L,101,104,-3
7277,79,3639,W,109,98,11
7278,80,3639,L,98,109,-11
7279,504,3640,W,100,93,7
7280,503,3640,L,93,100,-7
7281,362,3641,L,92,110,-18
7282,361,3641,W,110,92,18
7283,623,3642,L,100,110,-10
7284,624,3642,W,110,100,10
7285,162,3643,L,103,110,-7
7286,161,3643,W,110,103,7
7287,842,3644,L,103,112,-9
7288,841,3644,W,112,103,9
7289,132,3645,L,94,95,-1
7290,131,3645,W,95,94,1
7291,581,3646,L,99,112,-13
7292,582,3646,W,112,99,13
7293,166,3647,W,118,95,23
7294,165,3647,L,95,118,-23
7295,747,3648,L,107,125,-18
7296,748,3648,W,125,107,18
7297,323,3649,L,114,135,-21
7298,324,3649,W,135,114,21
7299,433,3650,L,96,111,-15
7300,434,3650,W,111,96,15
7301,338,3651,L,90,98,-8
7302,337,3651,W,98,90,8
7303,779,3652,L,110,118,-8
7304,780,3652,W,118,110,8
7305,584,3653,L,94,133,-39
7306,583,3653,W,133,94,39
7307,648,3654,L,106,114,-8
7308,647,3654,W,114,106,8
7309,254,3655,L,103,111,-8
7310,253,3655,W,111,103,8
7311,325,3656,L,94,113,-19
7312,326,3656,W,113,94,19
7313,766,3657,L,91,118,-27
7314,765,3657,W,118,91,27
7315,833,3658,W,111,104,7
7316,834,3658,L,104,111,-7
7317,148,3659,L,111,120,-9
7318,147,3659,W,120,111,9
7319,164,3660,W,101,97,4
7320,163,3660,L,97,101,-4
7321,497,3661,W,84,74,10
7322,498,3661,L,74,84,-10
7323,695,3662,W,94,87,7
7324,696,3662,L,87,94,-7
7325,724,3663,L,87,90,-3
7326,723,3663,W,90,87,3
7327,44,3664,L,104,111,-7
7328,43,3664,W,111,104,7
7329,75,3665,W,105,87,18
7330,76,3665,L,87,105,-18
7331,677,3666,W,128,112,16
7332,678,3666,L,112,128,-16
7333,240,3667,L,94,102,-8
7334,239,3667,W,102,94,8
7335,774,3668,L,113,117,-4
7336,773,3668,W,117,113,4
7337,341,3669,L,108,109,-1
7338,342,3669,W,109,108,1
7339,113,3670,L,118,122,-4
7340,114,3670,W,122,118,4
7341,814,3671,L,95,111,-16
7342,813,3671,W,111,95,16
7343,536,3672,L,99,112,-13
7344,535,3672,W,112,99,13
7345,456,3673,L,96,107,-11
7346,455,3673,W,107,96,11
7347,791,3674,L,97,114,-17
7348,792,3674,W,114,97,17
7349,714,3675,L,101,125,-24
7350,713,3675,W,125,101,24
7351,202,3676,W,126,115,11
7352,201,3676,L,115,126,-11
7353,559,3677,L,114,119,-5
7354,560,3677,W,119,114,5
7355,764,3678,L,119,124,-5
7356,763,3678,W,124,119,5
7357,145,3679,W,98,97,1
7358,146,3679,L,97,98,-1
7359,806,3680,W,104,97,7
7360,805,3680,L,97,104,-7
7361,521,3681,W,117,112,5
7362,522,3681,L,112,117,-5
7363,426,3682,L,86,94,-8
7364,425,3682,W,94,86,8
7365,525,3683,W,113,99,14
7366,526,3683,L,99,113,-14
7367,548,3684,L,107,120,-13
7368,547,3684,W,120,107,13
7369,430,3685,L,113,118,-5
7370,429,3685,W,118,113,5
7371,786,3686,L,104,112,-8
7372,785,3686,W,112,104,8
7373,499,3687,L,80,97,-17
7374,500,3687,W,97,80,17
7375,524,3688,W,110,107,3
7376,523,3688,L,107,110,-3
7377,552,3689,W,98,92,6
7378,551,3689,L,92,98,-6
7379,108,3690,L,101,108,-7
7380,107,3690,W,108,101,7
7381,493,3691,W,117,115,2
7382,494,3691,L,115,117,-2
7383,601,3692,L,95,112,-17
7384,602,3692,W,112,95,17
7385,637,3693,W,107,96,11
7386,638,3693,L,96,107,-11
7387,196,3694,W,104,88,16
7388,195,3694,L,88,104,-16
7389,541,3695,W,104,101,3
7390,542,3695,L,101,104,-3
7391,404,3696,L,102,107,-5
7392,403,3696,W,107,102,5
7393,495,3697,L,94,112,-18
7394,496,3697,W,112,94,18
7395,630,3698,L,99,103,-4
7396,629,3698,W,103,99,4
7397,462,3699,L,110,137,-27
7398,461,3699,W,137,110,27
7399,390,3700,L,99,108,-9
7400,389,3700,W,108,99,9
7401,381,3701,L,99,112,-13
7402,382,3701,W,112,99,13
7403,369,3702,W,127,108,19
7404,370,3702,L,108,127,-19
7405,443,3703,W,113,104,9
7406,444,3703,L,104,113,-9
7407,537,3704,W,96,90,6
7408,538,3704,L,90,96,-6
7409,485,3705,L,96,105,-9
7410,486,3705,W,105,96,9
7411,255,3706,L,94,95,-1
7412,256,3706,W,95,94,1
7413,357,3707,W,99,94,5
7414,358,3707,L,94,99,-5
7415,683,3708,W,119,104,15
7416,684,3708,L,104,119,-15
7417,639,3709,L,107,120,-13
7418,640,3709,W,120,107,13
7419,300,3710,W,101,94,7
7420,299,3710,L,94,101,-7
7421,250,3711,L,110,121,-11
7422,249,3711,W,121,110,11
7423,471,3712,W,130,122,8
7424,472,3712,L,122,130,-8
7425,293,3713,W,109,100,9
7426,294,3713,L,100,109,-9
7427,366,3714,L,101,108,-7
7428,365,3714,W,108,101,7
7429,737,3715,W,105,83,22
7430,738,3715,L,83,105,-22
7431,285,3716,L,112,124,-12
7432,286,3716,W,124,112,12
7433,721,3717,W,112,92,20
7434,722,3717,L,92,112,-20
7435,46,3718,L,110,113,-3
7436,45,3718,W,113,110,3
7437,445,3719,L,109,119,-10
7438,446,3719,W,119,109,10
7439,98,3720,L,103,112,-9
7440,97,3720,W,112,103,9
7441,787,3721,L,91,97,-6
7442,788,3721,W,97,91,6
7443,304,3722,W,104,98,6
7444,303,3722,L,98,104,-6
7445,150,3723,L,111,129,-18
7446,149,3723,W,129,111,18
7447,387,3724,L,121,126,-5
7448,388,3724,W,126,121,5
7449,65,3725,L,98,119,-21
7450,66,3725,W,119,98,21
7451,12,3726,W,124,107,17
7452,11,3726,L,107,124,-17
7453,257,3727,W,122,116,6
7454,258,3727,L,116,122,-6
7455,371,3728,W,119,97,22
7456,372,3728,L,97,119,-22
7457,825,3729,L,86,113,-27
7458,826,3729,W,113,86,27
7459,281,3730,W,101,99,2
7460,282,3730,L,99,101,-2
7461,741,3731,L,83,101,-18
7462,742,3731,W,101,83,18
7463,551,3732,W,122,114,8
7464,552,3732,L,114,122,-8
7465,411,3733,W,110,91,19
7466,412,3733,L,91,110,-19
7467,701,3734,L,93,113,-20
7468,702,3734,W,113,93,20
7469,756,3735,L,110,116,-6
7470,755,3735,W,116,110,6
7471,183,3736,L,89,104,-15
7472,184,3736,W,104,89,15
7473,151,3737,W,115,107,8
7474,152,3737,L,107,115,-8
7475,727,3738,W,104,99,5
7476,728,3738,L,99,104,-5
7477,690,3739,W,99,85,14
7478,689,3739,L,85,99,-14
7479,431,3740,W,125,122,3
7480,432,3740,L,122,125,-3
7481,276,3741,W,141,113,28
7482,275,3741,L,113,141,-28
7483,154,3742,W,115,99,16
7484,153,3742,L,99,115,-16
7485,681,3743,L,94,108,-14
7486,682,3743,W,108,94,14
7487,555,3744,L,113,120,-7
7488,556,3744,W,120,113,7
7489,29,3745,W,114,95,19
7490,30,3745,L,95,114,-19
7491,785,3746,W,124,111,13
7492,786,3746,L,111,124,-13
7493,361,3747,W,110,83,27
7494,362,3747,L,83,110,-27
7495,735,3748,W,117,106,11
7496,736,3748,L,106,117,-11
7497,34,3749,W,115,107,8
7498,33,3749,L,107,115,-8
7499,378,3750,L,94,97,-3
7500,377,3750,W,97,94,3
7501,229,3751,L,81,96,-15
7502,230,3751,W,96,81,15
7503,434,3752,L,89,103,-14
7504,433,3752,W,103,89,14
7505,283,3753,L,107,114,-7
7506,284,3753,W,114,107,7
7507,419,3754,L,101,123,-22
7508,420,3754,W,123,101,22
7509,441,3755,W,101,69,32
7510,442,3755,L,69,101,-32
7511,715,3756,W,95,87,8
7512,716,3756,L,87,95,-8
7513,667,3757,W,112,110,2
7514,668,3757,L,110,112,-2
7515,125,3758,W,96,90,6
7516,126,3758,L,90,96,-6
7517,693,3759,W,105,100,5
7518,694,3759,L,100,105,-5
7519,593,3760,L,116,119,-3
7520,594,3760,W,119,116,3
7521,252,3761,W,101,92,9
7522,251,3761,L,92,101,-9
7523,394,3762,L,87,114,-27
7524,393,3762,W,114,87,27
7525,317,3763,W,109,93,16
7526,318,3763,L,93,109,-16
7527,591,3764,L,86,107,-21
7528,592,3764,W,107,86,21
7529,385,3765,L,117,120,-3
7530,386,3765,W,120,117,3
7531,100,3766,W,96,89,7
7532,99,3766,L,89,96,-7
7533,177,3767,W,114,106,8
7534,178,3767,L,106,114,-8
7535,18,3768,W,104,103,1
7536,17,3768,L,103,104,-1
7537,101,3769,L,86,91,-5
7538,102,3769,W,91,86,5
7539,334,3770,L,91,96,-5
7540,333,3770,W,96,91,5
7541,339,3771,L,93,110,-17
7542,340,3771,W,110,93,17
7543,152,3772,W,105,104,1
7544,151,3772,L,104,105,-1
7545,813,3773,L,99,102,-3
7546,814,3773,W,102,99,3
7547,801,3774,L,96,114,-18
7548,802,3774,W,114,96,18
7549,2,3775,L,88,97,-9
7550,1,3775,W,97,88,9
7551,822,3776,L,107,112,-5
7552,821,3776,W,112,107,5
7553,620,3777,W,117,100,17
7554,619,3777,L,100,117,-17
7555,112,3778,L,101,122,-21
7556,111,3778,W,122,101,21
7557,343,3779,L,112,117,-5
7558,344,3779,W,117,112,5
7559,333,3780,L,94,103,-9
7560,334,3780,W,103,94,9
7561,179,3781,L,121,125,-4
7562,180,3781,W,125,121,4
7563,812,3782,L,89,110,-21
7564,811,3782,W,110,89,21
7565,274,3783,L,112,119,-7
7566,273,3783,W,119,112,7
7567,475,3784,L,93,103,-10
7568,476,3784,W,103,93,10
7569,729,3785,L,84,102,-18
7570,730,3785,W,102,84,18
7571,636,3786,W,130,107,23
7572,635,3786,L,107,130,-23
7573,433,3787,W,98,90,8
7574,434,3787,L,90,98,-8
7575,266,3788,W,97,86,11
7576,265,3788,L,86,97,-11
7577,54,3789,L,115,117,-2
7578,53,3789,W,117,115,2
7579,388,3790,L,94,103,-9
7580,387,3790,W,103,94,9
7581,652,3791,W,133,103,30
7582,651,3791,L,103,133,-30
7583,480,3792,L,93,104,-11
7584,479,3792,W,104,93,11
7585,81,3793,L,97,101,-4
7586,82,3793,W,101,97,4
7587,706,3794,W,109,104,5
7588,705,3794,L,104,109,-5
7589,384,3795,W,119,112,7
7590,383,3795,L,112,119,-7
7591,594,3796,W,115,113,2
7592,593,3796,L,113,115,-2
7593,21,3797,L,104,116,-12
7594,22,3797,W,116,104,12
7595,223,3798,L,88,130,-42
7596,224,3798,W,130,88,42
7597,663,3799,L,101,111,-10
7598,664,3799,W,111,101,10
7599,40,3800,L,94,128,-34
7600,39,3800,W,128,94,34
7601,672,3801,L,110,113,-3
7602,671,3801,W,113,110,3
7603,52,3802,L,87,96,-9
7604,51,3802,W,96,87,9
7605,795,3803,W,114,93,21
7606,796,3803,L,93,114,-21
7607,295,3804,W,111,107,4
7608,296,3804,L,107,111,-4
7609,32,3805,L,79,96,-17
7610,31,3805,W,96,79,17
7611,260,3806,L,91,107,-16
7612,259,3806,W,107,91,16
7613,139,3807,L,108,112,-4
7614,140,3807,W,112,108,4
7615,583,3808,W,87,77,10
7616,584,3808,L,77,87,-10
7617,180,3809,L,121,126,-5
7618,179,3809,W,126,121,5
7619,450,3810,W,128,120,8
7620,449,3810,L,120,128,-8
7621,222,3811,W,93,88,5
7622,221,3811,L,88,93,-5
7623,617,3812,L,111,115,-4
7624,618,3812,W,115,111,4
7625,763,3813,W,116,97,19
7626,764,3813,L,97,116,-19
7627,143,3814,W,102,92,10
7628,144,3814,L,92,102,-10
7629,504,3815,W,132,130,2
7630,503,3815,L,130,132,-2
7631,292,3816,L,91,109,-18
7632,291,3816,W,109,91,18
7633,423,3817,W,114,96,18
7634,424,3817,L,96,114,-18
7635,80,3818,L,97,100,-3
7636,79,3818,W,100,97,3
7637,119,3819,W,108,92,16
7638,120,3819,L,92,108,-16
7639,330,3820,L,84,105,-21
7640,329,3820,W,105,84,21
7641,559,3821,L,100,117,-17
7642,560,3821,W,117,100,17
7643,817,3822,L,99,107,-8
7644,818,3822,W,107,99,8
7645,464,3823,W,117,111,6
7646,463,3823,L,111,117,-6
7647,136,3824,L,96,106,-10
7648,135,3824,W,106,96,10
7649,505,3825,L,90,102,-12
7650,506,3825,W,102,90,12
7651,99,3826,W,108,100,8
7652,100,3826,L,100,108,-8
7653,284,3827,W,124,76,48
7654,283,3827,L,76,124,-48
7655,106,3828,L,115,120,-5
7656,105,3828,W,120,115,5
7657,8,3829,W,105,100,5
7658,7,3829,L,100,105,-5
7659,115,3830,L,109,116,-7
7660,116,3830,W,116,109,7
7661,234,3831,L,91,103,-12
7662,233,3831,W,103,91,12
7663,501,3832,L,131,140,-9
7664,502,3832,W,140,131,9
7665,483,3833,W,122,121,1
7666,484,3833,L,121,122,-1
7667,353,3834,L,99,102,-3
7668,354,3834,W,102,99,3
7669,564,3835,L,120,129,-9
7670,563,3835,W,129,120,9
7671,563,3836,L,116,137,-21
7672,564,3836,W,137,116,21
7673,563,3837,W,118,113,5
7674,564,3837,L,113,118,-5
7675,564,3838,L,113,132,-19
7676,563,3838,W,132,113,19
7677,564,3839,L,91,113,-22
7678,563,3839,W,113,91,22
7679,354,3840,W,135,102,33
7680,353,3840,L,102,135,-33
7681,353,3841,L,99,112,-13
7682,354,3841,W,112,99,13
7683,721,3842,W,129,115,14
7684,722,3842,L,115,129,-14
7685,353,3843,W,111,108,3
7686,354,3843,L,108,111,-3
7687,721,3844,W,120,108,12
7688,722,3844,L,108,120,-12
7689,354,3845,W,130,86,44
7690,353,3845,L,86,130,-44
7691,354,3846,W,117,104,13
7692,353,3846,L,104,117,-13
7693,722,3847,L,100,136,-36
7694,721,3847,W,136,100,36
7695,155,3848,L,105,115,-10
7696,156,3848,W,115,105,10
7697,722,3849,L,111,113,-2
7698,721,3849,W,113,111,2
7699,156,3850,L,91,92,-1
7700,155,3850,W,92,91,1
7701,170,3851,W,114,75,39
7702,169,3851,L,75,114,-39
7703,155,3852,L,101,123,-22
7704,156,3852,W,123,101,22
7705,169,3853,L,107,110,-3
7706,170,3853,W,110,107,3
7707,608,3854,W,121,95,26
7708,607,3854,L,95,121,-26
7709,170,3855,L,104,125,-21
7710,169,3855,W,125,104,21
7711,572,3856,W,109,102,7
7712,571,3856,L,102,109,-7
7713,156,3857,L,102,121,-19
7714,155,3857,W,121,102,19
7715,608,3858,W,102,91,11
7716,607,3858,L,91,102,-11
7717,572,3859,W,115,94,21
7718,571,3859,L,94,115,-21
7719,170,3860,W,103,92,11
7720,169,3860,L,92,103,-11
7721,607,3861,L,104,115,-11
7722,608,3861,W,115,104,11
7723,156,3862,L,89,116,-27
7724,155,3862,W,116,89,27
7725,169,3863,L,96,121,-25
7726,170,3863,W,121,96,25
7727,571,3864,L,103,125,-22
7728,572,3864,W,125,103,22
7729,607,3865,L,94,106,-12
7730,608,3865,W,106,94,12
7731,155,3866,L,119,129,-10
7732,156,3866,W,129,119,10
7733,169,3867,W,126,99,27
7734,170,3867,L,99,126,-27
7735,571,3868,L,105,116,-11
7736,572,3868,W,116,105,11
7737,155,3869,L,111,123,-12
7738,156,3869,W,123,111,12
7739,729,3870,W,104,91,13
7740,730,3870,L,91,104,-13
7741,326,3871,W,115,99,16
7742,325,3871,L,99,115,-16
7743,730,3872,W,98,93,5
7744,729,3872,L,93,98,-5
7745,654,3873,W,105,83,22
7746,653,3873,L,83,105,-22
7747,185,3874,W,92,89,3
7748,186,3874,L,89,92,-3
7749,109,3875,W,103,96,7
7750,110,3875,L,96,103,-7
7751,653,3876,L,97,108,-11
7752,654,3876,W,108,97,11
7753,325,3877,L,99,103,-4
7754,326,3877,W,103,99,4
7755,110,3878,L,103,116,-13
7756,109,3878,W,116,103,13
7757,729,3879,W,96,92,4
7758,730,3879,L,92,96,-4
7759,133,3880,L,99,105,-6
7760,134,3880,W,105,99,6
7761,326,3881,L,101,111,-10
7762,325,3881,W,111,101,10
7763,186,3882,L,93,118,-25
7764,185,3882,W,118,93,25
7765,611,3883,W,128,103,25
7766,612,3883,L,103,128,-25
7767,11,3884,W,106,102,4
7768,12,3884,L,102,106,-4
7769,730,3885,L,98,105,-7
7770,729,3885,W,105,98,7
7771,134,3886,W,113,109,4
7772,133,3886,L,109,113,-4
7773,654,3887,W,104,95,9
7774,653,3887,L,95,104,-9
7775,326,3888,L,98,116,-18
7776,325,3888,W,116,98,18
7777,611,3889,W,119,113,6
7778,612,3889,L,113,119,-6
7779,185,3890,W,87,76,11
7780,186,3890,L,76,87,-11
7781,109,3891,L,108,110,-2
7782,110,3891,W,110,108,2
7783,654,3892,W,104,87,17
7784,653,3892,L,87,104,-17
7785,730,3893,W,111,106,5
7786,729,3893,L,106,111,-5
7787,134,3894,L,113,115,-2
7788,133,3894,W,115,113,2
7789,11,3895,W,119,114,5
7790,12,3895,L,114,119,-5
7791,109,3896,L,94,105,-11
7792,110,3896,W,105,94,11
7793,185,3897,L,77,104,-27
7794,186,3897,W,104,77,27
7795,325,3898,L,101,109,-8
7796,326,3898,W,109,101,8
7797,133,3899,L,111,115,-4
7798,134,3899,W,115,111,4
7799,612,3900,L,81,110,-29
7800,611,3900,W,110,81,29
7801,653,3901,W,111,97,14
7802,654,3901,L,97,111,-14
7803,186,3902,L,100,106,-6
7804,185,3902,W,106,100,6
7805,729,3903,L,91,99,-8
7806,730,3903,W,99,91,8
7807,12,3904,L,111,117,-6
7808,11,3904,W,117,111,6
7809,110,3905,L,82,96,-14
7810,109,3905,W,96,82,14
7811,133,3906,L,87,118,-31
7812,134,3906,W,118,87,31
7813,653,3907,W,106,102,4
7814,654,3907,L,102,106,-4
7815,325,3908,L,107,114,-7
7816,326,3908,W,114,107,7
7817,612,3909,L,109,121,-12
7818,611,3909,W,121,109,12
7819,110,3910,L,82,111,-29
7820,109,3910,W,111,82,29
7821,729,3911,W,97,95,2
7822,730,3911,L,95,97,-2
7823,12,3912,L,108,109,-1
7824,11,3912,W,109,108,1
7825,186,3913,W,97,83,14
7826,185,3913,L,83,97,-14
7827,475,3914,W,103,100,3
7828,476,3914,L,100,103,-3
7829,571,3915,W,98,83,15
7830,572,3915,L,83,98,-15
7831,99,3916,L,94,112,-18
7832,100,3916,W,112,94,18
7833,421,3917,L,94,109,-15
7834,422,3917,W,109,94,15
7835,469,3918,L,95,115,-20
7836,470,3918,W,115,95,20
7837,239,3919,W,111,105,6
7838,240,3919,L,105,111,-6
7839,308,3920,L,102,110,-8
7840,307,3920,W,110,102,8
7841,708,3921,L,86,104,-18
7842,707,3921,W,104,86,18
7843,83,3922,L,113,114,-1
7844,84,3922,W,114,113,1
7845,157,3923,L,97,101,-4
7846,158,3923,W,101,97,4
7847,287,3924,L,118,123,-5
7848,288,3924,W,123,118,5
7849,298,3925,L,73,112,-39
7850,297,3925,W,112,73,39
7851,491,3926,L,109,113,-4
7852,492,3926,W,113,109,4
7853,334,3927,W,100,93,7
7854,333,3927,L,93,100,-7
7855,291,3928,L,76,103,-27
7856,292,3928,W,103,76,27
7857,267,3929,W,109,91,18
7858,268,3929,L,91,109,-18
7859,384,3930,L,96,108,-12
7860,383,3930,W,108,96,12
7861,593,3931,W,100,98,2
7862,594,3931,L,98,100,-2
7863,53,3932,L,104,129,-25
7864,54,3932,W,129,104,25
7865,388,3933,L,79,89,-10
7866,387,3933,W,89,79,10
7867,607,3934,W,105,99,6
7868,608,3934,L,99,105,-6
7869,618,3935,W,105,101,4
7870,617,3935,L,101,105,-4
7871,91,3936,L,105,114,-9
7872,92,3936,W,114,105,9
7873,346,3937,L,96,125,-29
7874,345,3937,W,125,96,29
7875,448,3938,L,121,124,-3
7876,447,3938,W,124,121,3
7877,738,3939,L,75,122,-47
7878,737,3939,W,122,75,47
7879,533,3940,L,98,99,-1
7880,534,3940,W,99,98,1
7881,250,3941,W,120,111,9
7882,249,3941,L,111,120,-9
7883,117,3942,L,111,124,-13
7884,118,3942,W,124,111,13
7885,14,3943,W,110,97,13
7886,13,3943,L,97,110,-13
7887,240,3944,W,106,105,1
7888,239,3944,L,105,106,-1
7889,494,3945,L,125,126,-1
7890,493,3945,W,126,125,1
7891,63,3946,L,109,110,-1
7892,64,3946,W,110,109,1
7893,8,3947,W,135,128,7
7894,7,3947,L,128,135,-7
7895,549,3948,W,103,90,13
7896,550,3948,L,90,103,-13
7897,297,3949,L,106,107,-1
7898,298,3949,W,107,106,1
7899,307,3950,W,106,103,3
7900,308,3950,L,103,106,-3
7901,449,3951,L,101,123,-22
7902,450,3951,W,123,101,22
7903,723,3952,W,121,114,7
7904,724,3952,L,114,121,-7
7905,97,3953,L,86,101,-15
7906,98,3953,W,101,86,15
7907,548,3954,W,98,87,11
7908,547,3954,L,87,98,-11
7909,226,3955,W,127,112,15
7910,225,3955,L,112,127,-15
7911,466,3956,W,90,82,8
7912,465,3956,L,82,90,-8
7913,493,3957,W,114,100,14
7914,494,3957,L,100,114,-14
7915,604,3958,L,106,122,-16
7916,603,3958,W,122,106,16
7917,574,3959,L,88,101,-13
7918,573,3959,W,101,88,13
7919,278,3960,W,102,89,13
7920,277,3960,L,89,102,-13
7921,159,3961,L,94,98,-4
7922,160,3961,W,98,94,4
7923,79,3962,L,113,120,-7
7924,80,3962,W,120,113,7
7925,181,3963,L,99,120,-21
7926,182,3963,W,120,99,21
7927,232,3964,L,94,96,-2
7928,231,3964,W,96,94,2
7929,759,3965,W,114,109,5
7930,760,3965,L,109,114,-5
7931,524,3966,L,116,123,-7
7932,523,3966,W,123,116,7
7933,360,3967,L,89,104,-15
7934,359,3967,W,104,89,15
7935,513,3968,W,102,90,12
7936,514,3968,L,90,102,-12
7937,680,3969,L,98,105,-7
7938,679,3969,W,105,98,7
7939,179,3970,L,107,115,-8
7940,180,3970,W,115,107,8
7941,280,3971,W,106,103,3
7942,279,3971,L,103,106,-3
7943,65,3972,L,101,112,-11
7944,66,3972,W,112,101,11
7945,207,3973,W,103,100,3
7946,208,3973,L,100,103,-3
7947,354,3974,W,114,91,23
7948,353,3974,L,91,114,-23
7949,565,3975,W,105,102,3
7950,566,3975,L,102,105,-3
7951,401,3976,W,120,111,9
7952,402,3976,L,111,120,-9
7953,15,3977,W,102,95,7
7954,16,3977,L,95,102,-7
7955,50,3978,L,104,110,-6
7956,49,3978,W,110,104,6
7957,270,3979,W,112,99,13
7958,269,3979,L,99,112,-13
7959,412,3980,L,79,110,-31
7960,411,3980,W,110,79,31
7961,221,3981,L,87,98,-11
7962,222,3981,W,98,87,11
7963,795,3982,L,102,122,-20
7964,796,3982,W,122,102,20
7965,603,3983,W,134,131,3
7966,604,3983,L,131,134,-3
7967,481,3984,W,141,118,23
7968,482,3984,L,118,141,-23
7969,454,3985,L,90,108,-18
7970,453,3985,W,108,90,18
7971,110,3986,L,89,95,-6
7972,109,3986,W,95,89,6
7973,569,3987,L,111,118,-7
7974,570,3987,W,118,111,7
7975,399,3988,L,91,100,-9
7976,400,3988,W,100,91,9
7977,98,3989,L,87,106,-19
7978,97,3989,W,106,87,19
7979,714,3990,L,107,121,-14
7980,713,3990,W,121,107,14
7981,679,3991,L,109,110,-1
7982,680,3991,W,110,109,1
7983,256,3992,W,116,113,3
7984,255,3992,L,113,116,-3
7985,529,3993,W,123,116,7
7986,530,3993,L,116,123,-7
7987,198,3994,W,109,105,4
7988,197,3994,L,105,109,-4
7989,86,3995,W,113,101,12
7990,85,3995,L,101,113,-12
7991,811,3996,W,110,94,16
7992,812,3996,L,94,110,-16
7993,404,3997,L,103,108,-5
7994,403,3997,W,108,103,5
7995,385,3998,L,115,139,-24
7996,386,3998,W,139,115,24
7997,538,3999,W,117,110,7
7998,537,3999,L,110,117,-7
7999,158,4000,L,103,109,-6
8000,157,4000,W,109,103,6
8001,21,4001,L,82,91,-9
8002,22,4001,W,91,82,9
8003,40,4002,L,105,113,-8
8004,39,4002,W,113,105,8
8005,12,4003,L,130,135,-5
8006,11,4003,W,135,130,5
8007,554,4004,W,123,117,6
8008,553,4004,L,117,123,-6
8009,283,4005,L,117,130,-13
8010,284,4005,W,130,117,13
8011,180,4006,L,111,121,-10
8012,179,4006,W,121,111,10
8013,120,4007,L,104,115,-11
8014,119,4007,W,115,104,11
8015,101,4008,L,104,106,-2
8016,102,4008,W,106,104,2
8017,178,4009,L,89,117,-28
8018,177,4009,W,117,89,28
8019,486,4010,L,105,108,-3
8020,485,4010,W,108,105,3
8021,339,4011,L,114,122,-8
8022,340,4011,W,122,114,8
8023,666,4012,W,98,94,4
8024,665,4012,L,94,98,-4
8025,409,4013,L,88,95,-7
8026,410,4013,W,95,88,7
8027,69,4014,L,105,122,-17
8028,70,4014,W,122,105,17
8029,195,4015,L,116,117,-1
8030,196,4015,W,117,116,1
8031,334,4016,L,90,99,-9
8032,333,4016,W,99,90,9
8033,457,4017,W,100,95,5
8034,458,4017,L,95,100,-5
8035,453,4018,L,100,111,-11
8036,454,4018,W,111,100,11
8037,483,4019,L,98,107,-9
8038,484,4019,W,107,98,9
8039,64,4020,L,104,119,-15
8040,63,4020,W,119,104,15
8041,73,4021,L,107,117,-10
8042,74,4021,W,117,107,10
8043,273,4022,L,93,99,-6
8044,274,4022,W,99,93,6
8045,576,4023,L,89,90,-1
8046,575,4023,W,90,89,1
8047,224,4024,W,124,118,6
8048,223,4024,L,118,124,-6
8049,445,4025,W,99,92,7
8050,446,4025,L,92,99,-7
8051,665,4026,W,105,88,17
8052,666,4026,L,88,105,-17
8053,809,4027,L,97,110,-13
8054,810,4027,W,110,97,13
8055,628,4028,W,112,82,30
8056,627,4028,L,82,112,-30
8057,721,4029,W,110,98,12
8058,722,4029,L,98,110,-12
8059,415,4030,W,110,106,4
8060,416,4030,L,106,110,-4
8061,358,4031,L,118,121,-3
8062,357,4031,W,121,118,3
8063,36,4032,W,114,106,8
8064,35,4032,L,106,114,-8
8065,784,4033,L,124,133,-9
8066,783,4033,W,133,124,9
8067,99,4034,W,103,100,3
8068,100,4034,L,100,103,-3
8069,649,4035,L,91,95,-4
8070,650,4035,W,95,91,4
8071,482,4036,W,106,101,5
8072,481,4036,L,101,106,-5
8073,484,4037,W,113,106,7
8074,483,4037,L,106,113,-7
8075,813,4038,W,119,108,11
8076,814,4038,L,108,119,-11
8077,387,4039,W,118,108,10
8078,388,4039,L,108,118,-10
8079,635,4040,W,115,114,1
8080,636,4040,L,114,115,-1
8081,210,4041,L,113,122,-9
8082,209,4041,W,122,113,9
8083,842,4042,W,97,96,1
8084,841,4042,L,96,97,-1
8085,295,4043,L,95,109,-14
8086,296,4043,W,109,95,14
8087,582,4044,W,92,91,1
8088,581,4044,L,91,92,-1
8089,214,4045,L,112,131,-19
8090,213,4045,W,131,112,19
8091,408,4046,L,90,91,-1
8092,407,4046,W,91,90,1
8093,264,4047,L,100,108,-8
8094,263,4047,W,108,100,8
8095,302,4048,L,74,103,-29
8096,301,4048,W,103,74,29
8097,45,4049,W,97,81,16
8098,46,4049,L,81,97,-16
8099,126,4050,L,108,112,-4
8100,125,4050,W,112,108,4
8101,662,4051,L,106,120,-14
8102,661,4051,W,120,106,14
8103,469,4052,W,98,97,1
8104,470,4052,L,97,98,-1
8105,604,4053,W,115,90,25
8106,603,4053,L,90,115,-25
8107,22,4054,W,107,92,15
8108,21,4054,L,92,107,-15
8109,249,4055,L,94,107,-13
8110,250,4055,W,107,94,13
8111,133,4056,L,125,137,-12
8112,134,4056,W,137,125,12
8113,615,4057,W,109,94,15
8114,616,4057,L,94,109,-15
8115,664,4058,L,94,106,-12
8116,663,4058,W,106,94,12
8117,472,4059,W,127,115,12
8118,471,4059,L,115,127,-12
8119,740,4060,W,94,86,8
8120,739,4060,L,86,94,-8
8121,830,4061,L,98,106,-8
8122,829,4061,W,106,98,8
8123,680,4062,L,100,112,-12
8124,679,4062,W,112,100,12
8125,729,4063,L,95,108,-13
8126,730,4063,W,108,95,13
8127,625,4064,L,120,130,-10
8128,626,4064,W,130,120,10
8129,561,4065,L,107,117,-10
8130,562,4065,W,117,107,10
8131,622,4066,W,125,117,8
8132,621,4066,L,117,125,-8
8133,63,4067,L,119,130,-11
8134,64,4067,W,130,119,11
8135,736,4068,L,97,100,-3
8136,735,4068,W,100,97,3
8137,244,4069,L,108,129,-21
8138,243,4069,W,129,108,21
8139,435,4070,L,100,114,-14
8140,436,4070,W,114,100,14
8141,491,4071,L,87,115,-28
8142,492,4071,W,115,87,28
8143,104,4072,W,112,105,7
8144,103,4072,L,105,112,-7
8145,514,4073,W,117,107,10
8146,513,4073,L,107,117,-10
8147,66,4074,L,95,97,-2
8148,65,4074,W,97,95,2
8149,231,4075,W,101,84,17
8150,232,4075,L,84,101,-17
8151,551,4076,L,98,126,-28
8152,552,4076,W,126,98,28
8153,720,4077,L,95,110,-15
8154,719,4077,W,110,95,15
8155,110,4078,L,90,97,-7
8156,109,4078,W,97,90,7
8157,325,4079,L,100,104,-4
8158,326,4079,W,104,100,4
8159,348,4080,L,101,108,-7
8160,347,4080,W,108,101,7
8161,42,4081,L,100,109,-9
8162,41,4081,W,109,100,9
8163,670,4082,L,95,117,-22
8164,669,4082,W,117,95,22
8165,510,4083,W,116,98,18
8166,509,4083,L,98,116,-18
8167,320,4084,L,113,126,-13
8168,319,4084,W,126,113,13
8169,692,4085,L,97,122,-25
8170,691,4085,W,122,97,25
8171,556,4086,W,109,102,7
8172,555,4086,L,102,109,-7
8173,119,4087,W,133,109,24
8174,120,4087,L,109,133,-24
8175,559,4088,L,120,122,-2
8176,560,4088,W,122,120,2
8177,652,4089,W,112,87,25
8178,651,4089,L,87,112,-25
8179,575,4090,L,96,98,-2
8180,576,4090,W,98,96,2
8181,233,4091,L,82,95,-13
8182,234,4091,W,95,82,13
8183,818,4092,W,100,93,7
8184,817,4092,L,93,100,-7
8185,671,4093,W,93,90,3
8186,672,4093,L,90,93,-3
8187,201,4094,L,97,112,-15
8188,202,4094,W,112,97,15
8189,50,4095,L,124,125,-1
8190,49,4095,W,125,124,1
8191,3,4096,L,109,112,-3
8192,4,4096,W,112,109,3
8193,292,4097,L,90,105,-15
8194,291,4097,W,105,90,15
8195,828,4098,W,111,95,16
8196,827,4098,L,95,111,-16
8197,155,4099,L,102,110,-8
8198,156,4099,W,110,102,8
8199,697,4100,L,105,114,-9
8200,698,4100,W,114,105,9
8201,614,4101,L,100,107,-7
8202,613,4101,W,107,100,7
8203,143,4102,L,99,105,-6
8204,144,4102,W,105,99,6
8205,453,4103,L,91,116,-25
8206,454,4103,W,116,91,25
8207,710,4104,W,111,104,7
8208,709,4104,L,104,111,-7
8209,261,4105,L,102,118,-16
8210,262,4105,W,118,102,16
8211,512,4106,W,115,104,11
8212,511,4106,L,104,115,-11
8213,414,4107,L,95,112,-17
8214,413,4107,W,112,95,17
8215,657,4108,W,125,120,5
8216,658,4108,L,120,125,-5
8217,304,4109,L,109,123,-14
8218,303,4109,W,123,109,14
8219,397,4110,W,113,97,16
8220,398,4110,L,97,113,-16
8221,570,4111,L,93,98,-5
8222,569,4111,W,98,93,5
8223,518,4112,L,78,108,-30
8224,517,4112,W,108,78,30
8225,711,4113,L,86,95,-9
8226,712,4113,W,95,86,9
8227,49,4114,W,109,105,4
8228,50,4114,L,105,109,-4
8229,425,4115,L,94,110,-16
8230,426,4115,W,110,94,16
8231,109,4116,L,96,104,-8
8232,110,4116,W,104,96,8
8233,96,4117,L,92,117,-25
8234,95,4117,W,117,92,25
8235,431,4118,L,105,123,-18
8236,432,4118,W,123,105,18
8237,337,4119,W,107,103,4
8238,338,4119,L,103,107,-4
8239,562,4120,L,112,128,-16
8240,561,4120,W,128,112,16
8241,677,4121,W,109,103,6
8242,678,4121,L,103,109,-6
8243,9,4122,L,107,112,-5
8244,10,4122,W,112,107,5
8245,565,4123,W,87,75,12
8246,566,4123,L,75,87,-12
8247,92,4124,W,98,95,3
8248,91,4124,L,95,98,-3
8249,668,4125,L,74,116,-42
8250,667,4125,W,116,74,42
8251,87,4126,L,114,129,-15
8252,88,4126,W,129,114,15
8253,591,4127,W,121,110,11
8254,592,4127,L,110,121,-11
8255,623,4128,L,92,122,-30
8256,624,4128,W,122,92,30
8257,644,4129,W,123,102,21
8258,643,4129,L,102,123,-21
8259,375,4130,L,83,91,-8
8260,376,4130,W,91,83,8
8261,78,4131,W,103,91,12
8262,77,4131,L,91,103,-12
8263,478,4132,L,104,117,-13
8264,477,4132,W,117,104,13
8265,89,4133,L,112,120,-8
8266,90,4133,W,120,112,8
8267,437,4134,L,77,98,-21
8268,438,4134,W,98,77,21
8269,54,4135,W,107,101,6
8270,53,4135,L,101,107,-6
8271,130,4136,L,100,139,-39
8272,129,4136,W,139,100,39
8273,534,4137,W,110,106,4
8274,533,4137,L,106,110,-4
8275,799,4138,W,98,91,7
8276,800,4138,L,91,98,-7
8277,790,4139,W,97,96,1
8278,789,4139,L,96,97,-1
8279,525,4140,W,112,107,5
8280,526,4140,L,107,112,-5
8281,321,4141,W,97,83,14
8282,322,4141,L,83,97,-14
8283,72,4142,L,96,128,-32
8284,71,4142,W,128,96,32
8285,108,4143,L,81,87,-6
8286,107,4143,W,87,81,6
8287,476,4144,L,77,100,-23
8288,475,4144,W,100,77,23
8289,323,4145,L,104,106,-2
8290,324,4145,W,106,104,2
8291,687,4146,W,122,104,18
8292,688,4146,L,104,122,-18
8293,246,4147,L,115,120,-5
8294,245,4147,W,120,115,5
8295,161,4148,L,93,113,-20
8296,162,4148,W,113,93,20
8297,128,4149,L,101,129,-28
8298,127,4149,W,129,101,28
8299,488,4150,W,115,109,6
8300,487,4150,L,109,115,-6
8301,739,4151,L,78,100,-22
8302,740,4151,W,100,78,22
8303,837,4152,L,104,119,-15
8304,838,4152,W,119,104,15
8305,633,4153,L,99,107,-8
8306,634,4153,W,107,99,8
8307,730,4154,L,108,114,-6
8308,729,4154,W,114,108,6
8309,592,4155,L,112,120,-8
8310,591,4155,W,120,112,8
8311,774,4156,L,112,117,-5
8312,773,4156,W,117,112,5
8313,284,4157,W,110,101,9
8314,283,4157,L,101,110,-9
8315,140,4158,L,98,102,-4
8316,139,4158,W,102,98,4
8317,653,4159,L,80,100,-20
8318,654,4159,W,100,80,20
8319,367,4160,W,118,116,2
8320,368,4160,L,116,118,-2
8321,231,4161,L,89,104,-15
8322,232,4161,W,104,89,15
8323,77,4162,W,107,90,17
8324,78,4162,L,90,107,-17
8325,296,4163,L,92,112,-20
8326,295,4163,W,112,92,20
8327,391,4164,L,100,112,-12
8328,392,4164,W,112,100,12
8329,118,4165,W,100,98,2
8330,117,4165,L,98,100,-2
8331,847,4166,W,125,122,3
8332,848,4166,L,122,125,-3
8333,51,4167,L,104,112,-8
8334,52,4167,W,112,104,8
8335,796,4168,W,116,104,12
8336,795,4168,L,104,116,-12
8337,31,4169,W,105,92,13
8338,32,4169,L,92,105,-13
8339,351,4170,W,125,124,1
8340,352,4170,L,124,125,-1
8341,721,4171,L,85,107,-22
8342,722,4171,W,107,85,22
8343,717,4172,L,95,102,-7
8344,718,4172,W,102,95,7
8345,555,4173,L,81,121,-40
8346,556,4173,W,121,81,40
8347,794,4174,L,99,119,-20
8348,793,4174,W,119,99,20
8349,361,4175,W,130,122,8
8350,362,4175,L,122,130,-8
8351,713,4176,L,102,103,-1
8352,714,4176,W,103,102,1
8353,359,4177,L,85,99,-14
8354,360,4177,W,99,85,14
8355,709,4178,L,96,105,-9
8356,710,4178,W,105,96,9
8357,580,4179,L,99,105,-6
8358,579,4179,W,105,99,6
8359,845,4180,W,115,94,21
8360,846,4180,L,94,115,-21
8361,504,4181,W,122,110,12
8362,503,4181,L,110,122,-12
8363,71,4182,L,101,106,-5
8364,72,4182,W,106,101,5
8365,457,4183,L,92,102,-10
8366,458,4183,W,102,92,10
8367,191,4184,L,108,114,-6
8368,192,4184,W,114,108,6
8369,444,4185,W,114,98,16
8370,443,4185,L,98,114,-16
8371,269,4186,L,101,108,-7
8372,270,4186,W,108,101,7
8373,22,4187,L,105,110,-5
8374,21,4187,W,110,105,5
8375,706,4188,W,123,113,10
8376,705,4188,L,113,123,-10
8377,114,4189,W,94,87,7
8378,113,4189,L,87,94,-7
8379,68,4190,L,93,104,-11
8380,67,4190,W,104,93,11
8381,38,4191,L,91,107,-16
8382,37,4191,W,107,91,16
8383,568,4192,W,99,86,13
8384,567,4192,L,86,99,-13
8385,261,4193,L,104,114,-10
8386,262,4193,W,114,104,10
8387,737,4194,L,91,98,-7
8388,738,4194,W,98,91,7
8389,792,4195,L,98,115,-17
8390,791,4195,W,115,98,17
8391,462,4196,W,115,108,7
8392,461,4196,L,108,115,-7
8393,258,4197,W,131,127,4
8394,257,4197,L,127,131,-4
8395,94,4198,L,111,122,-11
8396,93,4198,W,122,111,11
8397,629,4199,W,126,121,5
8398,630,4199,L,121,126,-5
8399,490,4200,L,102,116,-14
8400,489,4200,W,116,102,14
8401,536,4201,W,113,105,8
8402,535,4201,L,105,113,-8
8403,48,4202,W,122,109,13
8404,47,4202,L,109,122,-13
8405,807,4203,W,119,111,8
8406,808,4203,L,111,119,-8
8407,264,4204,L,83,88,-5
8408,263,4204,W,88,83,5
8409,32,4205,L,96,108,-12
8410,31,4205,W,108,96,12
8411,669,4206,L,95,109,-14
8412,670,4206,W,109,95,14
8413,438,4207,L,88,100,-12
8414,437,4207,W,100,88,12
8415,466,4208,W,112,98,14
8416,465,4208,L,98,112,-14
8417,169,4209,L,110,112,-2
8418,170,4209,W,112,110,2
8419,447,4210,W,106,98,8
8420,448,4210,L,98,106,-8
8421,628,4211,W,110,109,1
8422,627,4211,L,109,110,-1
8423,772,4212,W,112,105,7
8424,771,4212,L,105,112,-7
8425,57,4213,L,114,115,-1
8426,58,4213,W,115,114,1
8427,707,4214,W,97,96,1
8428,708,4214,L,96,97,-1
8429,384,4215,W,105,97,8
8430,383,4215,L,97,105,-8
8431,626,4216,L,106,109,-3
8432,625,4216,W,109,106,3
8433,582,4217,L,89,104,-15
8434,581,4217,W,104,89,15
8435,433,4218,L,108,123,-15
8436,434,4218,W,123,108,15
8437,265,4219,W,136,106,30
8438,266,4219,L,106,136,-30
8439,817,4220,L,90,97,-7
8440,818,4220,W,97,90,7
8441,340,4221,W,112,102,10
8442,339,4221,L,102,112,-10
8443,164,4222,L,116,130,-14
8444,163,4222,W,130,116,14
8445,185,4223,L,94,101,-7
8446,186,4223,W,101,94,7
8447,761,4224,W,101,91,10
8448,762,4224,L,91,101,-10
8449,448,4225,L,92,120,-28
8450,447,4225,W,120,92,28
8451,115,4226,L,99,110,-11
8452,116,4226,W,110,99,11
8453,648,4227,L,97,112,-15
8454,647,4227,W,112,97,15
8455,455,4228,W,115,95,20
8456,456,4228,L,95,115,-20
8457,84,4229,L,102,105,-3
8458,83,4229,W,105,102,3
8459,789,4230,L,101,112,-11
8460,790,4230,W,112,101,11
8461,55,4231,W,101,98,3
8462,56,4231,L,98,101,-3
8463,333,4232,L,100,104,-4
8464,334,4232,W,104,100,4
8465,638,4233,W,114,106,8
8466,637,4233,L,106,114,-8
8467,181,4234,L,111,118,-7
8468,182,4234,W,118,111,7
8469,494,4235,W,135,130,5
8470,493,4235,L,130,135,-5
8471,661,4236,L,103,120,-17
8472,662,4236,W,120,103,17
8473,630,4237,L,109,114,-5
8474,629,4237,W,114,109,5
8475,61,4238,L,87,94,-7
8476,62,4238,W,94,87,7
8477,536,4239,W,101,90,11
8478,535,4239,L,90,101,-11
8479,206,4240,W,109,100,9
8480,205,4240,L,100,109,-9
8481,637,4241,W,105,96,9
8482,638,4241,L,96,105,-9
8483,463,4242,L,95,100,-5
8484,464,4242,W,100,95,5
8485,557,4243,L,98,125,-27
8486,558,4243,W,125,98,27
8487,290,4244,W,110,98,12
8488,289,4244,L,98,110,-12
8489,660,4245,L,86,109,-23
8490,659,4245,W,109,86,23
8491,346,4246,W,122,103,19
8492,345,4246,L,103,122,-19
8493,377,4247,L,99,100,-1
8494,378,4247,W,100,99,1
8495,79,4248,W,107,80,27
8496,80,4248,L,80,107,-27
8497,354,4249,L,99,103,-4
8498,353,4249,W,103,99,4
8499,452,4250,L,113,120,-7
8500,451,4250,W,120,113,7
8501,859,4251,W,109,104,5
8502,860,4251,L,104,109,-5
8503,585,4252,L,112,130,-18
8504,586,4252,W,130,112,18
8505,386,4253,L,108,112,-4
8506,385,4253,W,112,108,4
8507,51,4254,L,106,109,-3
8508,52,4254,W,109,106,3
8509,870,4255,W,125,107,18
8510,869,4255,L,107,125,-18
8511,14,4256,W,92,91,1
8512,13,4256,L,91,92,-1
8513,324,4257,W,119,108,11
8514,323,4257,L,108,119,-11
8515,553,4258,W,102,88,14
8516,554,4258,L,88,102,-14
8517,165,4259,W,117,108,9
8518,166,4259,L,108,117,-9
8519,523,4260,W,114,98,16
8520,524,4260,L,98,114,-16
8521,764,4261,L,95,102,-7
8522,763,4261,W,102,95,7
8523,418,4262,L,89,96,-7
8524,417,4262,W,96,89,7
8525,16,4263,W,119,98,21
8526,15,4263,L,98,119,-21
8527,410,4264,W,102,92,10
8528,409,4264,L,92,102,-10
8529,642,4265,W,104,98,6
8530,641,4265,L,98,104,-6
8531,310,4266,L,96,100,-4
8532,309,4266,W,100,96,4
8533,857,4267,L,121,124,-3
8534,858,4267,W,124,121,3
8535,5,4268,L,110,118,-8
8536,6,4268,W,118,110,8
8537,578,4269,W,105,98,7
8538,577,4269,L,98,105,-7
8539,689,4270,L,106,112,-6
8540,690,4270,W,112,106,6
8541,428,4271,L,86,105,-19
8542,427,4271,W,105,86,19
8543,752,4272,W,99,85,14
8544,751,4272,L,85,99,-14
8545,122,4273,L,95,112,-17
8546,121,4273,W,112,95,17
8547,139,4274,L,95,113,-18
8548,140,4274,W,113,95,18
8549,357,4275,L,83,96,-13
8550,358,4275,W,96,83,13
8551,287,4276,L,130,142,-12
8552,288,4276,W,142,130,12
8553,83,4277,L,109,110,-1
8554,84,4277,W,110,109,1
8555,274,4278,W,117,99,18
8556,273,4278,L,99,117,-18
8557,810,4279,L,92,102,-10
8558,809,4279,W,102,92,10
8559,823,4280,W,109,95,14
8560,824,4280,L,95,109,-14
8561,479,4281,W,108,90,18
8562,480,4281,L,90,108,-18
8563,467,4282,L,121,128,-7
8564,468,4282,W,128,121,7
8565,105,4283,L,112,120,-8
8566,106,4283,W,120,112,8
8567,131,4284,L,97,107,-10
8568,132,4284,W,107,97,10
8569,547,4285,W,105,97,8
8570,548,4285,L,97,105,-8
8571,381,4286,L,84,97,-13
8572,382,4286,W,97,84,13
8573,218,4287,L,93,110,-17
8574,217,4287,W,110,93,17
8575,786,4288,L,109,129,-20
8576,785,4288,W,129,109,20
8577,29,4289,L,104,119,-15
8578,30,4289,W,119,104,15
8579,31,4290,L,100,116,-16
8580,32,4290,W,116,100,16
8581,275,4291,L,113,123,-10
8582,276,4291,W,123,113,10
8583,505,4292,L,108,114,-6
8584,506,4292,W,114,108,6
8585,562,4293,W,129,99,30
8586,561,4293,L,99,129,-30
8587,373,4294,W,112,103,9
8588,374,4294,L,103,112,-9
8589,654,4295,L,103,104,-1
8590,653,4295,W,104,103,1
8591,238,4296,W,111,98,13
8592,237,4296,L,98,111,-13
8593,435,4297,L,86,109,-23
8594,436,4297,W,109,86,23
8595,144,4298,L,108,116,-8
8596,143,4298,W,116,108,8
8597,459,4299,W,112,99,13
8598,460,4299,L,99,112,-13
8599,606,4300,L,84,99,-15
8600,605,4300,W,99,84,15
8601,504,4301,L,101,137,-36
8602,503,4301,W,137,101,36
8603,98,4302,L,88,111,-23
8604,97,4302,W,111,88,23
8605,234,4303,W,95,91,4
8606,233,4303,L,91,95,-4
8607,415,4304,L,85,90,-5
8608,416,4304,W,90,85,5
8609,769,4305,L,91,98,-7
8610,770,4305,W,98,91,7
8611,819,4306,W,117,109,8
8612,820,4306,L,109,117,-8
8613,394,4307,W,107,79,28
8614,393,4307,L,79,107,-28
8615,12,4308,L,104,113,-9
8616,11,4308,W,113,104,9
8617,228,4309,W,129,125,4
8618,227,4309,L,125,129,-4
8619,330,4310,L,105,116,-11
8620,329,4310,W,116,105,11
8621,560,4311,L,94,105,-11
8622,559,4311,W,105,94,11
8623,159,4312,W,97,96,1
8624,160,4312,L,96,97,-1
8625,700,4313,W,116,108,8
8626,699,4313,L,108,116,-8
8627,378,4314,W,110,106,4
8628,377,4314,L,106,110,-4
8629,27,4315,W,110,108,2
8630,28,4315,L,108,110,-2
8631,745,4316,W,111,98,13
8632,746,4316,L,98,111,-13
8633,398,4317,W,109,104,5
8634,397,4317,L,104,109,-5
8635,116,4318,W,116,107,9
8636,115,4318,L,107,116,-9
8637,47,4319,W,112,103,9
8638,48,4319,L,103,112,-9
8639,730,4320,W,88,72,16
8640,729,4320,L,72,88,-16
8641,369,4321,L,110,132,-22
8642,370,4321,W,132,110,22
8643,486,4322,L,89,102,-13
8644,485,4322,W,102,89,13
8645,188,4323,L,98,120,-22
8646,187,4323,W,120,98,22
8647,844,4324,W,105,99,6
8648,843,4324,L,99,105,-6
8649,566,4325,W,102,101,1
8650,565,4325,L,101,102,-1
8651,349,4326,L,89,117,-28
8652,350,4326,W,117,89,28
8653,829,4327,L,90,94,-4
8654,830,4327,W,94,90,4
8655,177,4328,L,99,105,-6
8656,178,4328,W,105,99,6
8657,360,4329,W,116,100,16
8658,359,4329,L,100,116,-16
8659,474,4330,L,80,112,-32
8660,473,4330,W,112,80,32
8661,530,4331,L,102,133,-31
8662,529,4331,W,133,102,31
8663,558,4332,L,109,117,-8
8664,557,4332,W,117,109,8
8665,319,4333,L,109,125,-16
8666,320,4333,W,125,109,16
8667,828,4334,W,130,114,16
8668,827,4334,L,114,130,-16
8669,336,4335,W,112,104,8
8670,335,4335,L,104,112,-8
8671,858,4336,W,107,102,5
8672,857,4336,L,102,107,-5
8673,663,4337,W,122,107,15
8674,664,4337,L,107,122,-15
8675,850,4338,L,107,108,-1
8676,849,4338,W,108,107,1
8677,756,4339,W,131,123,8
8678,755,4339,L,123,131,-8
8679,396,4340,W,108,99,9
8680,395,4340,L,99,108,-9
8681,303,4341,W,122,106,16
8682,304,4341,L,106,122,-16
8683,732,4342,W,103,92,11
8684,731,4342,L,92,103,-11
8685,338,4343,W,122,114,8
8686,337,4343,L,114,122,-8
8687,468,4344,L,97,115,-18
8688,467,4344,W,115,97,18
8689,237,4345,L,107,112,-5
8690,238,4345,W,112,107,5
8691,184,4346,L,105,112,-7
8692,183,4346,W,112,105,7
8693,248,4347,W,120,111,9
8694,247,4347,L,111,120,-9
8695,317,4348,W,107,95,12
8696,318,4348,L,95,107,-12
8697,539,4349,L,109,118,-9
8698,540,4349,W,118,109,9
8699,3,4350,W,112,111,1
8700,4,4350,L,111,112,-1
8701,62,4351,L,92,123,-31
8702,61,4351,W,123,92,31
8703,26,4352,W,106,88,18
8704,25,4352,L,88,106,-18
8705,585,4353,L,91,110,-19
8706,586,4353,W,110,91,19
8707,508,4354,L,109,112,-3
8708,507,4354,W,112,109,3
8709,698,4355,W,119,115,4
8710,697,4355,L,115,119,-4
8711,702,4356,L,102,121,-19
8712,701,4356,W,121,102,19
8713,693,4357,L,106,117,-11
8714,694,4357,W,117,106,11
8715,11,4358,W,132,117,15
8716,12,4358,L,117,132,-15
8717,235,4359,W,111,103,8
8718,236,4359,L,103,111,-8
8719,263,4360,W,127,94,33
8720,264,4360,L,94,127,-33
8721,243,4361,W,114,110,4
8722,244,4361,L,110,114,-4
8723,826,4362,L,92,108,-16
8724,825,4362,W,108,92,16
8725,173,4363,W,114,113,1
8726,174,4363,L,113,114,-1
8727,313,4364,L,104,128,-24
8728,314,4364,W,128,104,24
8729,59,4365,L,107,111,-4
8730,60,4365,W,111,107,4
8731,775,4366,L,109,118,-9
8732,776,4366,W,118,109,9
8733,28,4367,L,106,111,-5
8734,27,4367,W,111,106,5
8735,471,4368,W,140,135,5
8736,472,4368,L,135,140,-5
8737,109,4369,L,74,89,-15
8738,110,4369,W,89,74,15
8739,598,4370,W,112,107,5
8740,597,4370,L,107,112,-5
8741,268,4371,L,87,110,-23
8742,267,4371,W,110,87,23
8743,743,4372,W,120,95,25
8744,744,4372,L,95,120,-25
8745,432,4373,W,115,113,2
8746,431,4373,L,113,115,-2
8747,609,4374,W,121,107,14
8748,610,4374,L,107,121,-14
8749,266,4375,L,96,113,-17
8750,265,4375,W,113,96,17
8751,802,4376,L,90,93,-3
8752,801,4376,W,93,90,3
8753,141,4377,W,103,95,8
8754,142,4377,L,95,103,-8
8755,489,4378,L,102,107,-5
8756,490,4378,W,107,102,5
8757,629,4379,L,99,105,-6
8758,630,4379,W,105,99,6
8759,792,4380,L,84,105,-21
8760,791,4380,W,105,84,21
8761,309,4381,W,137,112,25
8762,310,4381,L,112,137,-25
8763,557,4382,L,102,125,-23
8764,558,4382,W,125,102,23
8765,30,4383,W,111,104,7
8766,29,4383,L,104,111,-7
8767,219,4384,L,97,121,-24
8768,220,4384,W,121,97,24
8769,204,4385,L,91,105,-14
8770,203,4385,W,105,91,14
8771,427,4386,L,86,113,-27
8772,428,4386,W,113,86,27
8773,673,4387,L,98,105,-7
8774,674,4387,W,105,98,7
8775,686,4388,W,107,99,8
8776,685,4388,L,99,107,-8
8777,436,4389,L,106,109,-3
8778,435,4389,W,109,106,3
8779,53,4390,W,105,103,2
8780,54,4390,L,103,105,-2
8781,213,4391,L,94,102,-8
8782,214,4391,W,102,94,8
8783,174,4392,W,108,104,4
8784,173,4392,L,104,108,-4
8785,289,4393,L,117,121,-4
8786,290,4393,W,121,117,4
8787,846,4394,L,117,121,-4
8788,845,4394,W,121,117,4
8789,456,4395,L,107,113,-6
8790,455,4395,W,113,107,6
8791,112,4396,L,108,116,-8
8792,111,4396,W,116,108,8
8793,502,4397,W,106,97,9
8794,501,4397,L,97,106,-9
8795,208,4398,L,102,114,-12
8796,207,4398,W,114,102,12
8797,276,4399,W,133,120,13
8798,275,4399,L,120,133,-13
8799,814,4400,L,108,116,-8
8800,813,4400,W,116,108,8
8801,684,4401,W,113,108,5
8802,683,4401,L,108,113,-5
8803,236,4402,L,86,102,-16
8804,235,4402,W,102,86,16
8805,699,4403,L,97,125,-28
8806,700,4403,W,125,97,28
8807,667,4404,L,95,113,-18
8808,668,4404,W,113,95,18
8809,480,4405,L,93,116,-23
8810,479,4405,W,116,93,23
8811,804,4406,L,111,126,-15
8812,803,4406,W,126,111,15
8813,659,4407,L,98,118,-20
8814,660,4407,W,118,98,20
8815,132,4408,L,104,109,-5
8816,131,4408,W,109,104,5
8817,442,4409,W,128,100,28
8818,441,4409,L,100,128,-28
8819,578,4410,W,119,99,20
8820,577,4410,L,99,119,-20
8821,824,4411,L,88,104,-16
8822,823,4411,W,104,88,16
8823,226,4412,W,98,88,10
8824,225,4412,L,88,98,-10
8825,592,4413,W,95,90,5
8826,591,4413,L,90,95,-5
8827,224,4414,W,124,114,10
8828,223,4414,L,114,124,-10
8829,458,4415,L,94,108,-14
8830,457,4415,W,108,94,14
8831,127,4416,L,116,120,-4
8832,128,4416,W,120,116,4
8833,279,4417,L,101,117,-16
8834,280,4417,W,117,101,16
8835,113,4418,L,106,108,-2
8836,114,4418,W,108,106,2
8837,655,4419,L,98,115,-17
8838,656,4419,W,115,98,17
8839,7,4420,L,83,105,-22
8840,8,4420,W,105,83,22
8841,641,4421,L,109,113,-4
8842,642,4421,W,113,109,4
8843,586,4422,W,115,96,19
8844,585,4422,L,96,115,-19
8845,331,4423,L,105,111,-6
8846,332,4423,W,111,105,6
8847,395,4424,L,96,104,-8
8848,396,4424,W,104,96,8
8849,342,4425,L,119,122,-3
8850,341,4425,W,122,119,3
8851,833,4426,L,97,104,-7
8852,834,4426,W,104,97,7
8853,277,4427,W,105,101,4
8854,278,4427,L,101,105,-4
8855,540,4428,L,91,107,-16
8856,539,4428,W,107,91,16
8857,203,4429,W,107,94,13
8858,204,4429,L,94,107,-13
8859,611,4430,W,113,111,2
8860,612,4430,L,111,113,-2
8861,214,4431,W,114,113,1
8862,213,4431,L,113,114,-1
8863,271,4432,L,139,142,-3
8864,272,4432,W,142,139,3
8865,166,4433,L,101,120,-19
8866,165,4433,W,120,101,19
8867,514,4434,L,108,121,-13
8868,513,4434,W,121,108,13
8869,275,4435,L,98,144,-46
8870,276,4435,W,144,98,46
8871,751,4436,W,109,106,3
8872,752,4436,L,106,109,-3
8873,841,4437,L,103,116,-13
8874,842,4437,W,116,103,13
8875,215,4438,W,102,95,7
8876,216,4438,L,95,102,-7
8877,100,4439,W,112,108,4
8878,99,4439,L,108,112,-4
8879,725,4440,L,109,129,-20
8880,726,4440,W,129,109,20
8881,519,4441,W,123,112,11
8882,520,4441,L,112,123,-11
8883,152,4442,W,123,118,5
8884,151,4442,L,118,123,-5
8885,145,4443,L,109,112,-3
8886,146,4443,W,112,109,3
8887,195,4444,L,98,128,-30
8888,196,4444,W,128,98,30
8889,55,4445,L,103,119,-16
8890,56,4445,W,119,103,16
8891,788,4446,W,100,88,12
8892,787,4446,L,88,100,-12
8893,741,4447,L,111,115,-4
8894,742,4447,W,115,111,4
8895,326,4448,W,112,86,26
8896,325,4448,L,86,112,-26
8897,186,4449,L,86,102,-16
8898,185,4449,W,102,86,16
8899,430,4450,L,107,110,-3
8900,429,4450,W,110,107,3
8901,821,4451,L,116,124,-8
8902,822,4451,W,124,116,8
8903,229,4452,L,88,96,-8
8904,230,4452,W,96,88,8
8905,581,4453,L,98,109,-11
8906,582,4453,W,109,98,11
8907,520,4454,L,120,127,-7
8908,519,4454,W,127,120,7
8909,636,4455,W,109,103,6
8910,635,4455,L,103,109,-6
8911,840,4456,L,95,103,-8
8912,839,4456,W,103,95,8
8913,803,4457,W,113,103,10
8914,804,4457,L,103,113,-10
8915,465,4458,W,114,109,5
8916,466,4458,L,109,114,-5
8917,101,4459,W,119,114,5
8918,102,4459,L,114,119,-5
8919,862,4460,W,116,112,4
8920,861,4460,L,112,116,-4
8921,6,4461,W,114,105,9
8922,5,4461,L,105,114,-9
8923,190,4462,L,99,101,-2
8924,189,4462,W,101,99,2
8925,46,4463,L,98,105,-7
8926,45,4463,W,105,98,7
8927,396,4464,W,109,106,3
8928,395,4464,L,106,109,-3
8929,405,4465,L,109,120,-11
8930,406,4465,W,120,109,11
8931,156,4466,L,108,123,-15
8932,155,4466,W,123,108,15
8933,392,4467,L,110,121,-11
8934,391,4467,W,121,110,11
8935,737,4468,W,100,92,8
8936,738,4468,L,92,100,-8
8937,779,4469,W,112,111,1
8938,780,4469,L,111,112,-1
8939,135,4470,L,93,103,-10
8940,136,4470,W,103,93,10
8941,82,4471,W,108,106,2
8942,81,4471,L,106,108,-2
8943,107,4472,W,109,103,6
8944,108,4472,L,103,109,-6
8945,605,4473,W,115,105,10
8946,606,4473,L,105,115,-10
8947,327,4474,W,112,86,26
8948,328,4474,L,86,112,-26
8949,419,4475,L,122,124,-2
8950,420,4475,W,124,122,2
8951,52,4476,W,97,95,2
8952,51,4476,L,95,97,-2
8953,390,4477,W,109,104,5
8954,389,4477,L,104,109,-5
8955,500,4478,L,102,105,-3
8956,499,4478,W,105,102,3
8957,570,4479,W,109,99,10
8958,569,4479,L,99,109,-10
8959,242,4480,L,114,127,-13
8960,241,4480,W,127,114,13
8961,364,4481,W,115,103,12
8962,363,4481,L,103,115,-12
8963,460,4482,L,108,111,-3
8964,459,4482,W,111,108,3
8965,94,4483,L,73,122,-49
8966,93,4483,W,122,73,49
8967,624,4484,W,118,98,20
8968,623,4484,L,98,118,-20
8969,301,4485,W,118,115,3
8970,302,4485,L,115,118,-3
8971,618,4486,L,112,113,-1
8972,617,4486,W,113,112,1
8973,639,4487,W,107,105,2
8974,640,4487,L,105,107,-2
8975,613,4488,L,100,109,-9
8976,614,4488,W,109,100,9
8977,87,4489,L,98,123,-25
8978,88,4489,W,123,98,25
8979,597,4490,L,99,102,-3
8980,598,4490,W,102,99,3
8981,434,4491,W,119,95,24
8982,433,4491,L,95,119,-24
8983,25,4492,L,97,109,-12
8984,26,4492,W,109,97,12
8985,446,4493,L,93,110,-17
8986,445,4493,W,110,93,17
8987,59,4494,L,105,112,-7
8988,60,4494,W,112,105,7
8989,247,4495,W,127,123,4
8990,248,4495,L,123,127,-4
8991,484,4496,W,125,108,17
8992,483,4496,L,108,125,-17
8993,138,4497,L,96,112,-16
8994,137,4497,W,112,96,16
8995,416,4498,L,78,113,-35
8996,415,4498,W,113,78,35
8997,192,4499,L,92,93,-1
8998,191,4499,W,93,92,1
8999,184,4500,W,112,107,5
9000,183,4500,L,107,112,-5
9001,102,4501,L,93,102,-9
9002,101,4501,W,102,93,9
9003,407,4502,L,91,107,-16
9004,408,4502,W,107,91,16
9005,749,4503,W,143,114,29
9006,750,4503,L,114,143,-29
9007,200,4504,L,95,108,-13
9008,199,4504,W,108,95,13
9009,219,4505,L,104,118,-14
9010,220,4505,W,118,104,14
9011,37,4506,W,104,101,3
9012,38,4506,L,101,104,-3
9013,864,4507,L,103,118,-15
9014,863,4507,W,118,103,15
9015,417,4508,L,95,99,-4
9016,418,4508,W,99,95,4
9017,280,4509,W,113,110,3
9018,279,4509,L,110,113,-3
9019,39,4510,L,89,94,-5
9020,40,4510,W,94,89,5
9021,812,4511,W,117,106,11
9022,811,4511,L,106,117,-11
9023,241,4512,L,92,111,-19
9024,242,4512,W,111,92,19
9025,515,4513,L,101,104,-3
9026,516,4513,W,104,101,3
9027,827,4514,L,100,121,-21
9028,828,4514,W,121,100,21
9029,44,4515,L,95,118,-23
9030,43,4515,W,118,95,23
9031,154,4516,L,98,118,-20
9032,153,4516,W,118,98,20
9033,656,4517,L,85,107,-22
9034,655,4517,W,107,85,22
9035,742,4518,W,106,100,6
9036,741,4518,L,100,106,-6
9037,379,4519,W,99,98,1
9038,380,4519,L,98,99,-1
9039,820,4520,L,103,109,-6
9040,819,4520,W,109,103,6
9041,817,4521,L,114,122,-8
9042,818,4521,W,122,114,8
9043,127,4522,W,127,121,6
9044,128,4522,L,121,127,-6
9045,141,4523,W,119,109,10
9046,142,4523,L,109,119,-10
9047,724,4524,L,98,108,-10
9048,723,4524,W,108,98,10
9049,747,4525,L,112,125,-13
9050,748,4525,W,125,112,13
9051,465,4526,W,113,104,9
9052,466,4526,L,104,113,-9
9053,564,4527,L,91,126,-35
9054,563,4527,W,126,91,35
9055,352,4528,L,101,120,-19
9056,351,4528,W,120,101,19
9057,2,4529,W,106,101,5
9058,1,4529,L,101,106,-5
9059,521,4530,L,95,98,-3
9060,522,4530,W,98,95,3
9061,272,4531,W,108,107,1
9062,271,4531,L,107,108,-1
9063,147,4532,L,98,120,-22
9064,148,4532,W,120,98,22
9065,701,4533,W,102,97,5
9066,702,4533,L,97,102,-5
9067,382,4534,L,87,98,-11
9068,381,4534,W,98,87,11
9069,13,4535,L,101,116,-15
9070,14,4535,W,116,101,15
9071,426,4536,W,122,118,4
9072,425,4536,L,118,122,-4
9073,800,4537,W,108,104,4
9074,799,4537,L,104,108,-4
9075,735,4538,L,98,111,-13
9076,736,4538,W,111,98,13
9077,734,4539,W,137,112,25
9078,733,4539,L,112,137,-25
9079,120,4540,L,97,113,-16
9080,119,4540,W,113,97,16
9081,106,4541,L,93,109,-16
9082,105,4541,W,109,93,16
9083,537,4542,L,99,107,-8
9084,538,4542,W,107,99,8
9085,602,4543,L,105,108,-3
9086,601,4543,W,108,105,3
9087,704,4544,L,107,114,-7
9088,703,4544,W,114,107,7
9089,322,4545,L,77,110,-33
9090,321,4545,W,110,77,33
9091,843,4546,L,93,102,-9
9092,844,4546,W,102,93,9
9093,524,4547,W,103,101,2
9094,523,4547,L,101,103,-2
9095,861,4548,W,120,108,12
9096,862,4548,L,108,120,-12
9097,433,4549,W,110,105,5
9098,434,4549,L,105,110,-5
9099,142,4550,L,113,132,-19
9100,141,4550,W,132,113,19
9101,26,4551,L,108,116,-8
9102,25,4551,W,116,108,8
9103,593,4552,L,86,96,-10
9104,594,4552,W,96,86,10
9105,374,4553,W,115,109,6
9106,373,4553,L,109,115,-6
9107,621,4554,L,112,140,-28
9108,622,4554,W,140,112,28
9109,34,4555,L,107,127,-20
9110,33,4555,W,127,107,20
9111,117,4556,W,113,108,5
9112,118,4556,L,108,113,-5
9113,750,4557,W,104,95,9
9114,749,4557,L,95,104,-9
9115,15,4558,L,94,134,-40
9116,16,4558,W,134,94,40
9117,399,4559,L,89,104,-15
9118,400,4559,W,104,89,15
9119,155,4560,L,108,117,-9
9120,156,4560,W,117,108,9
9121,208,4561,L,95,103,-8
9122,207,4561,W,103,95,8
9123,84,4562,L,97,98,-1
9124,83,4562,W,98,97,1
9125,590,4563,L,96,105,-9
9126,589,4563,W,105,96,9
9127,832,4564,L,86,102,-16
9128,831,4564,W,102,86,16
9129,288,4565,L,105,119,-14
9130,287,4565,W,119,105,14
9131,499,4566,L,95,107,-12
9132,500,4566,W,107,95,12
9133,45,4567,W,108,87,21
9134,46,4567,L,87,108,-21
9135,695,4568,W,109,107,2
9136,696,4568,L,107,109,-2
9137,131,4569,L,106,114,-8
9138,132,4569,W,114,106,8
9139,389,4570,L,94,100,-6
9140,390,4570,W,100,94,6
9141,318,4571,L,114,121,-7
9142,317,4571,W,121,114,7
9143,9,4572,L,99,101,-2
9144,10,4572,W,101,99,2
9145,376,4573,L,92,100,-8
9146,375,4573,W,100,92,8
9147,21,4574,W,117,97,20
9148,22,4574,L,97,117,-20
9149,675,4575,W,110,96,14
9150,676,4575,L,96,110,-14
9151,381,4576,L,92,101,-9
9152,382,4576,W,101,92,9
9153,441,4577,W,109,94,15
9154,442,4577,L,94,109,-15
9155,541,4578,L,86,98,-12
9156,542,4578,W,98,86,12
9157,216,4579,L,79,88,-9
9158,215,4579,W,88,79,9
9159,645,4580,L,95,111,-16
9160,646,4580,W,111,95,16
9161,863,4581,W,120,116,4
9162,864,4581,L,116,120,-4
9163,436,4582,W,117,106,11
9164,435,4582,L,106,117,-11
9165,451,4583,W,125,124,1
9166,452,4583,L,124,125,-1
9167,797,4584,W,129,122,7
9168,798,4584,L,122,129,-7
9169,482,4585,W,105,95,10
9170,481,4585,L,95,105,-10
9171,176,4586,W,107,101,6
9172,175,4586,L,101,107,-6
9173,588,4587,L,108,117,-9
9174,587,4587,W,117,108,9
9175,107,4588,L,109,123,-14
9176,108,4588,W,123,109,14
9177,464,4589,W,97,82,15
9178,463,4589,L,82,97,-15
9179,239,4590,L,106,121,-15
9180,240,4590,W,121,106,15
9181,366,4591,L,85,102,-17
9182,365,4591,W,102,85,17
9183,80,4592,W,94,92,2
9184,79,4592,L,92,94,-2
9185,560,4593,L,118,123,-5
9186,559,4593,W,123,118,5
9187,838,4594,L,105,112,-7
9188,837,4594,W,112,105,7
9189,470,4595,W,106,98,8
9190,469,4595,L,98,106,-8
9191,664,4596,W,128,119,9
9192,663,4596,L,119,128,-9
9193,144,4597,L,106,110,-4
9194,143,4597,W,110,106,4
9195,314,4598,W,100,93,7
9196,313,4598,L,93,100,-7
9197,124,4599,L,100,127,-27
9198,123,4599,W,127,100,27
9199,68,4600,W,116,111,5
9200,67,4600,L,111,116,-5
9201,822,4601,W,116,108,8
9202,821,4601,L,108,116,-8
9203,220,4602,W,127,99,28
9204,219,4602,L,99,127,-28
9205,865,4603,W,99,94,5
9206,866,4603,L,94,99,-5
9207,501,4604,L,109,121,-12
9208,502,4604,W,121,109,12
9209,46,4605,L,109,118,-9
9210,45,4605,W,118,109,9
9211,505,4606,L,114,115,-1
9212,506,4606,W,115,114,1
9213,133,4607,L,116,118,-2
9214,134,4607,W,118,116,2
9215,118,4608,W,102,95,7
9216,117,4608,L,95,102,-7
9217,294,4609,L,93,101,-8
9218,293,4609,W,101,93,8
9219,612,4610,L,117,125,-8
9220,611,4610,W,125,117,8
9221,443,4611,L,106,115,-9
9222,444,4611,W,115,106,9
9223,527,4612,W,107,102,5
9224,528,4612,L,102,107,-5
9225,67,4613,W,105,104,1
9226,68,4613,L,104,105,-1
9227,274,4614,W,106,94,12
9228,273,4614,L,94,106,-12
9229,85,4615,L,112,123,-11
9230,86,4615,W,123,112,11
9231,428,4616,W,111,92,19
9232,427,4616,L,92,111,-19
9233,335,4617,L,104,115,-11
9234,336,4617,W,115,104,11
9235,526,4618,L,105,113,-8
9236,525,4618,W,113,105,8
9237,791,4619,W,121,116,5
9238,792,4619,L,116,121,-5
9239,202,4620,L,90,99,-9
9240,201,4620,W,99,90,9
9241,81,4621,L,82,110,-28
9242,82,4621,W,110,82,28
9243,853,4622,L,91,93,-2
9244,854,4622,W,93,91,2
9245,32,4623,W,120,113,7
9246,31,4623,L,113,120,-7
9247,404,4624,L,102,116,-14
9248,403,4624,W,116,102,14
9249,856,4625,L,91,101,-10
9250,855,4625,W,101,91,10
9251,370,4626,L,119,127,-8
9252,369,4626,W,127,119,8
9253,411,4627,L,94,98,-4
9254,412,4627,W,98,94,4
9255,223,4628,L,98,109,-11
9256,224,4628,W,109,98,11
9257,647,4629,W,101,89,12
9258,648,4629,L,89,101,-12
9259,420,4630,L,82,90,-8
9260,419,4630,W,90,82,8
9261,535,4631,W,115,103,12
9262,536,4631,L,103,115,-12
9263,487,4632,L,111,118,-7
9264,488,4632,W,118,111,7
9265,252,4633,W,123,114,9
9266,251,4633,L,114,123,-9
9267,841,4634,W,107,98,9
9268,842,4634,L,98,107,-9
9269,679,4635,W,95,89,6
9270,680,4635,L,89,95,-6
9271,225,4636,L,104,117,-13
9272,226,4636,W,117,104,13
9273,634,4637,L,112,114,-2
9274,633,4637,W,114,112,2
9275,148,4638,L,88,114,-26
9276,147,4638,W,114,88,26
9277,1,4639,L,86,91,-5
9278,2,4639,W,91,86,5
9279,104,4640,W,121,109,12
9280,103,4640,L,109,121,-12
9281,372,4641,L,122,129,-7
9282,371,4641,W,129,122,7
9283,408,4642,W,112,98,14
9284,407,4642,L,98,112,-14
9285,616,4643,W,116,96,20
9286,615,4643,L,96,116,-20
9287,43,4644,L,98,105,-7
9288,44,4644,W,105,98,7
9289,778,4645,W,124,122,2
9290,777,4645,L,122,124,-2
9291,534,4646,L,94,110,-16
9292,533,4646,W,110,94,16
9293,345,4647,L,116,140,-24
9294,346,4647,W,140,116,24
9295,718,4648,L,99,116,-17
9296,717,4648,W,116,99,17
9297,676,4649,L,92,104,-12
9298,675,4649,W,104,92,12
9299,126,4650,L,114,117,-3
9300,125,4650,W,117,114,3
9301,651,4651,L,99,108,-9
9302,652,4651,W,108,99,9
9303,244,4652,L,95,118,-23
9304,243,4652,W,118,95,23
9305,76,4653,L,101,111,-10
9306,75,4653,W,111,101,10
9307,363,4654,L,91,99,-8
9308,364,4654,W,99,91,8
9309,270,4655,L,82,91,-9
9310,269,4655,W,91,82,9
9311,806,4656,L,83,100,-17
9312,805,4656,W,100,83,17
9313,207,4657,L,80,114,-34
9314,208,4657,W,114,80,34
9315,93,4658,W,101,89,12
9316,94,4658,L,89,101,-12
9317,353,4659,L,118,124,-6
9318,354,4659,W,124,118,6
9319,556,4660,W,120,101,19
9320,555,4660,L,101,120,-19
9321,601,4661,L,98,119,-21
9322,602,4661,W,119,98,21
9323,237,4662,L,105,111,-6
9324,238,4662,W,111,105,6
9325,271,4663,L,98,102,-4
9326,272,4663,W,102,98,4
9327,298,4664,L,99,101,-2
9328,297,4664,W,101,99,2
9329,485,4665,W,119,94,25
9330,486,4665,L,94,119,-25
9331,459,4666,L,103,105,-2
9332,460,4666,W,105,103,2
9333,315,4667,L,89,102,-13
9334,316,4667,W,102,89,13
9335,343,4668,L,111,121,-10
9336,344,4668,W,121,111,10
9337,254,4669,L,98,102,-4
9338,253,4669,W,102,98,4
9339,230,4670,W,102,100,2
9340,229,4670,L,100,102,-2
9341,23,4671,L,103,113,-10
9342,24,4671,W,113,103,10
9343,168,4672,W,106,94,12
9344,167,4672,L,94,106,-12
9345,259,4673,W,123,107,16
9346,260,4673,L,107,123,-16
9347,358,4674,L,104,111,-7
9348,357,4674,W,111,104,7
9349,341,4675,L,100,102,-2
9350,342,4675,W,102,100,2
9351,530,4676,L,115,131,-16
9352,529,4676,W,131,115,16
9353,282,4677,L,102,112,-10
9354,281,4677,W,112,102,10
9355,71,4678,L,90,106,-16
9356,72,4678,W,106,90,16
9357,690,4679,W,95,91,4
9358,689,4679,L,91,95,-4
9359,175,4680,L,102,107,-5
9360,176,4680,W,107,102,5
9361,60,4681,L,118,120,-2
9362,59,4681,W,120,118,2
9363,75,4682,L,85,90,-5
9364,76,4682,W,90,85,5
9365,88,4683,W,106,102,4
9366,87,4683,L,102,106,-4
9367,543,4684,L,90,104,-14
9368,544,4684,W,104,90,14
9369,563,4685,L,108,109,-1
9370,564,4685,W,109,108,1
9371,584,4686,L,100,119,-19
9372,583,4686,W,119,100,19
9373,811,4687,W,119,114,5
9374,812,4687,L,114,119,-5
9375,119,4688,L,102,111,-9
9376,120,4688,W,111,102,9
9377,594,4689,L,100,112,-12
9378,593,4689,W,112,100,12
9379,90,4690,L,87,91,-4
9380,89,4690,W,91,87,4
9381,176,4691,L,96,123,-27
9382,175,4691,W,123,96,27
9383,293,4692,W,104,98,6
9384,294,4692,L,98,104,-6
9385,172,4693,L,116,123,-7
9386,171,4693,W,123,116,7
9387,434,4694,L,109,115,-6
9388,433,4694,W,115,109,6
9389,488,4695,L,91,103,-12
9390,487,4695,W,103,91,12
9391,33,4696,W,119,113,6
9392,34,4696,L,113,119,-6
9393,646,4697,L,90,109,-19
9394,645,4697,W,109,90,19
9395,821,4698,L,99,119,-20
9396,822,4698,W,119,99,20
9397,554,4699,W,109,105,4
9398,553,4699,L,105,109,-4
9399,65,4700,W,90,88,2
9400,66,4700,L,88,90,-2
9401,533,4701,W,110,90,20
9402,534,4701,L,90,110,-20
9403,299,4702,W,117,112,5
9404,300,4702,L,112,117,-5
9405,694,4703,W,109,108,1
9406,693,4703,L,108,109,-1
9407,123,4704,L,107,115,-8
9408,124,4704,W,115,107,8
9409,547,4705,L,101,106,-5
9410,548,4705,W,106,101,5
9411,41,4706,W,109,102,7
9412,42,4706,L,102,109,-7
9413,121,4707,W,117,101,16
9414,122,4707,L,101,117,-16
9415,535,4708,L,95,106,-11
9416,536,4708,W,106,95,11
9417,764,4709,L,102,113,-11
9418,763,4709,W,113,102,11
9419,550,4710,W,98,86,12
9420,549,4710,L,86,98,-12
9421,627,4711,W,94,93,1
9422,628,4711,L,93,94,-1
9423,529,4712,W,125,111,14
9424,530,4712,L,111,125,-14
9425,6,4713,W,121,110,11
9426,5,4713,L,110,121,-11
9427,174,4714,W,96,95,1
9428,173,4714,L,95,96,-1
9429,544,4715,W,92,84,8
9430,543,4715,L,84,92,-8
9431,10,4716,W,107,97,10
9432,9,4716,L,97,107,-10
9433,170,4717,W,102,100,2
9434,169,4717,L,100,102,-2
9435,108,4718,L,111,118,-7
9436,107,4718,W,118,111,7
9437,24,4719,W,112,109,3
9438,23,4719,L,109,112,-3
9439,767,4720,W,108,93,15
9440,768,4720,L,93,108,-15
9441,142,4721,L,104,116,-12
9442,141,4721,W,116,104,12
9443,116,4722,W,136,130,6
9444,115,4722,L,130,136,-6
9445,607,4723,L,74,104,-30
9446,608,4723,W,104,74,30
9447,860,4724,L,113,117,-4
9448,859,4724,W,117,113,4
9449,763,4725,W,114,108,6
9450,764,4725,L,108,114,-6
9451,88,4726,L,102,119,-17
9452,87,4726,W,119,102,17
9453,316,4727,L,121,126,-5
9454,315,4727,W,126,121,5
9455,780,4728,L,108,115,-7
9456,779,4728,W,115,108,7
9457,599,4729,W,110,108,2
9458,600,4729,L,108,110,-2
9459,268,4730,L,107,117,-10
9460,267,4730,W,117,107,10
9461,670,4731,L,82,113,-31
9462,669,4731,W,113,82,31
9463,238,4732,L,105,107,-2
9464,237,4732,W,107,105,2
9465,481,4733,L,107,108,-1
9466,482,4733,W,108,107,1
9467,125,4734,W,105,95,10
9468,126,4734,L,95,105,-10
9469,783,4735,L,110,117,-7
9470,784,4735,W,117,110,7
9471,213,4736,W,109,79,30
9472,214,4736,L,79,109,-30
9473,222,4737,L,79,99,-20
9474,221,4737,W,99,79,20
9475,56,4738,L,100,113,-13
9476,55,4738,W,113,100,13
9477,216,4739,W,82,73,9
9478,215,4739,L,73,82,-9
9479,182,4740,L,101,114,-13
9480,181,4740,W,114,101,13
9481,791,4741,W,105,90,15
9482,792,4741,L,90,105,-15
9483,612,4742,L,90,135,-45
9484,611,4742,W,135,90,45
9485,288,4743,W,111,109,2
9486,287,4743,L,109,111,-2
9487,291,4744,W,107,99,8
9488,292,4744,L,99,107,-8
9489,755,4745,L,114,127,-13
9490,756,4745,W,127,114,13
9491,658,4746,L,108,119,-11
9492,657,4746,W,119,108,11
9493,616,4747,W,95,69,26
9494,615,4747,L,69,95,-26
9495,179,4748,L,111,118,-7
9496,180,4748,W,118,111,7
9497,724,4749,L,88,96,-8
9498,723,4749,W,96,88,8
9499,579,4750,W,125,121,4
9500,580,4750,L,121,125,-4
9501,542,4751,W,102,98,4
9502,541,4751,L,98,102,-4
9503,368,4752,W,100,89,11
9504,367,4752,L,89,100,-11
9505,407,4753,W,96,92,4
9506,408,4753,L,92,96,-4
9507,183,4754,L,100,103,-3
9508,184,4754,W,103,100,3
9509,561,4755,L,100,122,-22
9510,562,4755,W,122,100,22
9511,617,4756,L,108,122,-14
9512,618,4756,W,122,108,14
9513,615,4757,L,97,108,-11
9514,616,4757,W,108,97,11
9515,602,4758,W,107,92,15
9516,601,4758,L,92,107,-15
9517,771,4759,L,90,103,-13
9518,772,4759,W,103,90,13
9519,209,4760,L,120,132,-12
9520,210,4760,W,132,120,12
9521,522,4761,L,95,102,-7
9522,521,4761,W,102,95,7
9523,139,4762,L,89,95,-6
9524,140,4762,W,95,89,6
9525,39,4763,W,123,114,9
9526,40,4763,L,114,123,-9
9527,589,4764,W,113,108,5
9528,590,4764,L,108,113,-5
9529,631,4765,L,85,93,-8
9530,632,4765,W,93,85,8
9531,569,4766,L,106,109,-3
9532,570,4766,W,109,106,3
9533,770,4767,W,95,85,10
9534,769,4767,L,85,95,-10
9535,52,4768,L,89,109,-20
9536,51,4768,W,109,89,20
9537,286,4769,L,97,107,-10
9538,285,4769,W,107,97,10
9539,7,4770,L,98,132,-34
9540,8,4770,W,132,98,34
9541,682,4771,L,101,108,-7
9542,681,4771,W,108,101,7
9543,427,4772,W,131,120,11
9544,428,4772,L,120,131,-11
9545,630,4773,L,95,114,-19
9546,629,4773,W,114,95,19
9547,350,4774,W,99,94,5
9548,349,4774,L,94,99,-5
9549,450,4775,W,113,109,4
9550,449,4775,L,109,113,-4
9551,640,4776,L,111,113,-2
9552,639,4776,W,113,111,2
9553,632,4777,L,86,103,-17
9554,631,4777,W,103,86,17
9555,160,4778,L,92,116,-24
9556,159,4778,W,116,92,24
9557,267,4779,L,92,112,-20
9558,268,4779,W,112,92,20
9559,17,4780,L,120,121,-1
9560,18,4780,W,121,120,1
9561,308,4781,L,101,112,-11
9562,307,4781,W,112,101,11
9563,186,4782,L,100,122,-22
9564,185,4782,W,122,100,22
9565,733,4783,L,118,122,-4
9566,734,4783,W,122,118,4
9567,437,4784,L,94,110,-16
9568,438,4784,W,110,94,16
9569,713,4785,W,116,108,8
9570,714,4785,L,108,116,-8
9571,300,4786,L,96,99,-3
9572,299,4786,W,99,96,3
9573,266,4787,W,97,79,18
9574,265,4787,L,79,97,-18
9575,27,4788,W,120,119,1
9576,28,4788,L,119,120,-1
9577,610,4789,W,118,112,6
9578,609,4789,L,112,118,-6
9579,423,4790,L,111,118,-7
9580,424,4790,W,118,111,7
9581,788,4791,L,100,105,-5
9582,787,4791,W,105,100,5
9583,253,4792,L,105,133,-28
9584,254,4792,W,133,105,28
9585,627,4793,L,84,104,-20
9586,628,4793,W,104,84,20
9587,175,4794,L,105,110,-5
9588,176,4794,W,110,105,5
9589,103,4795,L,105,116,-11
9590,104,4795,W,116,105,11
9591,748,4796,W,121,113,8
9592,747,4796,L,113,121,-8
9593,663,4797,L,89,110,-21
9594,664,4797,W,110,89,21
9595,260,4798,L,87,109,-22
9596,259,4798,W,109,87,22
9597,328,4799,L,101,130,-29
9598,327,4799,W,130,101,29
9599,503,4800,W,119,115,4
9600,504,4800,L,115,119,-4
9601,111,4801,W,117,90,27
9602,112,4801,L,90,117,-27
9603,447,4802,L,84,114,-30
9604,448,4802,W,114,84,30
9605,736,4803,W,114,110,4
9606,735,4803,L,110,114,-4
9607,765,4804,W,103,100,3
9608,766,4804,L,100,103,-3
9609,311,4805,L,103,111,-8
9610,312,4805,W,111,103,8
9611,555,4806,L,88,109,-21
9612,556,4806,W,109,88,21
9613,134,4807,W,102,99,3
9614,133,4807,L,99,102,-3
9615,132,4808,W,101,94,7
9616,131,4808,L,94,101,-7
9617,768,4809,W,99,88,11
9618,767,4809,L,88,99,-11
9619,507,4810,L,110,124,-14
9620,508,4810,W,124,110,14
9621,608,4811,W,106,99,7
9622,607,4811,L,99,106,-7
9623,146,4812,L,86,88,-2
9624,145,4812,W,88,86,2
9625,583,4813,L,91,95,-4
9626,584,4813,W,95,91,4
9627,705,4814,L,85,92,-7
9628,706,4814,W,92,85,7
9629,196,4815,W,117,87,30
9630,195,4815,L,87,117,-30
9631,211,4816,W,109,94,15
9632,212,4816,L,94,109,-15
9633,479,4817,L,95,103,-8
9634,480,4817,W,103,95,8
9635,506,4818,L,77,87,-10
9636,505,4818,W,87,77,10
9637,30,4819,W,126,94,32
9638,29,4819,L,94,126,-32
9639,785,4820,L,111,116,-5
9640,786,4820,W,116,111,5
9641,130,4821,L,95,134,-39
9642,129,4821,W,134,95,39
9643,672,4822,L,107,115,-8
9644,671,4822,W,115,107,8
9645,222,4823,W,120,89,31
9646,221,4823,L,89,120,-31
9647,276,4824,W,115,98,17
9648,275,4824,L,98,115,-17
9649,1,4825,L,105,112,-7
9650,2,4825,W,112,105,7
9651,532,4826,L,91,96,-5
9652,531,4826,W,96,91,5
9653,57,4827,W,124,116,8
9654,58,4827,L,116,124,-8
9655,669,4828,L,91,102,-11
9656,670,4828,W,102,91,11
9657,666,4829,W,114,103,11
9658,665,4829,L,103,114,-11
9659,818,4830,W,105,91,14
9660,817,4830,L,91,105,-14
9661,600,4831,W,102,99,3
9662,599,4831,L,99,102,-3
9663,230,4832,W,107,101,6
9664,229,4832,L,101,107,-6
9665,595,4833,L,106,142,-36
9666,596,4833,W,142,106,36
9667,233,4834,W,110,108,2
9668,234,4834,L,108,110,-2
9669,19,4835,W,109,101,8
9670,20,4835,L,101,109,-8
9671,816,4836,W,112,110,2
9672,815,4836,L,110,112,-2
9673,777,4837,W,106,98,8
9674,778,4837,L,98,106,-8
9675,696,4838,W,97,96,1
9676,695,4838,L,96,97,-1
9677,572,4839,W,116,112,4
9678,571,4839,L,112,116,-4
9679,406,4840,L,106,107,-1
9680,405,4840,W,107,106,1
9681,243,4841,W,118,113,5
9682,244,4841,L,113,118,-5
9683,766,4842,L,98,106,-8
9684,765,4842,W,106,98,8
9685,782,4843,W,111,102,9
9686,781,4843,L,102,111,-9
9687,5,4844,L,92,101,-9
9688,6,4844,W,101,92,9
9689,492,4845,W,98,92,6
9690,491,4845,L,92,98,-6
9691,136,4846,L,98,105,-7
9692,135,4846,W,105,98,7
9693,227,4847,L,103,112,-9
9694,228,4847,W,112,103,9
9695,579,4848,L,84,128,-44
9696,580,4848,W,128,84,44
9697,402,4849,L,109,138,-29
9698,401,4849,W,138,109,29
9699,403,4850,L,100,103,-3
9700,404,4850,W,103,100,3
9701,143,4851,W,107,106,1
9702,144,4851,L,106,107,-1
9703,380,4852,L,82,107,-25
9704,379,4852,W,107,82,25
9705,511,4853,L,92,99,-7
9706,512,4853,W,99,92,7
9707,496,4854,W,125,120,5
9708,495,4854,L,120,125,-5
9709,868,4855,L,114,118,-4
9710,867,4855,W,118,114,4
9711,43,4856,W,121,85,36
9712,44,4856,L,85,121,-36
9713,254,4857,W,114,96,18
9714,253,4857,L,96,114,-18
9715,836,4858,L,105,107,-2
9716,835,4858,W,107,105,2
9717,49,4859,W,128,110,18
9718,50,4859,L,110,128,-18
9719,4,4860,W,105,88,17
9720,3,4860,L,88,105,-17
9721,251,4861,L,80,113,-33
9722,252,4861,W,113,80,33
9723,273,4862,L,105,111,-6
9724,274,4862,W,111,105,6
9725,825,4863,L,92,97,-5
9726,826,4863,W,97,92,5
9727,281,4864,L,94,95,-1
9728,282,4864,W,95,94,1
9729,20,4865,L,87,97,-10
9730,19,4865,W,97,87,10
9731,517,4866,W,113,94,19
9732,518,4866,L,94,113,-19
9733,228,4867,W,111,93,18
9734,227,4867,L,93,111,-18
9735,483,4868,W,132,127,5
9736,484,4868,L,127,132,-5
9737,497,4869,W,111,110,1
9738,498,4869,L,110,111,-1
9739,424,4870,L,109,131,-22
9740,423,4870,W,131,109,22
9741,650,4871,L,107,109,-2
9742,649,4871,W,109,107,2
9743,867,4872,W,106,104,2
9744,868,4872,L,104,106,-2
9745,851,4873,W,96,90,6
9746,852,4873,L,90,96,-6
9747,278,4874,W,94,87,7
9748,277,4874,L,87,94,-7
9749,187,4875,L,115,126,-11
9750,188,4875,W,126,115,11
9751,189,4876,L,105,120,-15
9752,190,4876,W,120,105,15
9753,641,4877,W,121,114,7
9754,642,4877,L,114,121,-7
9755,255,4878,W,106,98,8
9756,256,4878,L,98,106,-8
9757,506,4879,W,112,89,23
9758,505,4879,L,89,112,-23
9759,383,4880,L,88,105,-17
9760,384,4880,W,105,88,17
9761,393,4881,W,95,83,12
9762,394,4881,L,83,95,-12
9763,763,4882,L,101,118,-17
9764,764,4882,W,118,101,17
9765,194,4883,L,122,127,-5
9766,193,4883,W,127,122,5
9767,461,4884,L,101,120,-19
9768,462,4884,W,120,101,19
9769,727,4885,W,104,85,19
9770,728,4885,L,85,104,-19
9771,362,4886,L,95,101,-6
9772,361,4886,W,101,95,6
9773,125,4887,W,112,104,8
9774,126,4887,L,104,112,-8
9775,80,4888,W,112,103,9
9776,79,4888,L,103,112,-9
9777,329,4889,W,112,103,9
9778,330,4889,L,103,112,-9
9779,808,4890,L,100,105,-5
9780,807,4890,W,105,100,5
9781,40,4891,L,95,122,-27
9782,39,4891,W,122,95,27
9783,758,4892,L,94,109,-15
9784,757,4892,W,109,94,15
9785,357,4893,L,81,91,-10
9786,358,4893,W,91,81,10
9787,73,4894,W,130,114,16
9788,74,4894,L,114,130,-16
9789,138,4895,W,104,96,8
9790,137,4895,L,96,104,-8
9791,781,4896,L,70,91,-21
9792,782,4896,W,91,70,21
9793,205,4897,W,122,105,17
9794,206,4897,L,105,122,-17
9795,70,4898,W,112,108,4
9796,69,4898,L,108,112,-4
9797,519,4899,W,120,114,6
9798,520,4899,L,114,120,-6
9799,714,4900,L,102,115,-13
9800,713,4900,W,115,102,13
9801,754,4901,W,110,107,3
9802,753,4901,L,107,110,-3
9803,356,4902,L,88,106,-18
9804,355,4902,W,106,88,18
9805,429,4903,L,102,107,-5
9806,430,4903,W,107,102,5
9807,835,4904,W,112,100,12
9808,836,4904,L,100,112,-12
9809,744,4905,L,68,95,-27
9810,743,4905,W,95,68,27
9811,681,4906,W,109,103,6
9812,682,4906,L,103,109,-6
9813,834,4907,L,90,128,-38
9814,833,4907,W,128,90,38
9815,185,4908,W,105,99,6
9816,186,4908,L,99,105,-6
9817,513,4909,W,105,89,16
9818,514,4909,L,89,105,-16
9819,475,4910,L,104,119,-15
9820,476,4910,W,119,104,15
9821,501,4911,L,97,118,-21
9822,502,4911,W,118,97,21
9823,779,4912,W,98,85,13
9824,780,4912,L,85,98,-13
9825,422,4913,W,109,85,24
9826,421,4913,L,85,109,-24
9827,430,4914,L,111,113,-2
9828,429,4914,W,113,111,2
9829,753,4915,W,90,81,9
9830,754,4915,L,81,90,-9
9831,240,4916,W,132,129,3
9832,239,4916,L,129,132,-3
9833,8,4917,W,117,104,13
9834,7,4917,L,104,117,-13
9835,716,4918,L,97,108,-11
9836,715,4918,W,108,97,11
9837,58,4919,W,94,91,3
9838,57,4919,L,91,94,-3
9839,708,4920,W,96,85,11
9840,707,4920,L,85,96,-11
9841,531,4921,W,104,99,5
9842,532,4921,L,99,104,-5
9843,136,4922,L,83,108,-25
9844,135,4922,W,108,83,25
9845,66,4923,W,124,104,20
9846,65,4923,L,104,124,-20
9847,678,4924,W,92,87,5
9848,677,4924,L,87,92,-5
9849,831,4925,L,125,137,-12
9850,832,4925,W,137,125,12
9851,421,4926,L,106,149,-43
9852,422,4926,W,149,106,43
9853,92,4927,W,111,92,19
9854,91,4927,L,92,111,-19
9855,304,4928,L,96,117,-21
9856,303,4928,W,117,96,21
9857,842,4929,L,84,107,-23
9858,841,4929,W,107,84,23
9859,426,4930,L,101,116,-15
9860,425,4930,W,116,101,15
9861,365,4931,W,119,114,5
9862,366,4931,L,114,119,-5
9863,798,4932,W,115,102,13
9864,797,4932,L,102,115,-13
9865,719,4933,L,103,107,-4
9866,720,4933,W,107,103,4
9867,869,4934,L,107,110,-3
9868,870,4934,W,110,107,3
9869,217,4935,L,109,111,-2
9870,218,4935,W,111,109,2
9871,866,4936,W,112,94,18
9872,865,4936,L,94,112,-18
9873,596,4937,W,120,83,37
9874,595,4937,L,83,120,-37
9875,558,4938,L,94,101,-7
9876,557,4938,W,101,94,7
9877,728,4939,W,105,90,15
9878,727,4939,L,90,105,-15
9879,277,4940,L,91,96,-5
9880,278,4940,W,96,91,5
9881,776,4941,L,115,123,-8
9882,775,4941,W,123,115,8
9883,477,4942,W,99,93,6
9884,478,4942,L,93,99,-6
9885,137,4943,L,89,93,-4
9886,138,4943,W,93,89,4
9887,257,4944,L,101,106,-5
9888,258,4944,W,106,101,5
9889,760,4945,W,99,96,3
9890,759,4945,L,96,99,-3
9891,801,4946,W,115,111,4
9892,802,4946,L,111,115,-4
9893,305,4947,L,99,102,-3
9894,306,4947,W,102,99,3
9895,852,4948,W,118,110,8
9896,851,4948,L,110,118,-8
9897,163,4949,W,129,109,20
9898,164,4949,L,109,129,-20
9899,135,4950,L,91,105,-14
9900,136,4950,W,105,91,14
9901,272,4951,L,94,104,-10
9902,271,4951,W,104,94,10
9903,95,4952,W,124,121,3
9904,96,4952,L,121,124,-3
9905,307,4953,W,114,111,3
9906,308,4953,L,111,114,-3
9907,642,4954,W,94,92,2
9908,641,4954,L,92,94,-2
9909,473,4955,L,87,95,-8
9910,474,4955,W,95,87,8
9911,762,4956,L,95,102,-7
9912,761,4956,W,102,95,7
9913,685,4957,L,71,93,-22
9914,686,4957,W,93,71,22
9915,848,4958,L,116,121,-5
9916,847,4958,W,121,116,5
9917,171,4959,L,105,120,-15
9918,172,4959,W,120,105,15
9919,462,4960,L,102,111,-9
9920,461,4960,W,111,102,9
9921,567,4961,W,104,88,16
9922,568,4961,L,88,104,-16
9923,333,4962,W,80,64,16
9924,334,4962,L,64,80,-16
9925,476,4963,L,101,113,-12
9926,475,4963,W,113,101,12
9927,72,4964,L,81,104,-23
9928,71,4964,W,104,81,23
9929,212,4965,W,116,96,20
9930,211,4965,L,96,116,-20
9931,470,4966,W,121,115,6
9932,469,4966,L,115,121,-6
9933,16,4967,W,116,107,9
9934,15,4967,L,107,116,-9
9935,150,4968,W,113,111,2
9936,149,4968,L,111,113,-2
9937,292,4969,L,96,100,-4
9938,291,4969,W,100,96,4
9939,688,4970,L,105,124,-19
9940,687,4970,W,124,105,19
9941,712,4971,W,85,77,8
9942,711,4971,L,77,85,-8
9943,74,4972,L,109,126,-17
9944,73,4972,W,126,109,17
9945,854,4973,L,86,110,-24
9946,853,4973,W,110,86,24
9947,279,4974,L,112,119,-7
9948,280,4974,W,119,112,7
9949,25,4975,L,73,96,-23
9950,26,4975,W,96,73,23
9951,262,4976,W,110,105,5
9952,261,4976,L,105,110,-5
9953,746,4977,L,83,90,-7
9954,745,4977,W,90,83,7
9955,11,4978,L,93,103,-10
9956,12,4978,W,103,93,10
9957,105,4979,L,102,109,-7
9958,106,4979,W,109,102,7
9959,443,4980,W,111,107,4
9960,444,4980,L,107,111,-4
9961,295,4981,L,102,105,-3
9962,296,4981,W,105,102,3
9963,153,4982,L,82,89,-7
9964,154,4982,W,89,82,7
9965,735,4983,L,100,107,-7
9966,736,4983,W,107,100,7
9967,520,4984,L,104,120,-16
9968,519,4984,W,120,104,16
9969,344,4985,W,127,121,6
9970,343,4985,L,121,127,-6
9971,134,4986,L,103,105,-2
9972,133,4986,W,105,103,2
9973,571,4987,L,117,121,-4
9974,572,4987,W,121,117,4
9975,480,4988,W,93,90,3
9976,479,4988,L,90,93,-3
9977,815,4989,W,113,88,25
9978,816,4989,L,88,113,-25
9979,285,4990,L,118,125,-7
9980,286,4990,W,125,118,7
9981,495,4991,W,115,108,7
9982,496,4991,L,108,115,-7
9983,193,4992,L,95,127,-32
9984,194,4992,W,127,95,32
9985,215,4993,W,102,96,6
9986,216,4993,L,96,102,-6
9987,619,4994,L,90,94,-4
9988,620,4994,W,94,90,4
9989,225,4995,L,69,88,-19
9990,226,4995,W,88,69,19
9991,587,4996,L,105,106,-1
9992,588,4996,W,106,105,1
9993,839,4997,L,77,93,-16
9994,840,4997,W,93,77,16
9995,355,4998,L,88,104,-16
9996,356,4998,W,104,88,16
9997,151,4999,L,88,115,-27
9998,152,4999,W,115,88,27
9999,210,5000,L,105,112,-7
10000,209,5000,W,112,105,7
10001,35,5001,W,119,117,2
10002,36,5001,L,117,119,-2
10003,64,5002,L,99,125,-26
10004,63,5002,W,125,99,26
10005,103,5003,L,93,100,-7
10006,104,5003,W,100,93,7
10007,402,5004,L,120,133,-13
10008,401,5004,W,133,120,13
10009,446,5005,L,96,117,-21
10010,445,5005,W,117,96,21
10011,498,5006,W,102,91,11
10012,497,5006,L,91,102,-11
10013,38,5007,W,119,105,14
10014,37,5007,L,105,119,-14
10015,439,5008,W,106,95,11
10016,440,5008,L,95,106,-11
10017,383,5009,W,126,99,27
10018,384,5009,L,99,126,-27
10019,170,5010,W,106,100,6
10020,169,5010,L,100,106,-6
10021,13,5011,L,107,118,-11
10022,14,5011,W,118,107,11
10023,552,5012,W,122,104,18
10024,551,5012,L,104,122,-18
10025,162,5013,L,96,106,-10
10026,161,5013,W,106,96,10
10027,10,5014,L,95,106,-11
10028,9,5014,W,106,95,11
10029,41,5015,W,105,99,6
10030,42,5015,L,99,105,-6
10031,416,5016,W,113,111,2
10032,415,5016,L,111,113,-2
10033,250,5017,L,105,109,-4
10034,249,5017,W,109,105,4
10035,703,5018,W,87,74,13
10036,704,5018,L,74,87,-13
10037,812,5019,L,87,115,-28
10038,811,5019,W,115,87,28
10039,731,5020,L,86,96,-10
10040,732,5020,W,96,86,10
10041,315,5021,L,120,122,-2
10042,316,5021,W,122,120,2
10043,471,5022,W,105,94,11
10044,472,5022,L,94,105,-11
10045,148,5023,W,110,108,2
10046,147,5023,L,108,110,-2
10047,369,5024,W,125,101,24
10048,370,5024,L,101,125,-24
10049,546,5025,W,112,106,6
10050,545,5025,L,106,112,-6
10051,787,5026,W,98,95,3
10052,788,5026,L,95,98,-3
10053,160,5027,W,101,91,10
10054,159,5027,L,91,101,-10
10055,17,5028,L,80,111,-31
10056,18,5028,W,111,80,31
10057,249,5029,L,115,122,-7
10058,250,5029,W,122,115,7
10059,674,5030,L,98,104,-6
10060,673,5030,W,104,98,6
10061,651,5031,L,95,116,-21
10062,652,5031,W,116,95,21
10063,413,5032,L,100,107,-7
10064,414,5032,W,107,100,7
10065,643,5033,W,112,102,10
10066,644,5033,L,102,112,-10
10067,156,5034,L,93,118,-25
10068,155,5034,W,118,93,25
10069,102,5035,L,107,115,-8
10070,101,5035,W,115,107,8
10071,169,5036,W,101,99,2
10072,170,5036,L,99,101,-2
10073,591,5037,L,96,110,-14
10074,592,5037,W,110,96,14
10075,332,5038,W,123,107,16
10076,331,5038,L,107,123,-16
10077,283,5039,L,121,124,-3
10078,284,5039,W,124,121,3
10079,177,5040,L,94,102,-8
10080,178,5040,W,102,94,8
10081,577,5041,L,107,108,-1
10082,578,5041,W,108,107,1
10083,493,5042,W,110,106,4
10084,494,5042,L,106,110,-4
10085,93,5043,W,109,97,12
10086,94,5043,L,97,109,-12
10087,726,5044,L,110,119,-9
10088,725,5044,W,119,110,9
10089,167,5045,L,85,97,-12
10090,168,5045,W,97,85,12
10091,805,5046,W,109,84,25
10092,806,5046,L,84,109,-25
10093,738,5047,L,80,112,-32
10094,737,5047,W,112,80,32
10095,438,5048,L,100,122,-22
10096,437,5048,W,122,100,22
10097,855,5049,W,114,106,8
10098,856,5049,L,106,114,-8
10099,449,5050,L,106,116,-10
10100,450,5050,W,116,106,10
10101,715,5051,L,82,114,-32
10102,716,5051,W,114,82,32
10103,306,5052,W,96,91,5
10104,305,5052,L,91,96,-5
10105,347,5053,W,114,109,5
10106,348,5053,L,109,114,-5
10107,146,5054,W,100,94,6
10108,145,5054,L,94,100,-6
10109,197,5055,L,75,86,-11
10110,198,5055,W,86,75,11
10111,793,5056,W,123,107,16
10112,794,5056,L,107,123,-16
10113,503,5057,L,108,119,-11
10114,504,5057,W,119,108,11
10115,70,5058,W,102,101,1
10116,69,5058,L,101,102,-1
10117,58,5059,L,86,88,-2
10118,57,5059,W,88,86,2
10119,509,5060,L,91,117,-26
10120,510,5060,W,117,91,26
10121,548,5061,W,116,92,24
10122,547,5061,L,92,116,-24
10123,594,5062,L,92,112,-20
10124,593,5062,W,112,92,20
10125,683,5063,L,97,112,-15
10126,684,5063,W,112,97,15
10127,440,5064,L,86,103,-17
10128,439,5064,W,103,86,17
10129,76,5065,L,94,111,-17
10130,75,5065,W,111,94,17
10131,173,5066,W,105,95,10
10132,174,5066,L,95,105,-10
10133,28,5067,W,112,111,1
10134,27,5067,L,111,112,-1
10135,232,5068,L,87,96,-9
10136,231,5068,W,96,87,9
10137,444,5069,W,99,88,11
10138,443,5069,L,88,99,-11
10139,422,5070,L,97,117,-20
10140,421,5070,W,117,97,20
10141,400,5071,W,117,104,13
10142,399,5071,L,104,117,-13
10143,60,5072,W,99,95,4
10144,59,5072,L,95,99,-4
10145,325,5073,L,92,95,-3
10146,326,5073,W,95,92,3
10147,157,5074,W,100,86,14
10148,158,5074,L,86,100,-14
10149,827,5075,L,96,122,-26
10150,828,5075,W,122,96,26
10151,353,5076,L,122,128,-6
10152,354,5076,W,128,122,6
10153,359,5077,L,107,125,-18
10154,360,5077,W,125,107,18
10155,460,5078,W,102,99,3
10156,459,5078,L,99,102,-3
10157,245,5079,L,94,102,-8
10158,246,5079,W,102,94,8
10159,638,5080,W,113,103,10
10160,637,5080,L,103,113,-10
10161,147,5081,W,85,83,2
10162,148,5081,L,83,85,-2
10163,371,5082,W,118,99,19
10164,372,5082,L,99,118,-19
10165,234,5083,L,83,89,-6
10166,233,5083,W,89,83,6
10167,284,5084,L,115,118,-3
10168,283,5084,W,118,115,3
10169,183,5085,L,81,97,-16
10170,184,5085,W,97,81,16
10171,844,5086,L,93,109,-16
10172,843,5086,W,109,93,16
10173,653,5087,L,100,107,-7
10174,654,5087,W,107,100,7
10175,575,5088,L,101,109,-8
10176,576,5088,W,109,101,8
10177,757,5089,W,123,116,7
10178,758,5089,L,116,123,-7
10179,686,5090,L,80,116,-36
10180,685,5090,W,116,80,36
10181,611,5091,W,127,104,23
10182,612,5091,L,104,127,-23
10183,158,5092,W,106,91,15
10184,157,5092,L,91,106,-15
10185,528,5093,L,96,108,-12
10186,527,5093,W,108,96,12
10187,773,5094,L,120,128,-8
10188,774,5094,W,128,120,8
10189,296,5095,L,89,102,-13
10190,295,5095,W,102,89,13
10191,4,5096,W,103,101,2
10192,3,5096,L,101,103,-2
10193,545,5097,W,117,113,4
10194,546,5097,L,113,117,-4
10195,199,5098,L,108,115,-7
10196,200,5098,W,115,108,7
10197,149,5099,L,102,105,-3
10198,150,5099,W,105,102,3
10199,297,5100,W,118,88,30
10200,298,5100,L,88,118,-30
10201,849,5101,L,95,106,-11
10202,850,5101,W,106,95,11
10203,223,5102,L,98,116,-18
10204,224,5102,W,116,98,18
10205,401,5103,W,106,100,6
10206,402,5103,L,100,106,-6
10207,620,5104,W,106,99,7
10208,619,5104,L,99,106,-7
10209,485,5105,L,83,98,-15
10210,486,5105,W,98,83,15
10211,260,5106,L,92,93,-1
10212,259,5106,W,93,92,1
10213,516,5107,L,103,112,-9
10214,515,5107,W,112,103,9
10215,218,5108,L,96,113,-17
10216,217,5108,W,113,96,17
10217,729,5109,L,75,88,-13
10218,730,5109,W,88,75,13
10219,209,5110,W,115,113,2
10220,210,5110,L,113,115,-2
10221,445,5111,W,104,72,32
10222,446,5111,L,72,104,-32
10223,553,5112,L,103,106,-3
10224,554,5112,W,106,103,3
10225,75,5113,L,101,118,-17
10226,76,5113,W,118,101,17
10227,795,5114,L,99,105,-6
10228,796,5114,W,105,99,6
10229,573,5115,L,104,111,-7
10230,574,5115,W,111,104,7
10231,227,5116,L,108,110,-2
10232,228,5116,W,110,108,2
10233,56,5117,L,79,98,-19
10234,55,5117,W,98,79,19
10235,723,5118,W,104,98,6
10236,724,5118,L,98,104,-6
10237,269,5119,W,97,91,6
10238,270,5119,L,91,97,-6
10239,259,5120,W,106,98,8
10240,260,5120,L,98,106,-8
10241,229,5121,L,89,96,-7
10242,230,5121,W,96,89,7
10243,572,5122,W,94,91,3
10244,571,5122,L,91,94,-3
10245,450,5123,W,122,114,8
10246,449,5123,L,114,122,-8
10247,502,5124,L,94,103,-9
10248,501,5124,W,103,94,9
10249,182,5125,L,110,113,-3
10250,181,5125,W,113,110,3
10251,492,5126,L,82,108,-26
10252,491,5126,W,108,82,26
10253,18,5127,W,114,106,8
10254,17,5127,L,106,114,-8
10255,262,5128,W,102,94,8
10256,261,5128,L,94,102,-8
10257,654,5129,L,99,105,-6
10258,653,5129,W,105,99,6
10259,326,5130,L,99,114,-15
10260,325,5130,W,114,99,15
10261,388,5131,W,107,96,11
10262,387,5131,L,96,107,-11
10263,603,5132,W,107,102,5
10264,604,5132,L,102,107,-5
10265,115,5133,W,108,96,12
10266,116,5133,L,96,108,-12
10267,691,5134,W,103,97,6
10268,692,5134,L,97,103,-6
10269,685,5135,L,98,102,-4
10270,686,5135,W,102,98,4
10271,566,5136,L,91,109,-18
10272,565,5136,W,109,91,18
10273,312,5137,L,121,130,-9
10274,311,5137,W,130,121,9
10275,91,5138,L,117,122,-5
10276,92,5138,W,122,117,5
10277,129,5139,L,114,120,-6
10278,130,5139,W,120,114,6
10279,54,5140,W,113,94,19
10280,53,5140,L,94,113,-19
10281,97,5141,L,104,113,-9
10282,98,5141,W,113,104,9
10283,29,5142,L,88,117,-29
10284,30,5142,W,117,88,29
10285,722,5143,W,129,100,29
10286,721,5143,L,100,129,-29
10287,564,5144,W,93,89,4
10288,563,5144,L,89,93,-4
10289,563,5145,L,101,115,-14
10290,564,5145,W,115,101,14
10291,564,5146,W,112,97,15
10292,563,5146,L,97,112,-15
10293,563,5147,W,108,97,11
10294,564,5147,L,97,108,-11
10295,563,5148,L,90,120,-30
10296,564,5148,W,120,90,30
10297,564,5149,L,77,110,-33
10298,563,5149,W,110,77,33
10299,564,5150,L,89,104,-15
10300,563,5150,W,104,89,15
10301,827,5151,L,88,96,-8
10302,828,5151,W,96,88,8
10303,828,5152,W,108,101,7
10304,827,5152,L,101,108,-7
10305,572,5153,W,113,87,26
10306,571,5153,L,87,113,-26
10307,827,5154,L,111,120,-9
10308,828,5154,W,120,111,9
10309,571,5155,L,78,116,-38
10310,572,5155,W,116,78,38
10311,828,5156,L,94,118,-24
10312,827,5156,W,118,94,24
10313,572,5157,L,99,105,-6
10314,571,5157,W,105,99,6
10315,828,5158,L,105,133,-28
10316,827,5158,W,133,105,28
10317,572,5159,L,84,99,-15
10318,571,5159,W,99,84,15
10319,571,5160,L,89,108,-19
10320,572,5160,W,108,89,19
10321,827,5161,L,91,118,-27
10322,828,5161,W,118,91,27
10323,571,5162,L,84,115,-31
10324,572,5162,W,115,84,31
10325,827,5163,W,108,102,6
10326,828,5163,L,102,108,-6
10327,232,5164,L,89,116,-27
10328,231,5164,W,116,89,27
10329,231,5165,L,91,103,-12
10330,232,5165,W,103,91,12
10331,457,5166,L,99,113,-14
10332,458,5166,W,113,99,14
10333,612,5167,L,121,125,-4
10334,611,5167,W,125,121,4
10335,232,5168,L,91,99,-8
10336,231,5168,W,99,91,8
10337,458,5169,W,95,91,4
10338,457,5169,L,91,95,-4
10339,611,5170,W,132,125,7
10340,612,5170,L,125,132,-7
10341,231,5171,L,87,94,-7
10342,232,5171,W,94,87,7
10343,494,5172,W,100,99,1
10344,493,5172,L,99,100,-1
10345,457,5173,L,97,111,-14
10346,458,5173,W,111,97,14
10347,611,5174,L,108,120,-12
10348,612,5174,W,120,108,12
10349,231,5175,W,95,91,4
10350,232,5175,L,91,95,-4
10351,457,5176,W,100,96,4
10352,458,5176,L,96,100,-4
10353,494,5177,W,121,108,13
10354,493,5177,L,108,121,-13
10355,232,5178,L,92,96,-4
10356,231,5178,W,96,92,4
10357,493,5179,L,98,123,-25
10358,494,5179,W,123,98,25
10359,612,5180,L,99,110,-11
10360,611,5180,W,110,99,11
10361,232,5181,W,102,96,6
10362,231,5181,L,96,102,-6
10363,458,5182,W,98,97,1
10364,457,5182,L,97,98,-1
10365,493,5183,L,93,104,-11
10366,494,5183,W,104,93,11
10367,453,5184,L,84,89,-5
10368,454,5184,W,89,84,5
10369,269,5185,L,73,106,-33
10370,270,5185,W,106,73,33
10371,612,5186,L,106,118,-12
10372,611,5186,W,118,106,12
10373,458,5187,L,92,124,-32
10374,457,5187,W,124,92,32
10375,454,5188,L,83,101,-18
10376,453,5188,W,101,83,18
10377,270,5189,W,97,90,7
10378,269,5189,L,90,97,-7
10379,18,5190,L,103,106,-3
10380,17,5190,W,106,103,3
10381,523,5191,W,104,92,12
10382,524,5191,L,92,104,-12
10383,17,5192,W,108,98,10
10384,18,5192,L,98,108,-10
10385,483,5193,L,81,114,-33
10386,484,5193,W,114,81,33
10387,269,5194,W,90,88,2
10388,270,5194,L,88,90,-2
10389,453,5195,L,99,102,-3
10390,454,5195,W,102,99,3
10391,524,5196,L,83,110,-27
10392,523,5196,W,110,83,27
10393,581,5197,L,104,118,-14
10394,582,5197,W,118,104,14
10395,270,5198,L,85,89,-4
10396,269,5198,W,89,85,4
10397,18,5199,L,84,98,-14
10398,17,5199,W,98,84,14
10399,109,5200,W,116,95,21
10400,110,5200,L,95,116,-21
10401,71,5201,W,100,98,2
10402,72,5201,L,98,100,-2
10403,523,5202,L,95,104,-9
10404,524,5202,W,104,95,9
10405,484,5203,W,121,94,27
10406,483,5203,L,94,121,-27
10407,18,5204,L,88,96,-8
10408,17,5204,W,96,88,8
10409,270,5205,L,80,96,-16
10410,269,5205,W,96,80,16
10411,582,5206,W,119,108,11
10412,581,5206,L,108,119,-11
10413,454,5207,L,83,100,-17
10414,453,5207,W,100,83,17
10415,71,5208,W,101,91,10
10416,72,5208,L,91,101,-10
10417,109,5209,W,96,87,9
10418,110,5209,L,87,96,-9
10419,523,5210,L,103,111,-8
10420,524,5210,W,111,103,8
10421,454,5211,W,101,85,16
10422,453,5211,L,85,101,-16
10423,484,5212,L,96,97,-1
10424,483,5212,W,97,96,1
10425,582,5213,W,131,102,29
10426,581,5213,L,102,131,-29
10427,269,5214,L,103,115,-12
10428,270,5214,W,115,103,12
10429,17,5215,L,81,102,-21
10430,18,5215,W,102,81,21
10431,72,5216,L,90,107,-17
10432,71,5216,W,107,90,17
10433,524,5217,L,72,89,-17
10434,523,5217,W,89,72,17
10435,110,5218,L,68,94,-26
10436,109,5218,W,94,68,26
10437,581,5219,W,85,84,1
10438,582,5219,L,84,85,-1
10439,453,5220,L,87,98,-11
10440,454,5220,W,98,87,11
10441,483,5221,L,106,115,-9
10442,484,5221,W,115,106,9
10443,17,5222,L,95,115,-20
10444,18,5222,W,115,95,20
10445,72,5223,L,101,106,-5
10446,71,5223,W,106,101,5
10447,110,5224,L,74,106,-32
10448,109,5224,W,106,74,32
10449,269,5225,L,91,123,-32
10450,270,5225,W,123,91,32
10451,483,5226,L,78,104,-26
10452,484,5226,W,104,78,26
10453,524,5227,L,101,102,-1
10454,523,5227,W,102,101,1
10455,581,5228,L,70,108,-38
10456,582,5228,W,108,70,38
10457,453,5229,W,100,90,10
10458,454,5229,L,90,100,-10
10459,359,5230,W,97,92,5
10460,360,5230,L,92,97,-5
10461,303,5231,L,109,144,-35
10462,304,5231,W,144,109,35
10463,7,5232,L,81,116,-35
10464,8,5232,W,116,81,35
10465,230,5233,L,96,101,-5
10466,229,5233,W,101,96,5
10467,126,5234,L,88,98,-10
10468,125,5234,W,98,88,10
10469,555,5235,L,103,117,-14
10470,556,5235,W,117,103,14
10471,141,5236,W,103,96,7
10472,142,5236,L,96,103,-7
10473,210,5237,L,99,107,-8
10474,209,5237,W,107,99,8
10475,325,5238,L,98,109,-11
10476,326,5238,W,109,98,11
10477,514,5239,L,105,115,-10
10478,513,5239,W,115,105,10
10479,664,5240,L,104,125,-21
10480,663,5240,W,125,104,21
10481,72,5241,W,112,110,2
10482,71,5241,L,110,112,-2
10483,224,5242,L,105,114,-9
10484,223,5242,W,114,105,9
10485,278,5243,W,96,91,5
10486,277,5243,L,91,96,-5
10487,458,5244,L,98,102,-4
10488,457,5244,W,102,98,4
10489,40,5245,L,98,122,-24
10490,39,5245,W,122,98,24
10491,107,5246,L,90,102,-12
10492,108,5246,W,102,90,12
10493,443,5247,L,84,110,-26
10494,444,5247,W,110,84,26
10495,842,5248,W,99,93,6
10496,841,5248,L,93,99,-6
10497,243,5249,W,120,111,9
10498,244,5249,L,111,120,-9
10499,183,5250,W,101,92,9
10500,184,5250,L,92,101,-9
10501,724,5251,W,114,100,14
10502,723,5251,L,100,114,-14
10503,538,5252,W,121,116,5
10504,537,5252,L,116,121,-5
10505,138,5253,L,98,107,-9
10506,137,5253,W,107,98,9
10507,218,5254,L,79,112,-33
10508,217,5254,W,112,79,33
10509,493,5255,L,94,109,-15
10510,494,5255,W,109,94,15
10511,54,5256,W,105,101,4
10512,53,5256,L,101,105,-4
10513,288,5257,W,129,105,24
10514,287,5257,L,105,129,-24
10515,130,5258,L,110,130,-20
10516,129,5258,W,130,110,20
10517,501,5259,L,105,129,-24
10518,502,5259,W,129,105,24
10519,721,5260,W,92,86,6
10520,722,5260,L,86,92,-6
10521,569,5261,L,98,113,-15
10522,570,5261,W,113,98,15
10523,14,5262,W,93,89,4
10524,13,5262,L,89,93,-4
10525,466,5263,W,109,108,1
10526,465,5263,L,108,109,-1
10527,116,5264,L,96,118,-22
10528,115,5264,W,118,96,22
10529,135,5265,W,100,84,16
10530,136,5265,L,84,100,-16
10531,65,5266,L,91,98,-7
10532,66,5266,W,98,91,7
10533,524,5267,L,107,118,-11
10534,523,5267,W,118,107,11
10535,680,5268,W,106,105,1
10536,679,5268,L,105,106,-1
10537,663,5269,W,100,99,1
10538,664,5269,L,99,100,-1
10539,28,5270,W,121,100,21
10540,27,5270,L,100,121,-21
10541,426,5271,L,112,114,-2
10542,425,5271,W,114,112,2
10543,273,5272,L,102,105,-3
10544,274,5272,W,105,102,3
10545,59,5273,L,99,113,-14
10546,60,5273,W,113,99,14
10547,99,5274,L,109,124,-15
10548,100,5274,W,124,109,15
10549,84,5275,W,109,102,7
10550,83,5275,L,102,109,-7
10551,333,5276,L,93,103,-10
10552,334,5276,W,103,93,10
10553,618,5277,L,99,112,-13
10554,617,5277,W,112,99,13
10555,383,5278,L,102,110,-8
10556,384,5278,W,110,102,8
10557,115,5279,L,109,112,-3
10558,116,5279,W,112,109,3
10559,730,5280,W,102,99,3
10560,729,5280,L,99,102,-3
10561,453,5281,L,98,111,-13
10562,454,5281,W,111,98,13
10563,220,5282,L,98,102,-4
10564,219,5282,W,102,98,4
10565,580,5283,L,87,95,-8
10566,579,5283,W,95,87,8
10567,722,5284,L,101,112,-11
10568,721,5284,W,112,101,11
10569,530,5285,W,124,115,9
10570,529,5285,L,115,124,-9
10571,787,5286,L,98,106,-8
10572,788,5286,W,106,98,8
10573,553,5287,W,105,97,8
10574,554,5287,L,97,105,-8
10575,259,5288,L,86,88,-2
10576,260,5288,W,88,86,2
10577,491,5289,W,108,104,4
10578,492,5289,L,104,108,-4
10579,119,5290,W,91,81,10
10580,120,5290,L,81,91,-10
10581,11,5291,L,109,123,-14
10582,12,5291,W,123,109,14
10583,430,5292,W,111,97,14
10584,429,5292,L,97,111,-14
10585,588,5293,L,97,104,-7
10586,587,5293,W,104,97,7
10587,244,5294,L,103,121,-18
10588,243,5294,W,121,103,18
10589,630,5295,L,115,120,-5
10590,629,5295,W,120,115,5
10591,763,5296,W,109,80,29
10592,764,5296,L,80,109,-29
10593,649,5297,L,90,103,-13
10594,650,5297,W,103,90,13
10595,767,5298,L,93,107,-14
10596,768,5298,W,107,93,14
10597,714,5299,W,124,117,7
10598,713,5299,L,117,124,-7
10599,157,5300,W,88,86,2
10600,158,5300,L,86,88,-2
10601,120,5301,L,81,103,-22
10602,119,5301,W,103,81,22
10603,240,5302,W,124,102,22
10604,239,5302,L,102,124,-22
10605,841,5303,L,89,107,-18
10606,842,5303,W,107,89,18
10607,415,5304,L,90,96,-6
10608,416,5304,W,96,90,6
10609,316,5305,W,115,107,8
10610,315,5305,L,107,115,-8
10611,800,5306,L,92,108,-16
10612,799,5306,W,108,92,16
10613,750,5307,W,106,87,19
10614,749,5307,L,87,106,-19
10615,381,5308,W,88,78,10
10616,382,5308,L,78,88,-10
10617,612,5309,L,111,136,-25
10618,611,5309,W,136,111,25
10619,455,5310,W,107,100,7
10620,456,5310,L,100,107,-7
10621,108,5311,W,92,87,5
10622,107,5311,L,87,92,-5
10623,615,5312,W,102,98,4
10624,616,5312,L,98,102,-4
10625,2,5313,W,101,86,15
10626,1,5313,L,86,101,-15
10627,103,5314,L,103,112,-9
10628,104,5314,W,112,103,9
10629,133,5315,L,110,118,-8
10630,134,5315,W,118,110,8
10631,784,5316,L,109,114,-5
10632,783,5316,W,114,109,5
10633,282,5317,L,107,119,-12
10634,281,5317,W,119,107,12
10635,81,5318,L,95,102,-7
10636,82,5318,W,102,95,7
10637,511,5319,L,93,110,-17
10638,512,5319,W,110,93,17
10639,250,5320,W,115,102,13
10640,249,5320,L,102,115,-13
10641,670,5321,W,94,90,4
10642,669,5321,L,90,94,-4
10643,32,5322,W,115,106,9
10644,31,5322,L,106,115,-9
10645,527,5323,W,112,106,6
10646,528,5323,L,106,112,-6
10647,568,5324,W,109,106,3
10648,567,5324,L,106,109,-3
10649,494,5325,W,110,108,2
10650,493,5325,L,108,110,-2
10651,79,5326,L,85,98,-13
10652,80,5326,W,98,85,13
10653,844,5327,L,91,100,-9
10654,843,5327,W,100,91,9
10655,190,5328,W,99,95,4
10656,189,5328,L,95,99,-4
10657,591,5329,L,91,105,-14
10658,592,5329,W,105,91,14
10659,258,5330,W,106,99,7
10660,257,5330,L,99,106,-7
10661,137,5331,L,110,113,-3
10662,138,5331,W,113,110,3
10663,769,5332,W,98,89,9
10664,770,5332,L,89,98,-9
10665,603,5333,L,95,101,-6
10666,604,5333,W,101,95,6
10667,846,5334,W,103,100,3
10668,845,5334,L,100,103,-3
10669,148,5335,L,117,119,-2
10670,147,5335,W,119,117,2
10671,225,5336,W,114,94,20
10672,226,5336,L,94,114,-20
10673,821,5337,L,87,107,-20
10674,822,5337,W,107,87,20
10675,248,5338,L,109,116,-7
10676,247,5338,W,116,109,7
10677,840,5339,L,89,91,-2
10678,839,5339,W,91,89,2
10679,124,5340,L,100,102,-2
10680,123,5340,W,102,100,2
10681,310,5341,L,94,105,-11
10682,309,5341,W,105,94,11
10683,361,5342,L,111,120,-9
10684,362,5342,W,120,111,9
10685,577,5343,W,109,105,4
10686,578,5343,L,105,109,-4
10687,38,5344,W,99,79,20
10688,37,5344,L,79,99,-20
10689,608,5345,W,103,96,7
10690,607,5345,L,96,103,-7
10691,579,5346,L,97,105,-8
10692,580,5346,W,105,97,8
10693,56,5347,L,92,100,-8
10694,55,5347,W,100,92,8
10695,773,5348,W,106,100,6
10696,774,5348,L,100,106,-6
10697,179,5349,L,105,139,-34
10698,180,5349,W,139,105,34
10699,385,5350,L,94,102,-8
10700,386,5350,W,102,94,8
10701,843,5351,W,100,85,15
10702,844,5351,L,85,100,-15
10703,76,5352,W,98,96,2
10704,75,5352,L,96,98,-2
10705,355,5353,L,82,88,-6
10706,356,5353,W,88,82,6
10707,490,5354,L,90,114,-24
10708,489,5354,W,114,90,24
10709,780,5355,L,116,121,-5
10710,779,5355,W,121,116,5
10711,395,5356,L,99,110,-11
10712,396,5356,W,110,99,11
10713,109,5357,W,101,87,14
10714,110,5357,L,87,101,-14
10715,101,5358,W,102,100,2
10716,102,5358,L,100,102,-2
10717,644,5359,W,119,100,19
10718,643,5359,L,100,119,-19
10719,229,5360,L,75,123,-48
10720,230,5360,W,123,75,48
10721,315,5361,L,93,105,-12
10722,316,5361,W,105,93,12
10723,676,5362,L,91,99,-8
10724,675,5362,W,99,91,8
10725,268,5363,W,97,88,9
10726,267,5363,L,88,97,-9
10727,813,5364,W,101,88,13
10728,814,5364,L,88,101,-13
10729,88,5365,L,90,105,-15
10730,87,5365,W,105,90,15
10731,323,5366,L,105,117,-12
10732,324,5366,W,117,105,12
10733,166,5367,L,101,104,-3
10734,165,5367,W,104,101,3
10735,221,5368,L,111,133,-22
10736,222,5368,W,133,111,22
10737,80,5369,W,93,84,9
10738,79,5369,L,84,93,-9
10739,30,5370,W,107,93,14
10740,29,5370,L,93,107,-14
10741,502,5371,L,110,120,-10
10742,501,5371,W,120,110,10
10743,737,5372,L,89,111,-22
10744,738,5372,W,111,89,22
10745,388,5373,W,115,91,24
10746,387,5373,L,91,115,-24
10747,44,5374,W,112,95,17
10748,43,5374,L,95,112,-17
10749,114,5375,W,115,91,24
10750,113,5375,L,91,115,-24
10751,191,5376,L,105,108,-3
10752,192,5376,W,108,105,3
10753,626,5377,W,102,99,3
10754,625,5377,L,99,102,-3
10755,457,5378,L,92,111,-19
10756,458,5378,W,111,92,19
10757,127,5379,W,116,105,11
10758,128,5379,L,105,116,-11
10759,838,5380,W,132,129,3
10760,837,5380,L,129,132,-3
10761,110,5381,L,104,110,-6
10762,109,5381,W,110,104,6
10763,53,5382,L,94,116,-22
10764,54,5382,W,116,94,22
10765,116,5383,L,97,108,-11
10766,115,5383,W,108,97,11
10767,505,5384,L,105,112,-7
10768,506,5384,W,112,105,7
10769,651,5385,L,120,128,-8
10770,652,5385,W,128,120,8
10771,735,5386,L,90,101,-11
10772,736,5386,W,101,90,11
10773,798,5387,L,109,112,-3
10774,797,5387,W,112,109,3
10775,521,5388,L,84,92,-8
10776,522,5388,W,92,84,8
10777,51,5389,L,91,113,-22
10778,52,5389,W,113,91,22
10779,17,5390,L,94,96,-2
10780,18,5390,W,96,94,2
10781,399,5391,L,94,106,-12
10782,400,5391,W,106,94,12
10783,822,5392,L,95,104,-9
10784,821,5392,W,104,95,9
10785,275,5393,L,98,114,-16
10786,276,5393,W,114,98,16
10787,778,5394,L,103,104,-1
10788,777,5394,W,104,103,1
10789,400,5395,W,115,107,8
10790,399,5395,L,107,115,-8
10791,619,5396,L,88,112,-24
10792,620,5396,W,112,88,24
10793,462,5397,W,89,87,2
10794,461,5397,L,87,89,-2
10795,554,5398,L,104,113,-9
10796,553,5398,W,113,104,9
10797,492,5399,L,102,118,-16
10798,491,5399,W,118,102,16
10799,504,5400,L,107,119,-12
10800,503,5400,W,119,107,12
10801,174,5401,L,103,109,-6
10802,173,5401,W,109,103,6
10803,325,5402,W,122,101,21
10804,326,5402,L,101,122,-21
10805,132,5403,L,79,91,-12
10806,131,5403,W,91,79,12
10807,764,5404,L,104,113,-9
10808,763,5404,W,113,104,9
10809,90,5405,W,113,99,14
10810,89,5405,L,99,113,-14
10811,134,5406,L,107,111,-4
10812,133,5406,W,111,107,4
10813,60,5407,W,105,100,5
10814,59,5407,L,100,105,-5
10815,404,5408,L,100,107,-7
10816,403,5408,W,107,100,7
10817,195,5409,L,96,107,-11
10818,196,5409,W,107,96,11
10819,713,5410,W,109,104,5
10820,714,5410,L,104,109,-5
10821,586,5411,W,103,97,6
10822,585,5411,L,97,103,-6
10823,597,5412,L,102,109,-7
10824,598,5412,W,109,102,7
10825,365,5413,L,88,91,-3
10826,366,5413,W,91,88,3
10827,249,5414,L,75,91,-16
10828,250,5414,W,91,75,16
10829,326,5415,W,117,102,15
10830,325,5415,L,102,117,-15
10831,319,5416,L,91,124,-33
10832,320,5416,W,124,91,33
10833,485,5417,L,91,92,-1
10834,486,5417,W,92,91,1
10835,214,5418,L,100,105,-5
10836,213,5418,W,105,100,5
10837,173,5419,L,120,132,-12
10838,174,5419,W,132,120,12
10839,254,5420,L,105,109,-4
10840,253,5420,W,109,105,4
10841,823,5421,W,94,85,9
10842,824,5421,L,85,94,-9
10843,766,5422,W,88,80,8
10844,765,5422,L,80,88,-8
10845,143,5423,W,120,105,15
10846,144,5423,L,105,120,-15
10847,448,5424,L,101,122,-21
10848,447,5424,W,122,101,21
10849,683,5425,L,97,109,-12
10850,684,5425,W,109,97,12
10851,721,5426,L,79,87,-8
10852,722,5426,W,87,79,8
10853,802,5427,W,115,111,4
10854,801,5427,L,111,115,-4
10855,339,5428,W,101,93,8
10856,340,5428,L,93,101,-8
10857,444,5429,L,102,113,-11
10858,443,5429,W,113,102,11
10859,711,5430,L,85,92,-7
10860,712,5430,W,92,85,7
10861,576,5431,L,103,115,-12
10862,575,5431,W,115,103,12
10863,279,5432,L,89,99,-10
10864,280,5432,W,99,89,10
10865,287,5433,L,111,116,-5
10866,288,5433,W,116,111,5
10867,476,5434,W,117,112,5
10868,475,5434,L,112,117,-5
10869,390,5435,L,108,115,-7
10870,389,5435,W,115,108,7
10871,691,5436,W,111,97,14
10872,692,5436,L,97,111,-14
10873,131,5437,L,91,105,-14
10874,132,5437,W,105,91,14
10875,796,5438,W,109,103,6
10876,795,5438,L,103,109,-6
10877,652,5439,W,130,112,18
10878,651,5439,L,112,130,-18
10879,503,5440,W,95,90,5
10880,504,5440,L,90,95,-5
10881,269,5441,W,109,106,3
10882,270,5441,L,106,109,-3
10883,162,5442,L,86,96,-10
10884,161,5442,W,96,86,10
10885,105,5443,W,99,94,5
10886,106,5443,L,94,99,-5
10887,298,5444,L,102,118,-16
10888,297,5444,W,118,102,16
10889,534,5445,L,110,118,-8
10890,533,5445,W,118,110,8
10891,1,5446,L,69,103,-34
10892,2,5446,W,103,69,34
10893,454,5447,W,101,94,7
10894,453,5447,L,94,101,-7
10895,693,5448,L,98,116,-18
10896,694,5448,W,116,98,18
10897,299,5449,W,130,109,21
10898,300,5449,L,109,130,-21
10899,44,5450,W,118,114,4
10900,43,5450,L,114,118,-4
10901,555,5451,L,99,107,-8
10902,556,5451,W,107,99,8
10903,834,5452,L,98,99,-1
10904,833,5452,W,99,98,1
10905,771,5453,L,85,121,-36
10906,772,5453,W,121,85,36
10907,685,5454,W,114,108,6
10908,686,5454,L,108,114,-6
10909,345,5455,W,122,106,16
10910,346,5455,L,106,122,-16
10911,9,5456,L,96,117,-21
10912,10,5456,W,117,96,21
10913,177,5457,W,123,108,15
10914,178,5457,L,108,123,-15
10915,41,5458,L,98,103,-5
10916,42,5458,W,103,98,5
10917,482,5459,L,114,131,-17
10918,481,5459,W,131,114,17
10919,548,5460,L,87,108,-21
10920,547,5460,W,108,87,21
10921,185,5461,W,107,89,18
10922,186,5461,L,89,107,-18
10923,748,5462,L,110,116,-6
10924,747,5462,W,116,110,6
10925,159,5463,W,106,98,8
10926,160,5463,L,98,106,-8
10927,559,5464,W,109,107,2
10928,560,5464,L,107,109,-2
10929,449,5465,L,107,125,-18
10930,450,5465,W,125,107,18
10931,617,5466,L,81,124,-43
10932,618,5466,W,124,81,43
10933,376,5467,L,85,94,-9
10934,375,5467,W,94,85,9
10935,20,5468,W,107,96,11
10936,19,5468,L,96,107,-11
10937,256,5469,L,119,124,-5
10938,255,5469,W,124,119,5
10939,629,5470,L,94,128,-34
10940,630,5470,W,128,94,34
10941,779,5471,L,104,107,-3
10942,780,5471,W,107,104,3
10943,433,5472,L,81,130,-49
10944,434,5472,W,130,81,49
10945,610,5473,W,90,87,3
10946,609,5473,L,87,90,-3
10947,518,5474,W,114,90,24
10948,517,5474,L,90,114,-24
10949,628,5475,W,108,99,9
10950,627,5475,L,99,108,-9
10951,228,5476,W,109,100,9
10952,227,5476,L,100,109,-9
10953,707,5477,L,75,104,-29
10954,708,5477,W,104,75,29
10955,706,5478,L,100,116,-16
10956,705,5478,W,116,100,16
10957,78,5479,L,83,95,-12
10958,77,5479,W,95,83,12
10959,546,5480,L,92,103,-11
10960,545,5480,W,103,92,11
10961,458,5481,L,85,93,-8
10962,457,5481,W,93,85,8
10963,317,5482,L,109,125,-16
10964,318,5482,W,125,109,16
10965,232,5483,L,104,112,-8
10966,231,5483,W,112,104,8
10967,311,5484,W,112,105,7
10968,312,5484,L,105,112,-7
10969,402,5485,L,116,123,-7
10970,401,5485,W,123,116,7
10971,265,5486,W,125,111,14
10972,266,5486,L,111,125,-14
10973,374,5487,L,84,121,-37
10974,373,5487,W,121,84,37
10975,594,5488,W,99,96,3
10976,593,5488,L,96,99,-3
10977,409,5489,L,93,114,-21
10978,410,5489,W,114,93,21
10979,788,5490,W,118,96,22
10980,787,5490,L,96,118,-22
10981,234,5491,L,114,121,-7
10982,233,5491,W,121,114,7
10983,506,5492,L,103,118,-15
10984,505,5492,W,118,103,15
10985,481,5493,L,89,95,-6
10986,482,5493,W,95,89,6
10987,697,5494,L,94,101,-7
10988,698,5494,W,101,94,7
10989,612,5495,L,112,128,-16
10990,611,5495,W,128,112,16
10991,246,5496,W,107,100,7
10992,245,5496,L,100,107,-7
10993,405,5497,W,102,98,4
10994,406,5497,L,98,102,-4
10995,657,5498,W,120,108,12
10996,658,5498,L,108,120,-12
10997,584,5499,L,101,109,-8
10998,583,5499,W,109,101,8
10999,520,5500,L,98,116,-18
11000,519,5500,W,116,98,18
11001,579,5501,L,96,104,-8
11002,580,5501,W,104,96,8
11003,148,5502,L,108,120,-12
11004,147,5502,W,120,108,12
11005,26,5503,L,108,114,-6
11006,25,5503,W,114,108,6
11007,640,5504,W,128,97,31
11008,639,5504,L,97,128,-31
11009,770,5505,W,102,96,6
11010,769,5505,L,96,102,-6
11011,861,5506,W,120,111,9
11012,862,5506,L,111,120,-9
11013,607,5507,L,94,115,-21
11014,608,5507,W,115,94,21
11015,847,5508,L,113,122,-9
11016,848,5508,W,122,113,9
11017,152,5509,W,118,104,14
11018,151,5509,L,104,118,-14
11019,23,5510,L,96,116,-20
11020,24,5510,W,116,96,20
11021,744,5511,W,91,84,7
11022,743,5511,L,84,91,-7
11023,818,5512,W,116,91,25
11024,817,5512,L,91,116,-25
11025,142,5513,L,99,104,-5
11026,141,5513,W,104,99,5
11027,755,5514,L,94,110,-16
11028,756,5514,W,110,94,16
11029,645,5515,L,98,107,-9
11030,646,5515,W,107,98,9
11031,351,5516,L,109,116,-7
11032,352,5516,W,116,109,7
11033,616,5517,L,90,100,-10
11034,615,5517,W,100,90,10
11035,623,5518,L,113,119,-6
11036,624,5518,W,119,113,6
11037,378,5519,L,91,99,-8
11038,377,5519,W,99,91,8
11039,496,5520,L,103,108,-5
11040,495,5520,W,108,103,5
11041,178,5521,L,112,115,-3
11042,177,5521,W,115,112,3
11043,66,5522,W,109,90,19
11044,65,5522,L,90,109,-19
11045,632,5523,W,106,103,3
11046,631,5523,L,103,106,-3
11047,797,5524,W,113,107,6
11048,798,5524,L,107,113,-6
11049,452,5525,L,103,123,-20
11050,451,5525,W,123,103,20
11051,585,5526,W,109,100,9
11052,586,5526,L,100,109,-9
11053,422,5527,L,95,112,-17
11054,421,5527,W,112,95,17
11055,557,5528,L,98,103,-5
11056,558,5528,W,103,98,5
11057,411,5529,W,104,96,8
11058,412,5529,L,96,104,-8
11059,268,5530,L,114,116,-2
11060,267,5530,W,116,114,2
11061,845,5531,L,100,108,-8
11062,846,5531,W,108,100,8
11063,353,5532,L,103,120,-17
11064,354,5532,W,120,103,17
11065,295,5533,L,89,102,-13
11066,296,5533,W,102,89,13
11067,606,5534,W,107,97,10
11068,605,5534,L,97,107,-10
11069,263,5535,W,106,94,12
11070,264,5535,L,94,106,-12
11071,261,5536,L,94,104,-10
11072,262,5536,W,104,94,10
11073,237,5537,W,100,99,1
11074,238,5537,L,99,100,-1
11075,725,5538,L,118,132,-14
11076,726,5538,W,132,118,14
11077,678,5539,W,102,84,18
11078,677,5539,L,84,102,-18
11079,438,5540,L,101,108,-7
11080,437,5540,W,108,101,7
11081,689,5541,L,115,117,-2
11082,690,5541,W,117,115,2
11083,812,5542,L,104,105,-1
11084,811,5542,W,105,104,1
11085,558,5543,W,112,102,10
11086,557,5543,L,102,112,-10
11087,216,5544,L,88,94,-6
11088,215,5544,W,94,88,6
11089,717,5545,L,101,116,-15
11090,718,5545,W,116,101,15
11091,472,5546,L,83,108,-25
11092,471,5546,W,108,83,25
11093,786,5547,W,121,120,1
11094,785,5547,L,120,121,-1
11095,758,5548,W,106,77,29
11096,757,5548,L,77,106,-29
11097,55,5549,W,94,86,8
11098,56,5549,L,86,94,-8
11099,201,5550,L,92,108,-16
11100,202,5550,W,108,92,16
11101,222,5551,W,104,101,3
11102,221,5551,L,101,104,-3
11103,827,5552,L,106,121,-15
11104,828,5552,W,121,106,15
11105,731,5553,L,81,97,-16
11106,732,5553,W,97,81,16
11107,147,5554,L,98,103,-5
11108,148,5554,W,103,98,5
11109,294,5555,L,94,104,-10
11110,293,5555,W,104,94,10
11111,128,5556,L,107,117,-10
11112,127,5556,W,117,107,10
11113,359,5557,W,104,99,5
11114,360,5557,L,99,104,-5
11115,737,5558,L,89,102,-13
11116,738,5558,W,102,89,13
11117,561,5559,L,95,100,-5
11118,562,5559,W,100,95,5
11119,837,5560,W,104,98,6
11120,838,5560,L,98,104,-6
11121,843,5561,W,119,99,20
11122,844,5561,L,99,119,-20
11123,247,5562,L,93,116,-23
11124,248,5562,W,116,93,23
11125,407,5563,L,98,104,-6
11126,408,5563,W,104,98,6
11127,787,5564,L,111,129,-18
11128,788,5564,W,129,111,18
11129,285,5565,L,101,107,-6
11130,286,5565,W,107,101,6
11131,662,5566,L,92,126,-34
11132,661,5566,W,126,92,34
11133,719,5567,W,104,85,19
11134,720,5567,L,85,104,-19
11135,808,5568,L,105,109,-4
11136,807,5568,W,109,105,4
11137,474,5569,L,108,121,-13
11138,473,5569,W,121,108,13
11139,426,5570,W,131,116,15
11140,425,5570,L,116,131,-15
11141,335,5571,L,95,100,-5
11142,336,5571,W,100,95,5
11143,193,5572,L,95,105,-10
11144,194,5572,W,105,95,10
11145,106,5573,L,108,116,-8
11146,105,5573,W,116,108,8
11147,12,5574,L,96,100,-4
11148,11,5574,W,100,96,4
11149,578,5575,W,103,96,7
11150,577,5575,L,96,103,-7
11151,242,5576,L,121,128,-7
11152,241,5576,W,128,121,7
11153,3,5577,L,116,130,-14
11154,4,5577,W,130,116,14
11155,471,5578,L,99,113,-14
11156,472,5578,W,113,99,14
11157,423,5579,W,111,102,9
11158,424,5579,L,102,111,-9
11159,291,5580,L,76,87,-11
11160,292,5580,W,87,76,11
11161,382,5581,L,101,128,-27
11162,381,5581,W,128,101,27
11163,565,5582,L,101,114,-13
11164,566,5582,W,114,101,13
11165,665,5583,W,98,81,17
11166,666,5583,L,81,98,-17
11167,126,5584,L,89,101,-12
11168,125,5584,W,101,89,12
11169,486,5585,W,102,91,11
11170,485,5585,L,91,102,-11
11171,304,5586,W,112,110,2
11172,303,5586,L,110,112,-2
11173,586,5587,L,106,111,-5
11174,585,5587,W,111,106,5
11175,648,5588,W,98,96,2
11176,647,5588,L,96,98,-2
11177,170,5589,W,104,94,10
11178,169,5589,L,94,104,-10
11179,828,5590,W,121,118,3
11180,827,5590,L,118,121,-3
11181,816,5591,W,103,95,8
11182,815,5591,L,95,103,-8
11183,404,5592,W,112,95,17
11184,403,5592,L,95,112,-17
11185,102,5593,L,88,103,-15
11186,101,5593,W,103,88,15
11187,535,5594,L,95,108,-13
11188,536,5594,W,108,95,13
11189,105,5595,W,103,94,9
11190,106,5595,L,94,103,-9
11191,267,5596,L,116,122,-6
11192,268,5596,W,122,116,6
11193,437,5597,W,96,95,1
11194,438,5597,L,95,96,-1
11195,470,5598,W,117,107,10
11196,469,5598,L,107,117,-10
11197,572,5599,L,97,99,-2
11198,571,5599,W,99,97,2
11199,6,5600,L,119,123,-4
11200,5,5600,W,123,119,4
11201,157,5601,W,96,78,18
11202,158,5601,L,78,96,-18
11203,73,5602,W,119,105,14
11204,74,5602,L,105,119,-14
11205,552,5603,W,116,106,10
11206,551,5603,L,106,116,-10
11207,624,5604,W,130,114,16
11208,623,5604,L,114,130,-16
11209,99,5605,L,107,112,-5
11210,100,5605,W,112,107,5
11211,403,5606,L,119,128,-9
11212,404,5606,W,128,119,9
11213,582,5607,W,116,103,13
11214,581,5607,L,103,116,-13
11215,262,5608,W,108,92,16
11216,261,5608,L,92,108,-16
11217,500,5609,W,118,112,6
11218,499,5609,L,112,118,-6
11219,507,5610,L,105,114,-9
11220,508,5610,W,114,105,9
11221,103,5611,L,103,114,-11
11222,104,5611,W,114,103,11
11223,88,5612,W,87,81,6
11224,87,5612,L,81,87,-6
11225,266,5613,L,91,111,-20
11226,265,5613,W,111,91,20
11227,10,5614,L,104,109,-5
11228,9,5614,W,109,104,5
11229,107,5615,L,105,108,-3
11230,108,5615,W,108,105,3
11231,4,5616,W,124,115,9
11232,3,5616,L,115,124,-9
11233,32,5617,W,114,110,4
11234,31,5617,L,110,114,-4
11235,164,5618,L,104,112,-8
11236,163,5618,W,112,104,8
11237,204,5619,L,89,109,-20
11238,203,5619,W,109,89,20
11239,461,5620,L,114,117,-3
11240,462,5620,W,117,114,3
11241,807,5621,W,102,92,10
11242,808,5621,L,92,102,-10
11243,223,5622,L,84,124,-40
11244,224,5622,W,124,84,40
11245,72,5623,W,96,88,8
11246,71,5623,L,88,96,-8
11247,338,5624,L,101,108,-7
11248,337,5624,W,108,101,7
11249,14,5625,W,122,95,27
11250,13,5625,L,95,122,-27
11251,139,5626,L,93,101,-8
11252,140,5626,W,101,93,8
11253,477,5627,L,122,124,-2
11254,478,5627,W,124,122,2
11255,851,5628,L,115,126,-11
11256,852,5628,W,126,115,11
11257,226,5629,W,105,102,3
11258,225,5629,L,102,105,-3
11259,189,5630,L,85,98,-13
11260,190,5630,W,98,85,13
11261,659,5631,W,111,106,5
11262,660,5631,L,106,111,-5
11263,667,5632,L,103,129,-26
11264,668,5632,W,129,103,26
11265,97,5633,L,111,115,-4
11266,98,5633,W,115,111,4
11267,60,5634,W,104,96,8
11268,59,5634,L,96,104,-8
11269,539,5635,W,115,92,23
11270,540,5635,L,92,115,-23
11271,602,5636,W,118,111,7
11272,601,5636,L,111,118,-7
11273,794,5637,W,121,101,20
11274,793,5637,L,101,121,-20
11275,308,5638,L,94,114,-20
11276,307,5638,W,114,94,20
11277,735,5639,W,117,109,8
11278,736,5639,L,109,117,-8
11279,276,5640,W,115,112,3
11280,275,5640,L,112,115,-3
11281,867,5641,W,103,95,8
11282,868,5641,L,95,103,-8
11283,336,5642,L,93,111,-18
11284,335,5642,W,111,93,18
11285,529,5643,W,116,100,16
11286,530,5643,L,100,116,-16
11287,479,5644,W,115,111,4
11288,480,5644,L,111,115,-4
11289,388,5645,W,98,95,3
11290,387,5645,L,95,98,-3
11291,617,5646,L,86,98,-12
11292,618,5646,W,98,86,12
11293,685,5647,L,104,109,-5
11294,686,5647,W,109,104,5
11295,611,5648,L,105,137,-32
11296,612,5648,W,137,105,32
11297,473,5649,L,104,110,-6
11298,474,5649,W,110,104,6
11299,560,5650,L,106,116,-10
11300,559,5650,W,116,106,10
11301,31,5651,L,110,116,-6
11302,32,5651,W,116,110,6
11303,592,5652,L,98,109,-11
11304,591,5652,W,109,98,11
11305,768,5653,L,114,121,-7
11306,767,5653,W,121,114,7
11307,16,5654,W,119,113,6
11308,15,5654,L,113,119,-6
11309,801,5655,W,101,98,3
11310,802,5655,L,98,101,-3
11311,274,5656,L,95,106,-11
11312,273,5656,W,106,95,11
11313,547,5657,L,86,105,-19
11314,548,5657,W,105,86,19
11315,410,5658,L,89,103,-14
11316,409,5658,W,103,89,14
11317,176,5659,L,92,99,-7
11318,175,5659,W,99,92,7
11319,5,5660,L,95,121,-26
11320,6,5660,W,121,95,26
11321,437,5661,W,117,95,22
11322,438,5661,L,95,117,-22
11323,394,5662,W,98,96,2
11324,393,5662,L,96,98,-2
11325,508,5663,L,112,117,-5
11326,507,5663,W,117,112,5
11327,342,5664,W,114,110,4
11328,341,5664,L,110,114,-4
11329,73,5665,L,103,116,-13
11330,74,5665,W,116,103,13
11331,47,5666,W,109,90,19
11332,48,5666,L,90,109,-19
11333,440,5667,W,103,92,11
11334,439,5667,L,92,103,-11
11335,263,5668,L,96,100,-4
11336,264,5668,W,100,96,4
11337,101,5669,W,113,90,23
11338,102,5669,L,90,113,-23
11339,658,5670,L,111,120,-9
11340,657,5670,W,120,111,9
11341,401,5671,W,112,104,8
11342,402,5671,L,104,112,-8
11343,489,5672,L,134,139,-5
11344,490,5672,W,139,134,5
11345,483,5673,L,110,123,-13
11346,484,5673,W,123,110,13
11347,100,5674,L,111,112,-1
11348,99,5674,W,112,111,1
11349,184,5675,W,121,119,2
11350,183,5675,L,119,121,-2
11351,280,5676,W,111,108,3
11352,279,5676,L,108,111,-3
11353,620,5677,W,119,101,18
11354,619,5677,L,101,119,-18
11355,199,5678,L,87,89,-2
11356,200,5678,W,89,87,2
11357,146,5679,W,112,106,6
11358,145,5679,L,106,112,-6
11359,181,5680,W,122,106,16
11360,182,5680,L,106,122,-16
11361,785,5681,L,104,105,-1
11362,786,5681,W,105,104,1
11363,488,5682,L,91,108,-17
11364,487,5682,W,108,91,17
11365,303,5683,W,116,102,14
11366,304,5683,L,102,116,-14
11367,565,5684,W,103,89,14
11368,566,5684,L,89,103,-14
11369,392,5685,W,98,92,6
11370,391,5685,L,92,98,-6
11371,427,5686,W,117,110,7
11372,428,5686,L,110,117,-7
11373,862,5687,L,100,120,-20
11374,861,5687,W,120,100,20
11375,756,5688,W,101,96,5
11376,755,5688,L,96,101,-5
11377,542,5689,W,100,93,7
11378,541,5689,L,93,100,-7
11379,428,5690,L,94,96,-2
11380,427,5690,W,96,94,2
11381,825,5691,L,119,128,-9
11382,826,5691,W,128,119,9
11383,420,5692,L,84,99,-15
11384,419,5692,W,99,84,15
11385,15,5693,L,102,106,-4
11386,16,5693,W,106,102,4
11387,2,5694,W,98,89,9
11388,1,5694,L,89,98,-9
11389,570,5695,L,104,108,-4
11390,569,5695,W,108,104,4
11391,74,5696,W,96,79,17
11392,73,5696,L,79,96,-17
11393,349,5697,L,105,112,-7
11394,350,5697,W,112,105,7
11395,334,5698,W,114,110,4
11396,333,5698,L,110,114,-4
11397,827,5699,L,108,116,-8
11398,828,5699,W,116,108,8
11399,481,5700,L,98,103,-5
11400,482,5700,W,103,98,5
11401,792,5701,L,104,112,-8
11402,791,5701,W,112,104,8
11403,270,5702,W,98,95,3
11404,269,5702,L,95,98,-3
11405,707,5703,L,96,102,-6
11406,708,5703,W,102,96,6
11407,278,5704,W,116,90,26
11408,277,5704,L,90,116,-26
11409,869,5705,L,110,115,-5
11410,870,5705,W,115,110,5
11411,205,5706,L,119,128,-9
11412,206,5706,W,128,119,9
11413,573,5707,W,91,85,6
11414,574,5707,L,85,91,-6
11415,353,5708,W,104,103,1
11416,354,5708,L,103,104,-1
11417,824,5709,L,81,84,-3
11418,823,5709,W,84,81,3
11419,106,5710,L,94,106,-12
11420,105,5710,W,106,94,12
11421,589,5711,W,107,93,14
11422,590,5711,L,93,107,-14
11423,296,5712,L,105,111,-6
11424,295,5712,W,111,105,6
11425,383,5713,W,99,96,3
11426,384,5713,L,96,99,-3
11427,529,5714,W,111,105,6
11428,530,5714,L,105,111,-6
11429,690,5715,W,110,103,7
11430,689,5715,L,103,110,-7
11431,37,5716,W,108,102,6
11432,38,5716,L,102,108,-6
11433,598,5717,W,107,102,5
11434,597,5717,L,102,107,-5
11435,104,5718,L,97,106,-9
11436,103,5718,W,106,97,9
11437,418,5719,W,93,90,3
11438,417,5719,L,90,93,-3
11439,445,5720,W,124,86,38
11440,446,5720,L,86,124,-38
11441,56,5721,L,97,110,-13
11442,55,5721,W,110,97,13
11443,35,5722,L,114,117,-3
11444,36,5722,W,117,114,3
11445,386,5723,W,134,121,13
11446,385,5723,L,121,134,-13
11447,136,5724,L,81,85,-4
11448,135,5724,W,85,81,4
11449,502,5725,W,114,100,14
11450,501,5725,L,100,114,-14
11451,641,5726,L,95,102,-7
11452,642,5726,W,102,95,7
11453,363,5727,W,104,97,7
11454,364,5727,L,97,104,-7
11455,671,5728,L,95,107,-12
11456,672,5728,W,107,95,12
11457,819,5729,L,102,115,-13
11458,820,5729,W,115,102,13
11459,63,5730,L,115,119,-4
11460,64,5730,W,119,115,4
11461,811,5731,W,97,89,8
11462,812,5731,L,89,97,-8
11463,575,5732,W,105,100,5
11464,576,5732,L,100,105,-5
11465,233,5733,W,110,95,15
11466,234,5733,L,95,110,-15
11467,187,5734,L,98,114,-16
11468,188,5734,W,114,98,16
11469,510,5735,L,104,111,-7
11470,509,5735,W,111,104,7
11471,712,5736,L,96,105,-9
11472,711,5736,W,105,96,9
11473,393,5737,L,92,107,-15
11474,394,5737,W,107,92,15
11475,150,5738,L,93,112,-19
11476,149,5738,W,112,93,19
11477,11,5739,W,111,106,5
11478,12,5739,L,106,111,-5
11479,463,5740,L,97,112,-15
11480,464,5740,W,112,97,15
11481,772,5741,W,116,95,21
11482,771,5741,L,95,116,-21
11483,762,5742,L,93,120,-27
11484,761,5742,W,120,93,27
11485,196,5743,L,114,119,-5
11486,195,5743,W,119,114,5
11487,680,5744,L,93,96,-3
11488,679,5744,W,96,93,3
11489,118,5745,L,78,91,-13
11490,117,5745,W,91,78,13
11491,480,5746,L,87,105,-18
11492,479,5746,W,105,87,18
11493,859,5747,W,101,82,19
11494,860,5747,L,82,101,-19
11495,301,5748,L,103,117,-14
11496,302,5748,W,117,103,14
11497,622,5749,L,105,109,-4
11498,621,5749,W,109,105,4
11499,566,5750,L,107,111,-4
11500,565,5750,W,111,107,4
11501,324,5751,W,108,105,3
11502,323,5751,L,105,108,-3
11503,407,5752,L,117,121,-4
11504,408,5752,W,121,117,4
11505,749,5753,L,103,105,-2
11506,750,5753,W,105,103,2
11507,856,5754,W,123,122,1
11508,855,5754,L,122,123,-1
11509,26,5755,W,107,103,4
11510,25,5755,L,103,107,-4
11511,79,5756,L,90,103,-13
11512,80,5756,W,103,90,13
11513,655,5757,L,91,109,-18
11514,656,5757,W,109,91,18
11515,120,5758,L,93,105,-12
11516,119,5758,W,105,93,12
11517,134,5759,L,108,116,-8
11518,133,5759,W,116,108,8
11519,709,5760,L,79,91,-12
11520,710,5760,W,91,79,12
11521,639,5761,L,84,102,-18
11522,640,5761,W,102,84,18
11523,71,5762,W,114,106,8
11524,72,5762,L,106,114,-8
11525,195,5763,L,94,113,-19
11526,196,5763,W,113,94,19
11527,708,5764,L,92,111,-19
11528,707,5764,W,111,92,19
11529,13,5765,L,93,103,-10
11530,14,5765,W,103,93,10
11531,705,5766,W,117,113,4
11532,706,5766,L,113,117,-4
11533,161,5767,L,83,103,-20
11534,162,5767,W,103,83,20
11535,178,5768,L,105,114,-9
11536,177,5768,W,114,105,9
11537,852,5769,W,114,91,23
11538,851,5769,L,91,114,-23
11539,673,5770,L,73,102,-29
11540,674,5770,W,102,73,29
11541,266,5771,L,97,110,-13
11542,265,5771,W,110,97,13
11543,605,5772,W,85,83,2
11544,606,5772,L,83,85,-2
11545,793,5773,L,103,111,-8
11546,794,5773,W,111,103,8
11547,169,5774,L,99,130,-31
11548,170,5774,W,130,99,31
11549,593,5775,W,126,123,3
11550,594,5775,L,123,126,-3
11551,864,5776,L,93,115,-22
11552,863,5776,W,115,93,22
11553,651,5777,L,107,127,-20
11554,652,5777,W,127,107,20
11555,137,5778,L,100,107,-7
11556,138,5778,W,107,100,7
11557,315,5779,L,97,112,-15
11558,316,5779,W,112,97,15
11559,781,5780,W,91,89,2
11560,782,5780,L,89,91,-2
11561,637,5781,L,89,106,-17
11562,638,5781,W,106,89,17
11563,171,5782,L,103,113,-10
11564,172,5782,W,113,103,10
11565,93,5783,W,92,90,2
11566,94,5783,L,90,92,-2
11567,329,5784,W,128,122,6
11568,330,5784,L,122,128,-6
11569,396,5785,W,102,98,4
11570,395,5785,L,98,102,-4
11571,788,5786,W,89,84,5
11572,787,5786,L,84,89,-5
11573,752,5787,W,129,128,1
11574,751,5787,L,128,129,-1
11575,722,5788,L,90,120,-30
11576,721,5788,W,120,90,30
11577,699,5789,L,107,114,-7
11578,700,5789,W,114,107,7
11579,562,5790,W,112,111,1
11580,561,5790,L,111,112,-1
11581,156,5791,W,116,91,25
11582,155,5791,L,91,116,-25
11583,694,5792,W,119,105,14
11584,693,5792,L,105,119,-14
11585,281,5793,L,102,108,-6
11586,282,5793,W,108,102,6
11587,322,5794,W,95,92,3
11588,321,5794,L,92,95,-3
11589,775,5795,L,94,112,-18
11590,776,5795,W,112,94,18
11591,687,5796,L,106,116,-10
11592,688,5796,W,116,106,10
11593,260,5797,L,104,115,-11
11594,259,5797,W,115,104,11
11595,143,5798,W,112,92,20
11596,144,5798,L,92,112,-20
11597,439,5799,L,101,104,-3
11598,440,5799,W,104,101,3
11599,650,5800,L,95,98,-3
11600,649,5800,W,98,95,3
11601,46,5801,L,103,121,-18
11602,45,5801,W,121,103,18
11603,429,5802,L,84,97,-13
11604,430,5802,W,97,84,13
11605,742,5803,L,97,108,-11
11606,741,5803,W,108,97,11
11607,545,5804,L,99,116,-17
11608,546,5804,W,116,99,17
11609,274,5805,W,96,83,13
11610,273,5805,L,83,96,-13
11611,686,5806,L,101,106,-5
11612,685,5806,W,106,101,5
11613,556,5807,W,120,116,4
11614,555,5807,L,116,120,-4
11615,582,5808,W,109,106,3
11616,581,5808,L,106,109,-3
11617,241,5809,L,98,102,-4
11618,242,5809,W,102,98,4
11619,698,5810,W,116,88,28
11620,697,5810,L,88,116,-28
11621,232,5811,L,81,101,-20
11622,231,5811,W,101,81,20
11623,647,5812,W,108,86,22
11624,648,5812,L,86,108,-22
11625,16,5813,W,108,95,13
11626,15,5813,L,95,108,-13
11627,653,5814,L,101,110,-9
11628,654,5814,W,110,101,9
11629,595,5815,L,110,122,-12
11630,596,5815,W,122,110,12
11631,578,5816,W,102,101,1
11632,577,5816,L,101,102,-1
11633,850,5817,L,88,91,-3
11634,849,5817,W,91,88,3
11635,517,5818,L,102,115,-13
11636,518,5818,W,115,102,13
11637,660,5819,L,99,115,-16
11638,659,5819,W,115,99,16
11639,602,5820,W,117,89,28
11640,601,5820,L,89,117,-28
11641,86,5821,L,95,109,-14
11642,85,5821,W,109,95,14
11643,759,5822,W,123,114,9
11644,760,5822,L,114,123,-9
11645,822,5823,W,91,78,13
11646,821,5823,L,78,91,-13
11647,398,5824,W,104,98,6
11648,397,5824,L,98,104,-6
11649,131,5825,L,109,115,-6
11650,132,5825,W,115,109,6
11651,307,5826,L,87,106,-19
11652,308,5826,W,106,87,19
11653,61,5827,W,125,94,31
11654,62,5827,L,94,125,-31
11655,3,5828,W,96,87,9
11656,4,5828,L,87,96,-9
11657,159,5829,W,112,93,19
11658,160,5829,L,93,112,-19
11659,347,5830,L,111,118,-7
11660,348,5830,W,118,111,7
11661,382,5831,L,94,106,-12
11662,381,5831,W,106,94,12
11663,240,5832,W,110,104,6
11664,239,5832,L,104,110,-6
11665,25,5833,W,91,79,12
11666,26,5833,L,79,91,-12
11667,211,5834,W,97,94,3
11668,212,5834,L,94,97,-3
11669,304,5835,L,99,114,-15
11670,303,5835,W,114,99,15
11671,346,5836,L,132,140,-8
11672,345,5836,W,140,132,8
11673,674,5837,L,119,124,-5
11674,673,5837,W,124,119,5
11675,352,5838,W,108,98,10
11676,351,5838,L,98,108,-10
11677,563,5839,W,132,98,34
11678,564,5839,L,98,132,-34
11679,234,5840,L,99,101,-2
11680,233,5840,W,101,99,2
11681,83,5841,L,113,119,-6
11682,84,5841,W,119,113,6
11683,745,5842,L,113,118,-5
11684,746,5842,W,118,113,5
11685,669,5843,W,111,101,10
11686,670,5843,L,101,111,-10
11687,427,5844,L,81,98,-17
11688,428,5844,W,98,81,17
11689,142,5845,L,100,112,-12
11690,141,5845,W,112,100,12
11691,167,5846,L,74,99,-25
11692,168,5846,W,99,74,25
11693,780,5847,L,87,117,-30
11694,779,5847,W,117,87,30
11695,277,5848,L,83,112,-29
11696,278,5848,W,112,83,29
11697,129,5849,W,112,95,17
11698,130,5849,L,95,112,-17
11699,621,5850,L,126,129,-3
11700,622,5850,W,129,126,3
11701,22,5851,L,86,114,-28
11702,21,5851,W,114,86,28
11703,469,5852,W,110,103,7
11704,470,5852,L,103,110,-7
11705,387,5853,W,105,92,13
11706,388,5853,L,92,105,-13
11707,229,5854,L,82,109,-27
11708,230,5854,W,109,82,27
11709,156,5855,W,119,117,2
11710,155,5855,L,117,119,-2
11711,574,5856,L,95,103,-8
11712,573,5856,W,103,95,8
11713,33,5857,L,95,113,-18
11714,34,5857,W,113,95,18
11715,192,5858,L,89,114,-25
11716,191,5858,W,114,89,25
11717,736,5859,L,101,108,-7
11718,735,5859,W,108,101,7
11719,848,5860,L,107,109,-2
11720,847,5860,W,109,107,2
11721,594,5861,L,93,113,-20
11722,593,5861,W,113,93,20
11723,774,5862,W,91,77,14
11724,773,5862,L,77,91,-14
11725,163,5863,W,116,104,12
11726,164,5863,L,104,116,-12
11727,238,5864,W,118,104,14
11728,237,5864,L,104,118,-14
11729,255,5865,W,98,95,3
11730,256,5865,L,95,98,-3
11731,625,5866,L,103,117,-14
11732,626,5866,W,117,103,14
11733,379,5867,W,83,77,6
11734,380,5867,L,77,83,-6
11735,421,5868,L,98,116,-18
11736,422,5868,W,116,98,18
11737,213,5869,W,106,103,3
11738,214,5869,L,103,106,-3
11739,302,5870,L,95,99,-4
11740,301,5870,W,99,95,4
11741,513,5871,W,115,111,4
11742,514,5871,L,111,115,-4
11743,627,5872,W,103,101,2
11744,628,5872,L,101,103,-2
11745,549,5873,L,101,103,-2
11746,550,5873,W,103,101,2
11747,42,5874,L,94,103,-9
11748,41,5874,W,103,94,9
11749,541,5875,L,90,104,-14
11750,542,5875,W,104,90,14
11751,292,5876,L,84,107,-23
11752,291,5876,W,107,84,23
11753,592,5877,L,104,110,-6
11754,591,5877,W,110,104,6
11755,177,5878,W,109,97,12
11756,178,5878,L,97,109,-12
11757,369,5879,L,110,112,-2
11758,370,5879,W,112,110,2
11759,175,5880,L,101,106,-5
11760,176,5880,W,106,101,5
11761,287,5881,L,104,107,-3
11762,288,5881,W,107,104,3
11763,97,5882,L,85,99,-14
11764,98,5882,W,99,85,14
11765,581,5883,L,89,108,-19
11766,582,5883,W,108,89,19
11767,615,5884,L,101,106,-5
11768,616,5884,W,106,101,5
11769,212,5885,L,97,116,-19
11770,211,5885,W,116,97,19
11771,434,5886,W,107,91,16
11772,433,5886,L,91,107,-16
11773,593,5887,W,101,96,5
11774,594,5887,L,96,101,-5
11775,811,5888,L,114,120,-6
11776,812,5888,W,120,114,6
11777,833,5889,W,110,107,3
11778,834,5889,L,107,110,-3
11779,384,5890,L,91,95,-4
11780,383,5890,W,95,91,4
11781,732,5891,W,109,99,10
11782,731,5891,L,99,109,-10
11783,499,5892,L,103,111,-8
11784,500,5892,W,111,103,8
11785,10,5893,W,114,100,14
11786,9,5893,L,100,114,-14
11787,327,5894,W,106,79,27
11788,328,5894,L,79,106,-27
11789,67,5895,L,88,100,-12
11790,68,5895,W,100,88,12
11791,24,5896,L,98,101,-3
11792,23,5896,W,101,98,3
11793,381,5897,W,93,87,6
11794,382,5897,L,87,93,-6
11795,165,5898,L,103,107,-4
11796,166,5898,W,107,103,4
11797,230,5899,W,86,74,12
11798,229,5899,L,74,86,-12
11799,253,5900,L,111,114,-3
11800,254,5900,W,114,111,3
11801,630,5901,L,110,115,-5
11802,629,5901,W,115,110,5
11803,340,5902,L,92,95,-3
11804,339,5902,W,95,92,3
11805,70,5903,W,95,85,10
11806,69,5903,L,85,95,-10
11807,39,5904,W,108,95,13
11808,40,5904,L,95,108,-13
11809,436,5905,W,128,116,12
11810,435,5905,L,116,128,-12
11811,102,5906,L,105,120,-15
11812,101,5906,W,120,105,15
11813,58,5907,W,105,99,6
11814,57,5907,L,99,105,-6
11815,497,5908,L,83,98,-15
11816,498,5908,W,98,83,15
11817,576,5909,L,89,103,-14
11818,575,5909,W,103,89,14
11819,857,5910,L,83,97,-14
11820,858,5910,W,97,83,14
11821,198,5911,L,95,96,-1
11822,197,5911,W,96,95,1
11823,217,5912,W,117,113,4
11824,218,5912,L,113,117,-4
11825,700,5913,W,125,99,26
11826,699,5913,L,99,125,-26
11827,577,5914,L,84,91,-7
11828,578,5914,W,91,84,7
11829,202,5915,W,103,95,8
11830,201,5915,L,95,103,-8
11831,638,5916,W,97,88,9
11832,637,5916,L,88,97,-9
11833,522,5917,W,91,86,5
11834,521,5917,L,86,91,-5
11835,830,5918,L,99,100,-1
11836,829,5918,W,100,99,1
11837,611,5919,W,128,108,20
11838,612,5919,L,108,128,-20
11839,180,5920,W,83,77,6
11840,179,5920,L,77,83,-6
11841,160,5921,L,115,118,-3
11842,159,5921,W,118,115,3
11843,654,5922,L,92,101,-9
11844,653,5922,W,101,92,9
11845,462,5923,L,94,103,-9
11846,461,5923,W,103,94,9
11847,445,5924,W,126,98,28
11848,446,5924,L,98,126,-28
11849,141,5925,W,91,74,17
11850,142,5925,L,74,91,-17
11851,666,5926,W,98,90,8
11852,665,5926,L,90,98,-8
11853,158,5927,L,98,123,-25
11854,157,5927,W,123,98,25
11855,358,5928,W,100,91,9
11856,357,5928,L,91,100,-9
11857,208,5929,L,94,112,-18
11858,207,5929,W,112,94,18
11859,661,5930,L,102,111,-9
11860,662,5930,W,111,102,9
11861,471,5931,W,121,115,6
11862,472,5931,L,115,121,-6
11863,460,5932,W,78,74,4
11864,459,5932,L,74,78,-4
11865,18,5933,W,109,98,11
11866,17,5933,L,98,109,-11
11867,641,5934,W,99,94,5
11868,642,5934,L,94,99,-5
11869,226,5935,W,95,86,9
11870,225,5935,L,86,95,-9
11871,222,5936,L,116,117,-1
11872,221,5936,W,117,116,1
11873,616,5937,L,106,117,-11
11874,615,5937,W,117,106,11
11875,422,5938,W,109,88,21
11876,421,5938,L,88,109,-21
11877,271,5939,W,107,101,6
11878,272,5939,L,101,107,-6
11879,571,5940,L,100,122,-22
11880,572,5940,W,122,100,22
11881,92,5941,W,103,94,9
11882,91,5941,L,94,103,-9
11883,139,5942,L,100,103,-3
11884,140,5942,W,103,100,3
11885,492,5943,L,89,115,-26
11886,491,5943,W,115,89,26
11887,853,5944,L,99,109,-10
11888,854,5944,W,109,99,10
11889,804,5945,L,101,111,-10
11890,803,5945,W,111,101,10
11891,696,5946,W,123,98,25
11892,695,5946,L,98,123,-25
11893,145,5947,W,91,78,13
11894,146,5947,L,78,91,-13
11895,461,5948,W,93,91,2
11896,462,5948,L,91,93,-2
11897,425,5949,W,116,104,12
11898,426,5949,L,104,116,-12
11899,503,5950,L,77,97,-20
11900,504,5950,W,97,77,20
11901,559,5951,W,115,113,2
11902,560,5951,L,113,115,-2
11903,307,5952,W,97,75,22
11904,308,5952,L,75,97,-22
11905,272,5953,L,97,111,-14
11906,271,5953,W,111,97,14
11907,209,5954,W,112,106,6
11908,210,5954,L,106,112,-6
11909,85,5955,W,109,90,19
11910,86,5955,L,90,109,-19
11911,53,5956,L,119,142,-23
11912,54,5956,W,142,119,23
11913,718,5957,W,95,85,10
11914,717,5957,L,85,95,-10
11915,370,5958,L,108,111,-3
11916,369,5958,W,111,108,3
11917,792,5959,L,82,94,-12
11918,791,5959,W,94,82,12
11919,215,5960,L,87,92,-5
11920,216,5960,W,92,87,5
11921,391,5961,L,99,130,-31
11922,392,5961,W,130,99,31
11923,91,5962,W,100,97,3
11924,92,5962,L,97,100,-3
11925,795,5963,L,79,104,-25
11926,796,5963,W,104,79,25
11927,357,5964,W,105,98,7
11928,358,5964,L,98,105,-7
11929,169,5965,L,103,121,-18
11930,170,5965,W,121,103,18
11931,415,5966,L,94,104,-10
11932,416,5966,W,104,94,10
11933,57,5967,L,91,103,-12
11934,58,5967,W,103,91,12
11935,417,5968,L,82,106,-24
11936,418,5968,W,106,82,24
11937,367,5969,L,84,93,-9
11938,368,5969,W,93,84,9
11939,400,5970,L,81,108,-27
11940,399,5970,W,108,81,27
11941,112,5971,L,90,115,-25
11942,111,5971,W,115,90,25
11943,98,5972,L,96,109,-13
11944,97,5972,W,109,96,13
11945,484,5973,W,114,110,4
11946,483,5973,L,110,114,-4
11947,182,5974,L,106,110,-4
11948,181,5974,W,110,106,4
11949,254,5975,W,95,89,6
11950,253,5975,L,89,95,-6
11951,360,5976,W,120,116,4
11952,359,5976,L,116,120,-4
11953,75,5977,L,100,102,-2
11954,76,5977,W,102,100,2
11955,210,5978,L,103,110,-7
11956,209,5978,W,110,103,7
11957,341,5979,W,110,105,5
11958,342,5979,L,105,110,-5
11959,637,5980,L,91,94,-3
11960,638,5980,W,94,91,3
11961,80,5981,L,80,94,-14
11962,79,5981,W,94,80,14
11963,456,5982,W,112,104,8
11964,455,5982,L,104,112,-8
11965,858,5983,W,122,117,5
11966,857,5983,L,117,122,-5
11967,601,5984,L,79,112,-33
11968,602,5984,W,112,79,33
11969,652,5985,L,91,114,-23
11970,651,5985,W,114,91,23
11971,179,5986,L,93,100,-7
11972,180,5986,W,100,93,7
11973,320,5987,W,93,87,6
11974,319,5987,L,87,93,-6
11975,684,5988,W,121,115,6
11976,683,5988,L,115,121,-6
11977,295,5989,L,96,108,-12
11978,296,5989,W,108,96,12
11979,753,5990,L,90,99,-9
11980,754,5990,W,99,90,9
11981,412,5991,L,123,131,-8
11982,411,5991,W,131,123,8
11983,708,5992,L,87,93,-6
11984,707,5992,W,93,87,6
11985,560,5993,L,97,104,-7
11986,559,5993,W,104,97,7
11987,395,5994,W,111,105,6
11988,396,5994,L,105,111,-6
11989,197,5995,L,93,103,-10
11990,198,5995,W,103,93,10
11991,783,5996,W,108,91,17
11992,784,5996,L,91,108,-17
11993,153,5997,L,89,104,-15
11994,154,5997,W,104,89,15
11995,806,5998,L,91,95,-4
11996,805,5998,W,95,91,4
11997,435,5999,L,103,122,-19
11998,436,5999,W,122,103,19
11999,863,6000,W,101,97,4
12000,864,6000,L,97,101,-4
12001,860,6001,L,98,108,-10
12002,859,6001,W,108,98,10
12003,817,6002,L,95,101,-6
12004,818,6002,W,101,95,6
12005,812,6003,L,91,100,-9
12006,811,6003,W,100,91,9
12007,403,6004,L,96,112,-16
12008,404,6004,W,112,96,16
12009,316,6005,W,98,94,4
12010,315,6005,L,94,98,-4
12011,239,6006,L,112,122,-10
12012,240,6006,W,122,112,10
12013,642,6007,W,99,93,6
12014,641,6007,L,93,99,-6
12015,185,6008,W,111,90,21
12016,186,6008,L,90,111,-21
12017,730,6009,W,109,104,5
12018,729,6009,L,104,109,-5
12019,219,6010,L,86,101,-15
12020,220,6010,W,101,86,15
12021,271,6011,L,98,117,-19
12022,272,6011,W,117,98,19
12023,380,6012,L,111,118,-7
12024,379,6012,W,118,111,7
12025,636,6013,W,102,88,14
12026,635,6013,L,88,102,-14
12027,832,6014,L,76,105,-29
12028,831,6014,W,105,76,29
12029,243,6015,W,111,96,15
12030,244,6015,L,96,111,-15
12031,172,6016,W,111,104,7
12032,171,6016,L,104,111,-7
12033,562,6017,L,108,110,-2
12034,561,6017,W,110,108,2
12035,115,6018,W,108,101,7
12036,116,6018,L,101,108,-7
12037,728,6019,L,92,98,-6
12038,727,6019,W,98,92,6
12039,170,6020,L,84,88,-4
12040,169,6020,W,88,84,4
12041,89,6021,L,88,94,-6
12042,90,6021,W,94,88,6
12043,564,6022,L,83,89,-6
12044,563,6022,W,89,83,6
12045,119,6023,W,94,84,10
12046,120,6023,L,84,94,-10
12047,442,6024,W,105,96,9
12048,441,6024,L,96,105,-9
12049,515,6025,L,91,100,-9
12050,516,6025,W,100,91,9
12051,607,6026,L,85,103,-18
12052,608,6026,W,103,85,18
12053,818,6027,W,108,83,25
12054,817,6027,L,83,108,-25
12055,29,6028,L,84,91,-7
12056,30,6028,W,91,84,7
12057,217,6029,W,120,85,35
12058,218,6029,L,85,120,-35
12059,465,6030,L,100,113,-13
12060,466,6030,W,113,100,13
12061,710,6031,W,119,118,1
12062,709,6031,L,118,119,-1
12063,476,6032,L,89,115,-26
12064,475,6032,W,115,89,26
12065,723,6033,W,102,89,13
12066,724,6033,L,89,102,-13
12067,43,6034,L,100,107,-7
12068,44,6034,W,107,100,7
12069,741,6035,W,108,106,2
12070,742,6035,L,106,108,-2
12071,314,6036,L,101,104,-3
12072,313,6036,W,104,101,3
12073,519,6037,W,104,96,8
12074,520,6037,L,96,104,-8
12075,531,6038,W,104,90,14
12076,532,6038,L,90,104,-14
12077,739,6039,L,99,103,-4
12078,740,6039,W,103,99,4
12079,841,6040,W,93,92,1
12080,842,6040,L,92,93,-1
12081,128,6041,W,111,107,4
12082,127,6041,L,107,111,-4
12083,1,6042,L,89,110,-21
12084,2,6042,W,110,89,21
12085,397,6043,L,97,106,-9
12086,398,6043,W,106,97,9
12087,318,6044,L,95,102,-7
12088,317,6044,W,102,95,7
12089,298,6045,W,105,102,3
12090,297,6045,L,102,105,-3
12091,478,6046,L,99,113,-14
12092,477,6046,W,113,99,14
12093,147,6047,W,100,99,1
12094,148,6047,L,99,100,-1
12095,535,6048,W,107,99,8
12096,536,6048,L,99,107,-8
12097,362,6049,L,99,113,-14
12098,361,6049,W,113,99,14
12099,377,6050,L,92,106,-14
12100,378,6050,W,106,92,14
12101,309,6051,W,101,95,6
12102,310,6051,L,95,101,-6
12103,306,6052,W,104,94,10
12104,305,6052,L,94,104,-10
12105,69,6053,L,86,108,-22
12106,70,6053,W,108,86,22
12107,726,6054,W,100,85,15
12108,725,6054,L,85,100,-15
12109,604,6055,W,130,125,5
12110,603,6055,L,125,130,-5
12111,428,6056,W,103,100,3
12112,427,6056,L,100,103,-3
12113,512,6057,L,109,116,-7
12114,511,6057,W,116,109,7
12115,345,6058,L,97,107,-10
12116,346,6058,W,107,97,10
12117,399,6059,L,91,107,-16
12118,400,6059,W,107,91,16
12119,569,6060,L,101,109,-8
12120,570,6060,W,109,101,8
12121,218,6061,L,78,118,-40
12122,217,6061,W,118,78,40
12123,809,6062,L,84,96,-12
12124,810,6062,W,96,84,12
12125,554,6063,L,95,99,-4
12126,553,6063,W,99,95,4
12127,523,6064,W,109,101,8
12128,524,6064,L,101,109,-8
12129,136,6065,L,88,97,-9
12130,135,6065,W,97,88,9
12131,96,6066,L,112,121,-9
12132,95,6066,W,121,112,9
12133,333,6067,L,88,97,-9
12134,334,6067,W,97,88,9
12135,373,6068,L,94,102,-8
12136,374,6068,W,102,94,8
12137,84,6069,W,107,97,10
12138,83,6069,L,97,107,-10
12139,548,6070,L,107,115,-8
12140,547,6070,W,115,107,8
12141,231,6071,W,108,94,14
12142,232,6071,L,94,108,-14
12143,27,6072,L,88,104,-16
12144,28,6072,W,104,88,16
12145,501,6073,L,97,104,-7
12146,502,6073,W,104,97,7
12147,670,6074,W,147,144,3
12148,669,6074,L,144,147,-3
12149,416,6075,L,99,109,-10
12150,415,6075,W,109,99,10
12151,540,6076,L,100,104,-4
12152,539,6076,W,104,100,4
12153,129,6077,W,107,87,20
12154,130,6077,L,87,107,-20
12155,556,6078,L,98,113,-15
12156,555,6078,W,113,98,15
12157,836,6079,L,95,114,-19
12158,835,6079,W,114,95,19
12159,642,6080,L,116,119,-3
12160,641,6080,W,119,116,3
12161,799,6081,L,85,98,-13
12162,800,6081,W,98,85,13
12163,868,6082,L,102,107,-5
12164,867,6082,W,107,102,5
12165,629,6083,L,90,106,-16
12166,630,6083,W,106,90,16
12167,264,6084,W,104,94,10
12168,263,6084,L,94,104,-10
12169,790,6085,L,90,103,-13
12170,789,6085,W,103,90,13
12171,396,6086,W,104,98,6
12172,395,6086,L,98,104,-6
12173,446,6087,L,106,127,-21
12174,445,6087,W,127,106,21
12175,312,6088,L,81,107,-26
12176,311,6088,W,107,81,26
12177,402,6089,L,103,128,-25
12178,401,6089,W,128,103,25
12179,354,6090,W,89,77,12
12180,353,6090,L,77,89,-12
12181,337,6091,L,95,113,-18
12182,338,6091,W,113,95,18
12183,8,6092,L,97,107,-10
12184,7,6092,W,107,97,10
12185,460,6093,W,112,100,12
12186,459,6093,L,100,112,-12
12187,118,6094,L,94,104,-10
12188,117,6094,W,104,94,10
12189,514,6095,L,96,115,-19
12190,513,6095,W,115,96,19
12191,180,6096,W,105,82,23
12192,179,6096,L,82,105,-23
12193,49,6097,L,108,114,-6
12194,50,6097,W,114,108,6
12195,716,6098,W,105,103,2
12196,715,6098,L,103,105,-2
12197,158,6099,L,81,118,-37
12198,157,6099,W,118,81,37
12199,516,6100,L,95,112,-17
12200,515,6100,W,112,95,17
12201,479,6101,W,100,88,12
12202,480,6101,L,88,100,-12
12203,454,6102,L,90,106,-16
12204,453,6102,W,106,90,16
12205,475,6103,L,101,105,-4
12206,476,6103,W,105,101,4
12207,779,6104,L,101,108,-7
12208,780,6104,W,108,101,7
12209,754,6105,L,97,100,-3
12210,753,6105,W,100,97,3
12211,51,6106,L,98,104,-6
12212,52,6106,W,104,98,6
12213,40,6107,L,76,96,-20
12214,39,6107,W,96,76,20
12215,634,6108,W,103,78,25
12216,633,6108,L,78,103,-25
12217,130,6109,L,97,126,-29
12218,129,6109,W,126,97,29
12219,723,6110,W,98,93,5
12220,724,6110,L,93,98,-5
12221,95,6111,L,95,108,-13
12222,96,6111,W,108,95,13
12223,537,6112,L,94,98,-4
12224,538,6112,W,98,94,4
12225,194,6113,W,105,100,5
12226,193,6113,L,100,105,-5
12227,526,6114,W,114,111,3
12228,525,6114,L,111,114,-3
12229,720,6115,W,112,110,2
12230,719,6115,L,110,112,-2
12231,791,6116,L,96,118,-22
12232,792,6116,W,118,96,22
12233,567,6117,W,124,119,5
12234,568,6117,L,119,124,-5
12235,186,6118,L,83,90,-7
12236,185,6118,W,90,83,7
12237,284,6119,W,106,96,10
12238,283,6119,L,96,106,-10
12239,459,6120,L,108,111,-3
12240,460,6120,W,111,108,3
12241,203,6121,L,105,107,-2
12242,204,6121,W,107,105,2
12243,265,6122,W,107,95,12
12244,266,6122,L,95,107,-12
12245,727,6123,W,123,99,24
12246,728,6123,L,99,123,-24
12247,796,6124,W,111,76,35
12248,795,6124,L,76,111,-35
12249,15,6125,L,87,109,-22
12250,16,6125,W,109,87,22
12251,140,6126,L,83,96,-13
12252,139,6126,W,96,83,13
12253,52,6127,W,94,90,4
12254,51,6127,L,90,94,-4
12255,482,6128,L,91,100,-9
12256,481,6128,W,100,91,9
12257,765,6129,L,97,99,-2
12258,766,6129,W,99,97,2
12259,599,6130,L,94,107,-13
12260,600,6130,W,107,94,13
12261,761,6131,L,80,83,-3
12262,762,6131,W,83,80,3
12263,270,6132,L,81,99,-18
12264,269,6132,W,99,81,18
12265,82,6133,L,94,97,-3
12266,81,6133,W,97,94,3
12267,64,6134,L,122,123,-1
12268,63,6134,W,123,122,1
12269,855,6135,W,109,103,6
12270,856,6135,L,103,109,-6
12271,653,6136,L,100,105,-5
12272,654,6136,W,105,100,5
12273,348,6137,L,85,106,-21
12274,347,6137,W,106,85,21
12275,677,6138,L,104,107,-3
12276,678,6138,W,107,104,3
12277,464,6139,W,98,95,3
12278,463,6139,L,95,98,-3
12279,550,6140,W,93,92,1
12280,549,6140,L,92,93,-1
12281,789,6141,W,109,95,14
12282,790,6141,L,95,109,-14
12283,831,6142,L,100,105,-5
12284,832,6142,W,105,100,5
12285,734,6143,L,105,110,-5
12286,733,6143,W,110,105,5
12287,596,6144,W,131,123,8
12288,595,6144,L,123,131,-8
12289,628,6145,L,106,114,-8
12290,627,6145,W,114,106,8
12291,747,6146,W,85,74,11
12292,748,6146,L,74,85,-11
12293,207,6147,W,125,88,37
12294,208,6147,L,88,125,-37
12295,467,6148,W,103,101,2
12296,468,6148,L,101,103,-2
12297,506,6149,L,84,104,-20
12298,505,6149,W,104,84,20
12299,587,6150,W,111,93,18
12300,588,6150,L,93,111,-18
12301,38,6151,W,110,106,4
12302,37,6151,L,106,110,-4
12303,839,6152,W,104,97,7
12304,840,6152,L,97,104,-7
12305,251,6153,L,93,102,-9
12306,252,6153,W,102,93,9
12307,235,6154,W,119,68,51
12308,236,6154,L,68,119,-51
12309,308,6155,W,114,103,11
12310,307,6155,L,103,114,-11
12311,672,6156,L,88,90,-2
12312,671,6156,W,90,88,2
12313,121,6157,W,114,98,16
12314,122,6157,L,98,114,-16
12315,702,6158,L,91,111,-20
12316,701,6158,W,111,91,20
12317,585,6159,L,93,95,-2
12318,586,6159,W,95,93,2
12319,425,6160,L,95,98,-3
12320,426,6160,W,98,95,3
12321,525,6161,W,116,104,12
12322,526,6161,L,104,116,-12
12323,590,6162,L,101,103,-2
12324,589,6162,W,103,101,2
12325,682,6163,L,105,108,-3
12326,681,6163,W,108,105,3
12327,487,6164,W,102,96,6
12328,488,6164,L,96,102,-6
12329,448,6165,L,84,99,-15
12330,447,6165,W,99,84,15
12331,777,6166,W,108,105,3
12332,778,6166,L,105,108,-3
12333,68,6167,L,91,106,-15
12334,67,6167,W,106,91,15
12335,679,6168,W,109,103,6
12336,680,6168,L,103,109,-6
12337,613,6169,L,119,122,-3
12338,614,6169,W,122,119,3
12339,344,6170,W,112,109,3
12340,343,6170,L,109,112,-3
12341,7,6171,L,113,120,-7
12342,8,6171,W,120,113,7
12343,757,6172,L,87,100,-13
12344,758,6172,W,100,87,13
12345,419,6173,L,108,114,-6
12346,420,6173,W,114,108,6
12347,257,6174,L,106,109,-3
12348,258,6174,W,109,106,3
12349,591,6175,L,91,108,-17
12350,592,6175,W,108,91,17
12351,485,6176,L,95,102,-7
12352,486,6176,W,102,95,7
12353,259,6177,W,100,96,4
12354,260,6177,L,96,100,-4
12355,826,6178,W,114,97,17
12356,825,6178,L,97,114,-17
12357,704,6179,W,103,94,9
12358,703,6179,L,94,103,-9
12359,149,6180,W,106,105,1
12360,150,6180,L,105,106,-1
12361,109,6181,W,103,83,20
12362,110,6181,L,83,103,-20
12363,168,6182,L,95,97,-2
12364,167,6182,W,97,95,2
12365,424,6183,L,111,123,-12
12366,423,6183,W,123,111,12
12367,580,6184,W,96,86,10
12368,579,6184,L,86,96,-10
12369,695,6185,L,70,95,-25
12370,696,6185,W,95,70,25
12371,782,6186,W,103,91,12
12372,781,6186,L,91,103,-12
12373,803,6187,W,116,99,17
12374,804,6187,L,99,116,-17
12375,561,6188,L,101,108,-7
12376,562,6188,W,108,101,7
12377,814,6189,W,108,104,4
12378,813,6189,L,104,108,-4
12379,870,6190,L,90,99,-9
12380,869,6190,W,99,90,9
12381,414,6191,L,122,127,-5
12382,413,6191,W,127,122,5
12383,83,6192,L,87,99,-12
12384,84,6192,W,99,87,12
12385,368,6193,L,91,103,-12
12386,367,6193,W,103,91,12
12387,233,6194,W,113,104,9
12388,234,6194,L,104,113,-9
12389,174,6195,W,115,112,3
12390,173,6195,L,112,115,-3
12391,331,6196,W,96,93,3
12392,332,6196,L,93,96,-3
12393,551,6197,L,91,94,-3
12394,552,6197,W,94,91,3
12395,472,6198,W,97,85,12
12396,471,6198,L,85,97,-12
12397,608,6199,W,106,103,3
12398,607,6199,L,103,106,-3
12399,600,6200,L,100,106,-6
12400,599,6200,W,106,100,6
12401,583,6201,L,89,92,-3
12402,584,6201,W,92,89,3
12403,125,6202,W,105,95,10
12404,126,6202,L,95,105,-10
12405,290,6203,L,74,92,-18
12406,289,6203,W,92,74,18
12407,221,6204,L,98,112,-14
12408,222,6204,W,112,98,14
12409,17,6205,L,87,102,-15
12410,18,6205,W,102,87,15
12411,760,6206,L,105,116,-11
12412,759,6206,W,116,105,11
12413,200,6207,W,107,103,4
12414,199,6207,L,103,107,-4
12415,371,6208,W,116,111,5
12416,372,6208,L,111,116,-5
12417,364,6209,W,107,102,5
12418,363,6209,L,102,107,-5
12419,575,6210,L,83,87,-4
12420,576,6210,W,87,83,4
12421,387,6211,L,82,87,-5
12422,388,6211,W,87,82,5
12423,37,6212,L,99,107,-8
12424,38,6212,W,107,99,8
12425,532,6213,L,84,92,-8
12426,531,6213,W,92,84,8
12427,196,6214,L,91,110,-19
12428,195,6214,W,110,91,19
12429,435,6215,L,101,120,-19
12430,436,6215,W,120,101,19
12431,821,6216,L,88,90,-2
12432,822,6216,W,90,88,2
12433,267,6217,L,81,92,-11
12434,268,6217,W,92,81,11
12435,638,6218,W,84,82,2
12436,637,6218,L,82,84,-2
12437,633,6219,L,88,108,-20
12438,634,6219,W,108,88,20
12439,264,6220,L,87,101,-14
12440,263,6220,W,101,87,14
12441,46,6221,L,96,108,-12
12442,45,6221,W,108,96,12
12443,151,6222,L,114,116,-2
12444,152,6222,W,116,114,2
12445,401,6223,W,135,116,19
12446,402,6223,L,116,135,-19
12447,77,6224,W,116,101,15
12448,78,6224,L,101,116,-15
12449,155,6225,L,78,111,-33
12450,156,6225,W,111,78,33
12451,356,6226,L,87,103,-16
12452,355,6226,W,103,87,16
12453,553,6227,W,101,91,10
12454,554,6227,L,91,101,-10
12455,76,6228,L,92,104,-12
12456,75,6228,W,104,92,12
12457,104,6229,W,95,90,5
12458,103,6229,L,90,95,-5
12459,253,6230,L,90,111,-21
12460,254,6230,W,111,90,21
12461,220,6231,W,91,80,11
12462,219,6231,L,80,91,-11
12463,665,6232,W,97,78,19
12464,666,6232,L,78,97,-19
12465,138,6233,L,90,114,-24
12466,137,6233,W,114,90,24
12467,27,6234,W,120,114,6
12468,28,6234,L,114,120,-6
12469,729,6235,W,102,91,11
12470,730,6235,L,91,102,-11
12471,433,6236,W,102,93,9
12472,434,6236,L,93,102,-9
12473,536,6237,L,91,100,-9
12474,535,6237,W,100,91,9
12475,509,6238,W,129,118,11
12476,510,6238,L,118,129,-11
12477,144,6239,L,80,84,-4
12478,143,6239,W,84,80,4
12479,543,6240,L,95,99,-4
12480,544,6240,W,99,95,4
12481,688,6241,L,99,110,-11
12482,687,6241,W,110,99,11
12483,277,6242,L,83,88,-5
12484,278,6242,W,88,83,5
12485,570,6243,L,87,101,-14
12486,569,6243,W,101,87,14
12487,572,6244,L,99,103,-4
12488,571,6244,W,103,99,4
12489,842,6245,L,81,104,-23
12490,841,6245,W,104,81,23
12491,421,6246,L,77,111,-34
12492,422,6246,W,111,77,34
12493,87,6247,W,111,94,17
12494,88,6247,L,94,111,-17
12495,237,6248,W,123,106,17
12496,238,6248,L,106,123,-17
12497,815,6249,W,93,88,5
12498,816,6249,L,88,93,-5
12499,334,6250,L,96,110,-14
12500,333,6250,W,110,96,14
12501,524,6251,L,97,121,-24
12502,523,6251,W,121,97,24
12503,486,6252,L,88,109,-21
12504,485,6252,W,109,88,21
12505,751,6253,L,122,127,-5
12506,752,6253,W,127,122,5
12507,601,6254,L,84,98,-14
12508,602,6254,W,98,84,14
12509,795,6255,L,103,117,-14
12510,796,6255,W,117,103,14
12511,666,6256,L,78,95,-17
12512,665,6256,W,95,78,17
12513,52,6257,W,111,89,22
12514,51,6257,L,89,111,-22
12515,854,6258,L,95,100,-5
12516,853,6258,W,100,95,5
12517,45,6259,W,107,93,14
12518,46,6259,L,93,107,-14
12519,369,6260,W,118,105,13
12520,370,6260,L,105,118,-13
12521,776,6261,W,91,80,11
12522,775,6261,L,80,91,-11
12523,28,6262,L,116,122,-6
12524,27,6262,W,122,116,6
12525,92,6263,L,101,111,-10
12526,91,6263,W,111,101,10
12527,581,6264,L,114,117,-3
12528,582,6264,W,117,114,3
12529,110,6265,L,82,92,-10
12530,109,6265,W,92,82,10
12531,360,6266,L,86,123,-37
12532,359,6266,W,123,86,37
12533,557,6267,L,91,96,-5
12534,558,6267,W,96,91,5
12535,618,6268,W,97,95,2
12536,617,6268,L,95,97,-2
12537,493,6269,L,97,109,-12
12538,494,6269,W,109,97,12
12539,372,6270,W,107,102,5
12540,371,6270,L,102,107,-5
12541,245,6271,W,97,91,6
12542,246,6271,L,91,97,-6
12543,184,6272,L,93,102,-9
12544,183,6272,W,102,93,9
12545,91,6273,L,95,120,-25
12546,92,6273,W,120,95,25
12547,844,6274,L,88,113,-25
12548,843,6274,W,113,88,25
12549,62,6275,L,94,106,-12
12550,61,6275,W,106,94,12
12551,18,6276,L,91,102,-11
12552,17,6276,W,102,91,11
12553,434,6277,L,84,96,-12
12554,433,6277,W,96,84,12
12555,252,6278,W,102,91,11
12556,251,6278,L,91,102,-11
12557,55,6279,L,90,104,-14
12558,56,6279,W,104,90,14
12559,111,6280,W,96,86,10
12560,112,6280,L,86,96,-10
12561,330,6281,W,93,90,3
12562,329,6281,L,90,93,-3
12563,520,6282,W,114,107,7
12564,519,6282,L,107,114,-7
12565,764,6283,L,100,115,-15
12566,763,6283,W,115,100,15
12567,528,6284,L,109,116,-7
12568,527,6284,W,116,109,7
12569,276,6285,W,124,117,7
12570,275,6285,L,117,124,-7
12571,293,6286,L,89,93,-4
12572,294,6286,W,93,89,4
12573,5,6287,L,103,110,-7
12574,6,6287,W,110,103,7
12575,59,6288,L,111,116,-5
12576,60,6288,W,116,111,5
12577,849,6289,L,97,103,-6
12578,850,6289,W,103,97,6
12579,250,6290,W,112,85,27
12580,249,6290,L,85,112,-27
12581,468,6291,W,103,97,6
12582,467,6291,L,97,103,-6
12583,332,6292,L,101,104,-3
12584,331,6292,W,104,101,3
12585,219,6293,L,98,109,-11
12586,220,6293,W,109,98,11
12587,746,6294,W,106,102,4
12588,745,6294,L,102,106,-4
12589,74,6295,L,103,108,-5
12590,73,6295,W,108,103,5
12591,175,6296,L,86,115,-29
12592,176,6296,W,115,86,29
12593,430,6297,L,94,102,-8
12594,429,6297,W,102,94,8
12595,21,6298,L,88,90,-2
12596,22,6298,W,90,88,2
12597,71,6299,L,99,104,-5
12598,72,6299,W,104,99,5
12599,343,6300,L,110,115,-5
12600,344,6300,W,115,110,5
12601,603,6301,W,115,98,17
12602,604,6301,L,98,115,-17
12603,431,6302,W,103,91,12
12604,432,6302,L,91,103,-12
12605,668,6303,W,92,86,6
12606,667,6303,L,86,92,-6
12607,504,6304,L,101,120,-19
12608,503,6304,W,120,101,19
12609,75,6305,L,95,96,-1
12610,76,6305,W,96,95,1
12611,406,6306,W,111,95,16
12612,405,6306,L,95,111,-16
12613,534,6307,L,80,93,-13
12614,533,6307,W,93,80,13
12615,207,6308,L,114,122,-8
12616,208,6308,W,122,114,8
12617,675,6309,L,87,95,-8
12618,676,6309,W,95,87,8
12619,701,6310,L,85,97,-12
12620,702,6310,W,97,85,12
12621,305,6311,L,101,107,-6
12622,306,6311,W,107,101,6
12623,656,6312,L,94,106,-12
12624,655,6312,W,106,94,12
12625,300,6313,W,100,85,15
12626,299,6313,L,85,100,-15
12627,743,6314,W,97,96,1
12628,744,6314,L,96,97,-1
12629,686,6315,W,114,106,8
12630,685,6315,L,106,114,-8
12631,122,6316,L,99,107,-8
12632,121,6316,W,107,99,8
12633,236,6317,L,83,92,-9
12634,235,6317,W,92,83,9
12635,519,6318,L,81,105,-24
12636,520,6318,W,105,81,24
12637,260,6319,W,110,98,12
12638,259,6319,L,98,110,-12
12639,763,6320,L,105,108,-3
12640,764,6320,W,108,105,3
12641,57,6321,L,99,108,-9
12642,58,6321,W,108,99,9
12643,715,6322,L,96,101,-5
12644,716,6322,W,101,96,5
12645,523,6323,L,93,106,-13
12646,524,6323,W,106,93,13
12647,113,6324,L,81,100,-19
12648,114,6324,W,100,81,19
12649,487,6325,L,97,102,-5
12650,488,6325,W,102,97,5
12651,146,6326,L,100,101,-1
12652,145,6326,W,101,100,1
12653,30,6327,W,90,84,6
12654,29,6327,L,84,90,-6
12655,703,6328,L,93,102,-9
12656,704,6328,W,102,93,9
12657,49,6329,L,98,107,-9
12658,50,6329,W,107,98,9
12659,635,6330,L,103,107,-4
12660,636,6330,W,107,103,4
12661,206,6331,L,109,111,-2
12662,205,6331,W,111,109,2
12663,94,6332,L,82,90,-8
12664,93,6332,W,90,82,8
12665,692,6333,L,85,102,-17
12666,691,6333,W,102,85,17
12667,498,6334,L,91,92,-1
12668,497,6334,W,92,91,1
12669,224,6335,L,104,118,-14
12670,223,6335,W,118,104,14
12671,713,6336,W,129,116,13
12672,714,6336,L,116,129,-13
12673,429,6337,L,93,95,-2
12674,430,6337,W,95,93,2
12675,42,6338,W,102,91,11
12676,41,6338,L,91,102,-11
12677,533,6339,W,113,101,12
12678,534,6339,L,101,113,-12
12679,389,6340,L,92,101,-9
12680,390,6340,W,101,92,9
12681,733,6341,W,106,98,8
12682,734,6341,L,98,106,-8
12683,866,6342,L,98,106,-8
12684,865,6342,W,106,98,8
12685,663,6343,W,100,84,16
12686,664,6343,L,84,100,-16
12687,646,6344,L,99,101,-2
12688,645,6344,W,101,99,2
12689,39,6345,W,119,103,16
12690,40,6345,L,103,119,-16
12691,66,6346,L,108,118,-10
12692,65,6346,W,118,108,10
12693,289,6347,L,102,103,-1
12694,290,6347,W,103,102,1
12695,123,6348,L,88,101,-13
12696,124,6348,W,101,88,13
12697,358,6349,L,105,120,-15
12698,357,6349,W,120,105,15
12699,13,6350,W,111,109,2
12700,14,6350,L,109,111,-2
12701,188,6351,W,125,101,24
12702,187,6351,L,101,125,-24
12703,100,6352,W,99,83,16
12704,99,6352,L,83,99,-16
12705,375,6353,L,114,118,-4
12706,376,6353,W,118,114,4
12707,495,6354,W,104,95,9
12708,496,6354,L,95,104,-9
12709,262,6355,W,106,88,18
12710,261,6355,L,88,106,-18
12711,225,6356,L,84,97,-13
12712,226,6356,W,97,84,13
12713,34,6357,L,95,109,-14
12714,33,6357,W,109,95,14
12715,513,6358,W,111,88,23
12716,514,6358,L,88,111,-23
12717,209,6359,L,104,108,-4
12718,210,6359,W,108,104,4
12719,443,6360,L,92,94,-2
12720,444,6360,W,94,92,2
12721,544,6361,W,117,107,10
12722,543,6361,L,107,117,-10
12723,451,6362,W,120,103,17
12724,452,6362,L,103,120,-17
12725,609,6363,L,95,99,-4
12726,610,6363,W,99,95,4
12727,182,6364,L,103,124,-21
12728,181,6364,W,124,103,21
12729,12,6365,L,97,101,-4
12730,11,6365,W,101,97,4
12731,231,6366,L,76,96,-20
12732,232,6366,W,96,76,20
12733,4,6367,W,105,97,8
12734,3,6367,L,97,105,-8
12735,436,6368,W,103,94,9
12736,435,6368,L,94,103,-9
12737,215,6369,L,79,89,-10
12738,216,6369,W,89,79,10
12739,346,6370,W,109,105,4
12740,345,6370,L,105,109,-4
12741,326,6371,L,99,114,-15
12742,325,6371,W,114,99,15
12743,357,6372,L,98,107,-9
12744,358,6372,W,107,98,9
12745,227,6373,L,86,94,-8
12746,228,6373,W,94,86,8
12747,366,6374,L,94,114,-20
12748,365,6374,W,114,94,20
12749,350,6375,W,102,93,9
12750,349,6375,L,93,102,-9
12751,8,6376,W,116,110,6
12752,7,6376,L,110,116,-6
12753,286,6377,W,104,98,6
12754,285,6377,L,98,104,-6
12755,67,6378,W,99,92,7
12756,68,6378,L,92,99,-7
12757,370,6379,L,104,119,-15
12758,369,6379,W,119,104,15
12759,865,6380,W,121,115,6
12760,866,6380,L,115,121,-6
12761,413,6381,W,100,92,8
12762,414,6381,L,92,100,-8
12763,140,6382,L,87,90,-3
12764,139,6382,W,90,87,3
12765,155,6383,L,98,118,-20
12766,156,6383,W,118,98,20
12767,213,6384,L,87,92,-5
12768,214,6384,W,92,87,5
12769,69,6385,L,102,108,-6
12770,70,6385,W,108,102,6
12771,441,6386,L,98,104,-6
12772,442,6386,W,104,98,6
12773,19,6387,W,108,94,14
12774,20,6387,L,94,108,-14
12775,135,6388,W,96,84,12
12776,136,6388,L,84,96,-12
12777,432,6389,W,96,84,12
12778,431,6389,L,84,96,-12
12779,145,6390,L,96,115,-19
12780,146,6390,W,115,96,19
12781,465,6391,L,87,91,-4
12782,466,6391,W,91,87,4
12783,22,6392,L,87,101,-14
12784,21,6392,W,101,87,14
12785,41,6393,L,98,100,-2
12786,42,6393,W,100,98,2
12787,98,6394,W,108,92,16
12788,97,6394,L,92,108,-16
12789,29,6395,L,86,96,-10
12790,30,6395,W,96,86,10
12791,643,6396,W,103,98,5
12792,644,6396,L,98,103,-5
12793,835,6397,L,99,102,-3
12794,836,6397,W,102,99,3
12795,313,6398,L,114,119,-5
12796,314,6398,W,119,114,5
12797,275,6399,L,108,112,-4
12798,276,6399,W,112,108,4
12799,54,6400,L,97,118,-21
12800,53,6400,W,118,97,21
12801,740,6401,W,102,91,11
12802,739,6401,L,91,102,-11
12803,408,6402,W,103,89,14
12804,407,6402,L,89,103,-14
12805,154,6403,W,103,94,9
12806,153,6403,L,94,103,-9
12807,480,6404,W,98,92,6
12808,479,6404,L,92,98,-6
12809,791,6405,W,94,82,12
12810,792,6405,L,82,94,-12
12811,488,6406,L,105,130,-25
12812,487,6406,W,130,105,25
12813,127,6407,W,120,109,11
12814,128,6407,L,109,120,-11
12815,679,6408,W,106,101,5
12816,680,6408,L,101,106,-5
12817,133,6409,L,105,110,-5
12818,134,6409,W,110,105,5
12819,70,6410,W,107,100,7
12820,69,6410,L,100,107,-7
12821,829,6411,W,94,84,10
12822,830,6411,L,84,94,-10
12823,228,6412,W,103,96,7
12824,227,6412,L,96,103,-7
12825,223,6413,L,96,102,-6
12826,224,6413,W,102,96,6
12827,664,6414,L,69,119,-50
12828,663,6414,W,119,69,50
12829,292,6415,W,94,92,2
12830,291,6415,L,92,94,-2
12831,239,6416,L,93,117,-24
12832,240,6416,W,117,93,24
12833,820,6417,L,89,109,-20
12834,819,6417,W,109,89,20
12835,681,6418,W,95,87,8
12836,682,6418,L,87,95,-8
12837,186,6419,L,87,106,-19
12838,185,6419,W,106,87,19
12839,738,6420,L,87,92,-5
12840,737,6420,W,92,87,5
12841,93,6421,W,103,93,10
12842,94,6421,L,93,103,-10
12843,614,6422,W,97,76,21
12844,613,6422,L,76,97,-21
12845,469,6423,L,109,114,-5
12846,470,6423,W,114,109,5
12847,279,6424,W,117,110,7
12848,280,6424,L,110,117,-7
12849,283,6425,W,101,90,11
12850,284,6425,L,90,101,-11
12851,48,6426,L,91,101,-10
12852,47,6426,W,101,91,10
12853,450,6427,W,134,120,14
12854,449,6427,L,120,134,-14
12855,291,6428,L,94,97,-3
12856,292,6428,W,97,94,3
12857,484,6429,W,112,92,20
12858,483,6429,L,92,112,-20
12859,160,6430,L,114,132,-18
12860,159,6430,W,132,114,18
12861,284,6431,L,92,110,-18
12862,283,6431,W,110,92,18
12863,132,6432,W,113,103,10
12864,131,6432,L,103,113,-10
12865,447,6433,L,92,102,-10
12866,448,6433,W,102,92,10
12867,36,6434,W,139,136,3
12868,35,6434,L,136,139,-3
12869,805,6435,W,99,71,28
12870,806,6435,L,71,99,-28
12871,459,6436,W,95,78,17
12872,460,6436,L,78,95,-17
12873,328,6437,L,75,102,-27
12874,327,6437,W,102,75,27
12875,669,6438,L,94,98,-4
12876,670,6438,W,98,94,4
12877,176,6439,W,118,113,5
12878,175,6439,L,113,118,-5
12879,272,6440,W,112,101,11
12880,271,6440,L,101,112,-11
12881,65,6441,L,88,104,-16
12882,66,6441,W,104,88,16
12883,810,6442,W,112,103,9
12884,809,6442,L,103,112,-9
12885,631,6443,W,106,76,30
12886,632,6443,L,76,106,-30
12887,470,6444,W,111,104,7
12888,469,6444,L,104,111,-7
12889,297,6445,W,115,100,15
12890,298,6445,L,100,115,-15
12891,475,6446,L,94,112,-18
12892,476,6446,W,112,94,18
12893,68,6447,W,122,97,25
12894,67,6447,L,97,122,-25
12895,50,6448,W,105,85,20
12896,49,6448,L,85,105,-20
12897,321,6449,L,87,92,-5
12898,322,6449,W,92,87,5
12899,457,6450,L,106,112,-6
12900,458,6450,W,112,106,6
12901,144,6451,L,95,112,-17
12902,143,6451,W,112,95,17
12903,63,6452,W,112,111,1
12904,64,6452,L,111,112,-1
12905,58,6453,W,88,87,1
12906,57,6453,L,87,88,-1
12907,117,6454,W,111,95,16
12908,118,6454,L,95,111,-16
12909,269,6455,L,94,104,-10
12910,270,6455,W,104,94,10
12911,453,6456,L,99,106,-7
12912,454,6456,W,106,99,7
12913,43,6457,W,106,94,12
12914,44,6457,L,94,106,-12
12915,273,6458,L,95,97,-2
12916,274,6458,W,97,95,2
12917,449,6459,L,95,111,-16
12918,450,6459,W,111,95,16
12919,563,6460,W,105,97,8
12920,564,6460,L,97,105,-8
12921,564,6461,L,91,104,-13
12922,563,6461,W,104,91,13
12923,563,6462,W,103,82,21
12924,564,6462,L,82,103,-21
12925,563,6463,L,91,96,-5
12926,564,6463,W,96,91,5
12927,564,6464,W,95,93,2
12928,563,6464,L,93,95,-2
12929,564,6465,L,100,108,-8
12930,563,6465,W,108,100,8
12931,483,6466,L,90,104,-14
12932,484,6466,W,104,90,14
12933,493,6467,L,88,118,-30
12934,494,6467,W,118,88,30
12935,484,6468,L,115,128,-13
12936,483,6468,W,128,115,13
12937,493,6469,L,111,114,-3
12938,494,6469,W,114,111,3
12939,484,6470,W,115,80,35
12940,483,6470,L,80,115,-35
12941,494,6471,W,94,82,12
12942,493,6471,L,82,94,-12
12943,483,6472,L,98,99,-1
12944,484,6472,W,99,98,1
12945,494,6473,W,97,89,8
12946,493,6473,L,89,97,-8
12947,483,6474,L,106,110,-4
12948,484,6474,W,110,106,4
12949,345,6475,L,100,113,-13
12950,346,6475,W,113,100,13
12951,325,6476,W,94,91,3
12952,326,6476,L,91,94,-3
12953,663,6477,W,108,95,13
12954,664,6477,L,95,108,-13
12955,346,6478,W,119,107,12
12956,345,6478,L,107,119,-12
12957,273,6479,W,94,73,21
12958,274,6479,L,73,94,-21
12959,664,6480,L,78,98,-20
12960,663,6480,W,98,78,20
12961,326,6481,L,81,82,-1
12962,325,6481,W,82,81,1
12963,345,6482,L,103,124,-21
12964,346,6482,W,124,103,21
12965,274,6483,L,101,106,-5
12966,273,6483,W,106,101,5
12967,325,6484,W,106,101,5
12968,326,6484,L,101,106,-5
12969,663,6485,W,101,84,17
12970,664,6485,L,84,101,-17
12971,346,6486,L,95,128,-33
12972,345,6486,W,128,95,33
12973,273,6487,W,86,84,2
12974,274,6487,L,84,86,-2
12975,325,6488,L,101,103,-2
12976,326,6488,W,103,101,2
12977,663,6489,L,89,99,-10
12978,664,6489,W,99,89,10
12979,273,6490,L,96,99,-3
12980,274,6490,W,99,96,3
12981,346,6491,L,99,124,-25
12982,345,6491,W,124,99,25
12983,345,6492,L,109,115,-6
12984,346,6492,W,115,109,6
12985,274,6493,L,91,106,-15
12986,273,6493,W,106,91,15
12987,664,6494,W,97,90,7
12988,663,6494,L,90,97,-7
12989,326,6495,L,90,106,-16
12990,325,6495,W,106,90,16
12991,274,6496,W,99,92,7
12992,273,6496,L,92,99,-7
12993,345,6497,W,117,101,16
12994,346,6497,L,101,117,-16
12995,664,6498,L,86,101,-15
12996,663,6498,W,101,86,15
12997,326,6499,W,104,98,6
12998,325,6499,L,98,104,-6
12999,547,6500,L,109,111,-2
13000,548,6500,W,111,109,2
13001,21,6501,W,111,87,24
13002,22,6501,L,87,111,-24
13003,615,6502,W,120,66,54
13004,616,6502,L,66,120,-54
13005,548,6503,W,102,96,6
13006,547,6503,L,96,102,-6
13007,22,6504,L,97,107,-10
13008,21,6504,W,107,97,10
13009,146,6505,L,93,99,-6
13010,145,6505,W,99,93,6
13011,260,6506,L,94,103,-9
13012,259,6506,W,103,94,9
13013,547,6507,W,111,107,4
13014,548,6507,L,107,111,-4
13015,145,6508,L,92,99,-7
13016,146,6508,W,99,92,7
13017,21,6509,L,115,120,-5
13018,22,6509,W,120,115,5
13019,616,6510,W,94,88,6
13020,615,6510,L,88,94,-6
13021,259,6511,L,109,121,-12
13022,260,6511,W,121,109,12
13023,638,6512,L,94,125,-31
13024,637,6512,W,125,94,31
13025,548,6513,W,114,105,9
13026,547,6513,L,105,114,-9
13027,354,6514,W,101,93,8
13028,353,6514,L,93,101,-8
13029,450,6515,W,109,98,11
13030,449,6515,L,98,109,-11
13031,615,6516,L,90,92,-2
13032,616,6516,W,92,90,2
13033,21,6517,L,83,91,-8
13034,22,6517,W,91,83,8
13035,145,6518,W,115,109,6
13036,146,6518,L,109,115,-6
13037,638,6519,L,99,106,-7
13038,637,6519,W,106,99,7
13039,259,6520,W,130,128,2
13040,260,6520,L,128,130,-2
13041,548,6521,L,73,100,-27
13042,547,6521,W,100,73,27
13043,450,6522,W,123,119,4
13044,449,6522,L,119,123,-4
13045,354,6523,W,103,95,8
13046,353,6523,L,95,103,-8
13047,615,6524,W,113,106,7
13048,616,6524,L,106,113,-7
13049,547,6525,W,111,107,4
13050,548,6525,L,107,111,-4
13051,146,6526,L,82,97,-15
13052,145,6526,W,97,82,15
13053,22,6527,L,91,96,-5
13054,21,6527,W,96,91,5
13055,637,6528,W,117,106,11
13056,638,6528,L,106,117,-11
13057,260,6529,L,99,111,-12
13058,259,6529,W,111,99,12
13059,353,6530,L,91,99,-8
13060,354,6530,W,99,91,8
13061,449,6531,L,87,97,-10
13062,450,6531,W,97,87,10
13063,616,6532,L,82,91,-9
13064,615,6532,W,91,82,9
13065,22,6533,L,92,99,-7
13066,21,6533,W,99,92,7
13067,547,6534,L,92,107,-15
13068,548,6534,W,107,92,15
13069,353,6535,L,100,113,-13
13070,354,6535,W,113,100,13
13071,146,6536,L,86,100,-14
13072,145,6536,W,100,86,14
13073,260,6537,L,108,118,-10
13074,259,6537,W,118,108,10
13075,637,6538,W,93,86,7
13076,638,6538,L,86,93,-7
13077,449,6539,L,99,106,-7
13078,450,6539,W,106,99,7
13079,616,6540,L,91,103,-12
13080,615,6540,W,103,91,12
13081,159,6541,W,122,99,23
13082,160,6541,L,99,122,-23
13083,370,6542,L,126,133,-7
13084,369,6542,W,133,126,7
13085,462,6543,L,91,117,-26
13086,461,6543,W,117,91,26
13087,593,6544,W,138,113,25
13088,594,6544,L,113,138,-25
13089,100,6545,W,105,100,5
13090,99,6545,L,100,105,-5
13091,558,6546,W,105,101,4
13092,557,6546,L,101,105,-4
13093,415,6547,L,87,92,-5
13094,416,6547,W,92,87,5
13095,101,6548,L,85,91,-6
13096,102,6548,W,91,85,6
13097,295,6549,W,112,90,22
13098,296,6549,L,90,112,-22
13099,472,6550,L,108,113,-5
13100,471,6550,W,113,108,5
13101,173,6551,L,98,114,-16
13102,174,6551,W,114,98,16
13103,55,6552,L,103,108,-5
13104,56,6552,W,108,103,5
13105,809,6553,L,83,95,-12
13106,810,6553,W,95,83,12
13107,180,6554,L,88,101,-13
13108,179,6554,W,101,88,13
13109,238,6555,L,95,99,-4
13110,237,6555,W,99,95,4
13111,132,6556,L,93,95,-2
13112,131,6556,W,95,93,2
13113,224,6557,W,112,101,11
13114,223,6557,L,101,112,-11
13115,317,6558,W,100,90,10
13116,318,6558,L,90,100,-10
13117,160,6559,L,92,102,-10
13118,159,6559,W,102,92,10
13119,271,6560,W,112,108,4
13120,272,6560,L,108,112,-4
13121,303,6561,W,100,88,12
13122,304,6561,L,88,100,-12
13123,664,6562,L,107,111,-4
13124,663,6562,W,111,107,4
13125,629,6563,L,90,101,-11
13126,630,6563,W,101,90,11
13127,466,6564,W,107,97,10
13128,465,6564,L,97,107,-10
13129,183,6565,L,92,109,-17
13130,184,6565,W,109,92,17
13131,116,6566,L,93,100,-7
13132,115,6566,W,100,93,7
13133,297,6567,W,113,86,27
13134,298,6567,L,86,113,-27
13135,72,6568,L,97,109,-12
13136,71,6568,W,109,97,12
13137,88,6569,L,103,110,-7
13138,87,6569,W,110,103,7
13139,561,6570,L,114,121,-7
13140,562,6570,W,121,114,7
13141,802,6571,L,104,116,-12
13142,801,6571,W,116,104,12
13143,354,6572,L,78,117,-39
13144,353,6572,W,117,78,39
13145,227,6573,L,73,96,-23
13146,228,6573,W,96,73,23
13147,93,6574,W,120,106,14
13148,94,6574,L,106,120,-14
13149,505,6575,L,77,116,-39
13150,506,6575,W,116,77,39
13151,601,6576,L,91,107,-16
13152,602,6576,W,107,91,16
13153,325,6577,L,99,108,-9
13154,326,6577,W,108,99,9
13155,32,6578,L,111,122,-11
13156,31,6578,W,122,111,11
13157,536,6579,W,80,79,1
13158,535,6579,L,79,80,-1
13159,443,6580,L,86,94,-8
13160,444,6580,W,94,86,8
13161,97,6581,W,111,105,6
13162,98,6581,L,105,111,-6
13163,514,6582,L,107,114,-7
13164,513,6582,W,114,107,7
13165,714,6583,L,101,110,-9
13166,713,6583,W,110,101,9
13167,231,6584,W,107,104,3
13168,232,6584,L,104,107,-3
13169,170,6585,W,104,103,1
13170,169,6585,L,103,104,-1
13171,215,6586,W,89,88,1
13172,216,6586,L,88,89,-1
13173,243,6587,L,80,117,-37
13174,244,6587,W,117,80,37
13175,28,6588,L,75,90,-15
13176,27,6588,W,90,75,15
13177,67,6589,W,99,91,8
13178,68,6589,L,91,99,-8
13179,291,6590,L,80,104,-24
13180,292,6590,W,104,80,24
13181,63,6591,L,98,106,-8
13182,64,6591,W,106,98,8
13183,268,6592,W,144,143,1
13184,267,6592,L,143,144,-1
13185,791,6593,W,107,103,4
13186,792,6593,L,103,107,-4
13187,353,6594,W,99,90,9
13188,354,6594,L,90,99,-9
13189,425,6595,L,103,116,-13
13190,426,6595,W,116,103,13
13191,213,6596,W,101,99,2
13192,214,6596,L,99,101,-2
13193,787,6597,W,89,78,11
13194,788,6597,L,78,89,-11
13195,612,6598,L,105,116,-11
13196,611,6598,W,116,105,11
13197,169,6599,L,98,110,-12
13198,170,6599,W,110,98,12
13199,128,6600,L,101,119,-18
13200,127,6600,W,119,101,18
13201,737,6601,L,103,105,-2
13202,738,6601,W,105,103,2
13203,680,6602,L,91,116,-25
13204,679,6602,W,116,91,25
13205,118,6603,L,104,107,-3
13206,117,6603,W,107,104,3
13207,642,6604,W,113,103,10
13208,641,6604,L,103,113,-10
13209,234,6605,L,74,110,-36
13210,233,6605,W,110,74,36
13211,105,6606,W,119,90,29
13212,106,6606,L,90,119,-29
13213,108,6607,W,102,86,16
13214,107,6607,L,86,102,-16
13215,763,6608,W,104,99,5
13216,764,6608,L,99,104,-5
13217,627,6609,L,91,103,-12
13218,628,6609,W,103,91,12
13219,21,6610,W,114,111,3
13220,22,6610,L,111,114,-3
13221,416,6611,W,92,74,18
13222,415,6611,L,74,92,-18
13223,553,6612,L,111,116,-5
13224,554,6612,W,116,111,5
13225,649,6613,L,69,96,-27
13226,650,6613,W,96,69,27
13227,457,6614,W,113,88,25
13228,458,6614,L,88,113,-25
13229,269,6615,L,100,105,-5
13230,270,6615,W,105,100,5
13231,120,6616,L,100,105,-5
13232,119,6616,W,105,100,5
13233,450,6617,L,100,103,-3
13234,449,6617,W,103,100,3
13235,163,6618,L,96,106,-10
13236,164,6618,W,106,96,10
13237,274,6619,L,94,99,-5
13238,273,6619,W,99,94,5
13239,119,6620,W,106,78,28
13240,120,6620,L,78,106,-28
13241,134,6621,W,115,112,3
13242,133,6621,L,112,115,-3
13243,140,6622,L,89,112,-23
13244,139,6622,W,112,89,23
13245,83,6623,L,91,101,-10
13246,84,6623,W,101,91,10
13247,721,6624,L,92,107,-15
13248,722,6624,W,107,92,15
13249,628,6625,W,101,95,6
13250,627,6625,L,95,101,-6
13251,516,6626,W,92,83,9
13252,515,6626,L,83,92,-9
13253,475,6627,L,90,99,-9
13254,476,6627,W,99,90,9
13255,22,6628,L,99,131,-32
13256,21,6628,W,131,99,32
13257,652,6629,W,123,110,13
13258,651,6629,L,110,123,-13
13259,2,6630,L,85,87,-2
13260,1,6630,W,87,85,2
13261,137,6631,W,97,90,7
13262,138,6631,L,90,97,-7
13263,844,6632,L,91,92,-1
13264,843,6632,W,92,91,1
13265,87,6633,W,107,92,15
13266,88,6633,L,92,107,-15
13267,131,6634,W,117,116,1
13268,132,6634,L,116,117,-1
13269,842,6635,L,98,99,-1
13270,841,6635,W,99,98,1
13271,207,6636,L,92,100,-8
13272,208,6636,W,100,92,8
13273,219,6637,L,93,123,-30
13274,220,6637,W,123,93,30
13275,99,6638,W,110,101,9
13276,100,6638,L,101,110,-9
13277,670,6639,L,82,88,-6
13278,669,6639,W,88,82,6
13279,279,6640,L,87,101,-14
13280,280,6640,W,101,87,14
13281,45,6641,W,107,77,30
13282,46,6641,L,77,107,-30
13283,437,6642,L,74,93,-19
13284,438,6642,W,93,74,19
13285,141,6643,L,109,114,-5
13286,142,6643,W,114,109,5
13287,331,6644,W,97,84,13
13288,332,6644,L,84,97,-13
13289,177,6645,W,101,95,6
13290,178,6645,L,95,101,-6
13291,402,6646,L,106,107,-1
13292,401,6646,W,107,106,1
13293,447,6647,L,88,114,-26
13294,448,6647,W,114,88,26
13295,259,6648,W,108,101,7
13296,260,6648,L,101,108,-7
13297,591,6649,W,100,98,2
13298,592,6649,L,98,100,-2
13299,7,6650,L,111,115,-4
13300,8,6650,W,115,111,4
13301,506,6651,L,78,102,-24
13302,505,6651,W,102,78,24
13303,106,6652,L,93,106,-13
13304,105,6652,W,106,93,13
13305,394,6653,W,103,91,12
13306,393,6653,L,91,103,-12
13307,42,6654,L,87,100,-13
13308,41,6654,W,100,87,13
13309,508,6655,W,113,99,14
13310,507,6655,L,99,113,-14
13311,18,6656,W,126,122,4
13312,17,6656,L,122,126,-4
13313,615,6657,L,91,95,-4
13314,616,6657,W,95,91,4
13315,384,6658,W,113,92,21
13316,383,6658,L,92,113,-21
13317,581,6659,W,135,131,4
13318,582,6659,L,131,135,-4
13319,136,6660,L,84,98,-14
13320,135,6660,W,98,84,14
13321,276,6661,W,110,106,4
13322,275,6661,L,106,110,-4
13323,44,6662,L,95,105,-10
13324,43,6662,W,105,95,10
13325,620,6663,W,95,81,14
13326,619,6663,L,81,95,-14
13327,502,6664,L,106,111,-5
13328,501,6664,W,111,106,5
13329,283,6665,L,86,109,-23
13330,284,6665,W,109,86,23
13331,80,6666,W,104,84,20
13332,79,6666,L,84,104,-20
13333,723,6667,W,116,104,12
13334,724,6667,L,104,116,-12
13335,735,6668,L,88,101,-13
13336,736,6668,W,101,88,13
13337,407,6669,L,83,97,-14
13338,408,6669,W,97,83,14
13339,797,6670,L,96,99,-3
13340,798,6670,W,99,96,3
13341,368,6671,W,113,111,2
13342,367,6671,L,111,113,-2
13343,69,6672,L,86,87,-1
13344,70,6672,W,87,86,1
13345,304,6673,L,88,110,-22
13346,303,6673,W,110,88,22
13347,286,6674,L,99,107,-8
13348,285,6674,W,107,99,8
13349,841,6675,L,102,109,-7
13350,842,6675,W,109,102,7
13351,181,6676,W,109,97,12
13352,182,6676,L,97,109,-12
13353,312,6677,L,99,104,-5
13354,311,6677,W,104,99,5
13355,855,6678,W,99,91,8
13356,856,6678,L,91,99,-8
13357,110,6679,L,89,103,-14
13358,109,6679,W,103,89,14
13359,489,6680,W,119,106,13
13360,490,6680,L,106,119,-13
13361,400,6681,L,80,111,-31
13362,399,6681,W,111,80,31
13363,95,6682,W,108,95,13
13364,96,6682,L,95,108,-13
13365,52,6683,L,89,94,-5
13366,51,6683,W,94,89,5
13367,292,6684,L,100,115,-15
13368,291,6684,W,115,100,15
13369,210,6685,L,114,120,-6
13370,209,6685,W,120,114,6
13371,822,6686,L,98,106,-8
13372,821,6686,W,106,98,8
13373,392,6687,W,119,98,21
13374,391,6687,L,98,119,-21
13375,491,6688,W,111,97,14
13376,492,6688,L,97,111,-14
13377,135,6689,L,91,107,-16
13378,136,6689,W,107,91,16
13379,663,6690,W,107,84,23
13380,664,6690,L,84,107,-23
13381,178,6691,L,88,102,-14
13382,177,6691,W,102,88,14
13383,251,6692,L,83,94,-11
13384,252,6692,W,94,83,11
13385,277,6693,L,76,94,-18
13386,278,6693,W,94,76,18
13387,479,6694,L,86,99,-13
13388,480,6694,W,99,86,13
13389,287,6695,L,110,120,-10
13390,288,6695,W,120,110,10
13391,569,6696,L,107,110,-3
13392,570,6696,W,110,107,3
13393,284,6697,W,87,81,6
13394,283,6697,L,81,87,-6
13395,811,6698,W,96,92,4
13396,812,6698,L,92,96,-4
13397,359,6699,L,107,111,-4
13398,360,6699,W,111,107,4
13399,59,6700,W,91,88,3
13400,60,6700,L,88,91,-3
13401,237,6701,W,103,101,2
13402,238,6701,L,101,103,-2
13403,562,6702,W,95,93,2
13404,561,6702,L,93,95,-2
13405,559,6703,W,116,103,13
13406,560,6703,L,103,116,-13
13407,54,6704,W,108,99,9
13408,53,6704,L,99,108,-9
13409,98,6705,W,92,89,3
13410,97,6705,L,89,92,-3
13411,778,6706,W,99,85,14
13412,777,6706,L,85,99,-14
13413,458,6707,L,91,130,-39
13414,457,6707,W,130,91,39
13415,428,6708,W,95,83,12
13416,427,6708,L,83,95,-12
13417,126,6709,W,93,86,7
13418,125,6709,L,86,93,-7
13419,631,6710,W,111,89,22
13420,632,6710,L,89,111,-22
13421,698,6711,W,111,80,31
13422,697,6711,L,80,111,-31
13423,64,6712,W,101,99,2
13424,63,6712,L,99,101,-2
13425,565,6713,L,104,108,-4
13426,566,6713,W,108,104,4
13427,341,6714,L,106,107,-1
13428,342,6714,W,107,106,1
13429,278,6715,L,94,101,-7
13430,277,6715,W,101,94,7
13431,218,6716,L,117,127,-10
13432,217,6716,W,127,117,10
13433,611,6717,W,122,108,14
13434,612,6717,L,108,122,-14
13435,26,6718,L,88,89,-1
13436,25,6718,W,89,88,1
13437,166,6719,W,110,100,10
13438,165,6719,L,100,110,-10
13439,573,6720,W,103,82,21
13440,574,6720,L,82,103,-21
13441,92,6721,W,110,91,19
13442,91,6721,L,91,110,-19
13443,487,6722,L,86,98,-12
13444,488,6722,W,98,86,12
13445,79,6723,W,106,104,2
13446,80,6723,L,104,106,-2
13447,385,6724,L,76,107,-31
13448,386,6724,W,107,76,31
13449,117,6725,L,92,98,-6
13450,118,6725,W,98,92,6
13451,253,6726,L,100,107,-7
13452,254,6726,W,107,100,7
13453,367,6727,L,87,101,-14
13454,368,6727,W,101,87,14
13455,634,6728,W,114,95,19
13456,633,6728,L,95,114,-19
13457,641,6729,W,105,97,8
13458,642,6729,L,97,105,-8
13459,13,6730,L,89,106,-17
13460,14,6730,W,106,89,17
13461,748,6731,W,119,100,19
13462,747,6731,L,100,119,-19
13463,361,6732,L,86,109,-23
13464,362,6732,W,109,86,23
13465,167,6733,L,75,93,-18
13466,168,6733,W,93,75,18
13467,763,6734,W,108,90,18
13468,764,6734,L,90,108,-18
13469,495,6735,W,109,98,11
13470,496,6735,L,98,109,-11
13471,146,6736,L,86,97,-11
13472,145,6736,W,97,86,11
13473,607,6737,L,91,106,-15
13474,608,6737,W,106,91,15
13475,501,6738,W,123,111,12
13476,502,6738,L,111,123,-12
13477,530,6739,W,117,102,15
13478,529,6739,L,102,117,-15
13479,669,6740,L,91,107,-16
13480,670,6740,W,107,91,16
13481,256,6741,L,91,108,-17
13482,255,6741,W,108,91,17
13483,373,6742,L,104,111,-7
13484,374,6742,W,111,104,7
13485,12,6743,L,92,95,-3
13486,11,6743,W,95,92,3
13487,84,6744,L,81,97,-16
13488,83,6744,W,97,81,16
13489,784,6745,L,99,113,-14
13490,783,6745,W,113,99,14
13491,560,6746,L,92,108,-16
13492,559,6746,W,108,92,16
13493,752,6747,L,91,101,-10
13494,751,6747,W,101,91,10
13495,228,6748,L,127,129,-2
13496,227,6748,W,129,127,2
13497,333,6749,W,112,101,11
13498,334,6749,L,101,112,-11
13499,449,6750,L,96,112,-16
13500,450,6750,W,112,96,16
13501,682,6751,L,89,101,-12
13502,681,6751,W,101,89,12
13503,599,6752,L,115,123,-8
13504,600,6752,W,123,115,8
13505,27,6753,L,72,74,-2
13506,28,6753,W,74,72,2
13507,50,6754,L,108,118,-10
13508,49,6754,W,118,108,10
13509,868,6755,W,95,92,3
13510,867,6755,L,92,95,-3
13511,230,6756,W,80,73,7
13512,229,6756,L,73,80,-7
13513,474,6757,L,102,107,-5
13514,473,6757,W,107,102,5
13515,470,6758,W,116,105,11
13516,469,6758,L,105,116,-11
13517,808,6759,L,95,114,-19
13518,807,6759,W,114,95,19
13519,409,6760,W,88,84,4
13520,410,6760,L,84,88,-4
13521,512,6761,L,104,108,-4
13522,511,6761,W,108,104,4
13523,696,6762,W,114,103,11
13524,695,6762,L,103,114,-11
13525,821,6763,L,92,117,-25
13526,822,6763,W,117,92,25
13527,75,6764,L,86,103,-17
13528,76,6764,W,103,86,17
13529,300,6765,L,118,122,-4
13530,299,6765,W,122,118,4
13531,265,6766,L,83,94,-11
13532,266,6766,W,94,83,11
13533,507,6767,L,100,105,-5
13534,508,6767,W,105,100,5
13535,313,6768,L,94,107,-13
13536,314,6768,W,107,94,13
13537,829,6769,L,100,104,-4
13538,830,6769,W,104,100,4
13539,550,6770,L,95,105,-10
13540,549,6770,W,105,95,10
13541,857,6771,L,92,99,-7
13542,858,6771,W,99,92,7
13543,545,6772,L,84,85,-1
13544,546,6772,W,85,84,1
13545,850,6773,W,110,103,7
13546,849,6773,L,103,110,-7
13547,577,6774,L,81,92,-11
13548,578,6774,W,92,81,11
13549,448,6775,L,92,106,-14
13550,447,6775,W,106,92,14
13551,673,6776,L,66,94,-28
13552,674,6776,W,94,66,28
13553,725,6777,W,122,106,16
13554,726,6777,L,106,122,-16
13555,582,6778,L,115,119,-4
13556,581,6778,W,119,115,4
13557,352,6779,L,97,105,-8
13558,351,6779,W,105,97,8
13559,144,6780,L,89,108,-19
13560,143,6780,W,108,89,19
13561,421,6781,L,105,108,-3
13562,422,6781,W,108,105,3
13563,454,6782,W,117,98,19
13564,453,6782,L,98,117,-19
13565,603,6783,W,118,111,7
13566,604,6783,L,111,118,-7
13567,796,6784,W,123,108,15
13568,795,6784,L,108,123,-15
13569,442,6785,L,100,109,-9
13570,441,6785,W,109,100,9
13571,640,6786,L,89,102,-13
13572,639,6786,W,102,89,13
13573,346,6787,W,100,98,2
13574,345,6787,L,98,100,-2
13575,758,6788,W,91,86,5
13576,757,6788,L,86,91,-5
13577,817,6789,L,97,123,-26
13578,818,6789,W,123,97,26
13579,689,6790,W,113,97,16
13580,690,6790,L,97,113,-16
13581,161,6791,L,83,96,-13
13582,162,6791,W,96,83,13
13583,771,6792,L,94,125,-31
13584,772,6792,W,125,94,31
13585,322,6793,L,85,88,-3
13586,321,6793,W,88,85,3
13587,362,6794,L,97,113,-16
13588,361,6794,W,113,97,16
13589,481,6795,W,94,87,7
13590,482,6795,L,87,94,-7
13591,41,6796,W,93,89,4
13592,42,6796,L,89,93,-4
13593,650,6797,W,96,87,9
13594,649,6797,L,87,96,-9
13595,195,6798,L,88,95,-7
13596,196,6798,W,95,88,7
13597,369,6799,L,103,114,-11
13598,370,6799,W,114,103,11
13599,342,6800,L,107,114,-7
13600,341,6800,W,114,107,7
13601,66,6801,L,99,129,-30
13602,65,6801,W,129,99,30
13603,451,6802,L,99,118,-19
13604,452,6802,W,118,99,19
13605,232,6803,L,92,102,-10
13606,231,6803,W,102,92,10
13607,488,6804,L,91,101,-10
13608,487,6804,W,101,91,10
13609,594,6805,L,99,113,-14
13610,593,6805,W,113,99,14
13611,360,6806,L,103,109,-6
13612,359,6806,W,109,103,6
13613,302,6807,W,128,125,3
13614,301,6807,L,125,128,-3
13615,515,6808,L,87,107,-20
13616,516,6808,W,107,87,20
13617,610,6809,W,101,94,7
13618,609,6809,L,94,101,-7
13619,461,6810,L,91,109,-18
13620,462,6810,W,109,91,18
13621,694,6811,L,102,115,-13
13622,693,6811,W,115,102,13
13623,23,6812,L,92,95,-3
13624,24,6812,W,95,92,3
13625,148,6813,W,120,108,12
13626,147,6813,L,108,120,-12
13627,779,6814,L,97,106,-9
13628,780,6814,W,106,97,9
13629,137,6815,L,91,97,-6
13630,138,6815,W,97,91,6
13631,34,6816,L,98,105,-7
13632,33,6816,W,105,98,7
13633,395,6817,L,98,104,-6
13634,396,6817,W,104,98,6
13635,751,6818,W,113,106,7
13636,752,6818,L,106,113,-7
13637,73,6819,L,100,105,-5
13638,74,6819,W,105,100,5
13639,513,6820,W,104,95,9
13640,514,6820,L,95,104,-9
13641,225,6821,L,86,118,-32
13642,226,6821,W,118,86,32
13643,833,6822,W,127,94,33
13644,834,6822,L,94,127,-33
13645,348,6823,L,82,87,-5
13646,347,6823,W,87,82,5
13647,750,6824,W,111,91,20
13648,749,6824,L,91,111,-20
13649,701,6825,L,85,93,-8
13650,702,6825,W,93,85,8
13651,81,6826,L,107,117,-10
13652,82,6826,W,117,107,10
13653,546,6827,W,114,103,11
13654,545,6827,L,103,114,-11
13655,755,6828,L,78,106,-28
13656,756,6828,W,106,78,28
13657,401,6829,W,98,80,18
13658,402,6829,L,80,98,-18
13659,37,6830,L,76,89,-13
13660,38,6830,W,89,76,13
13661,849,6831,L,105,130,-25
13662,850,6831,W,130,105,25
13663,570,6832,W,95,69,26
13664,569,6832,L,69,95,-26
13665,799,6833,W,101,91,10
13666,800,6833,L,91,101,-10
13667,125,6834,W,100,90,10
13668,126,6834,L,90,100,-10
13669,584,6835,L,105,116,-11
13670,583,6835,W,116,105,11
13671,93,6836,W,100,93,7
13672,94,6836,L,93,100,-7
13673,643,6837,L,104,108,-4
13674,644,6837,W,108,104,4
13675,196,6838,L,98,103,-5
13676,195,6838,W,103,98,5
13677,505,6839,W,108,101,7
13678,506,6839,L,101,108,-7
13679,275,6840,L,98,106,-8
13680,276,6840,W,106,98,8
13681,647,6841,W,95,88,7
13682,648,6841,L,88,95,-7
13683,49,6842,W,114,100,14
13684,50,6842,L,100,114,-14
13685,176,6843,L,85,91,-6
13686,175,6843,W,91,85,6
13687,528,6844,L,109,114,-5
13688,527,6844,W,114,109,5
13689,445,6845,L,84,92,-8
13690,446,6845,W,92,84,8
13691,233,6846,L,89,95,-6
13692,234,6846,W,95,89,6
13693,679,6847,L,113,121,-8
13694,680,6847,W,121,113,8
13695,864,6848,L,79,89,-10
13696,863,6848,W,89,79,10
13697,108,6849,W,92,86,6
13698,107,6849,L,86,92,-6
13699,307,6850,L,97,99,-2
13700,308,6850,W,99,97,2
13701,551,6851,W,108,100,8
13702,552,6851,L,100,108,-8
13703,219,6852,L,111,120,-9
13704,220,6852,W,120,111,9
13705,76,6853,L,84,98,-14
13706,75,6853,W,98,84,14
13707,587,6854,W,104,98,6
13708,588,6854,L,98,104,-6
13709,651,6855,L,89,104,-15
13710,652,6855,W,104,89,15
13711,416,6856,L,94,103,-9
13712,415,6856,W,103,94,9
13713,245,6857,L,114,119,-5
13714,246,6857,W,119,114,5
13715,805,6858,W,89,83,6
13716,806,6858,L,83,89,-6
13717,403,6859,L,90,97,-7
13718,404,6859,W,97,90,7
13719,759,6860,L,93,103,-10
13720,760,6860,W,103,93,10
13721,494,6861,L,97,106,-9
13722,493,6861,W,106,97,9
13723,174,6862,L,75,94,-19
13724,173,6862,W,94,75,19
13725,441,6863,L,105,108,-3
13726,442,6863,W,108,105,3
13727,433,6864,W,102,100,2
13728,434,6864,L,100,102,-2
13729,17,6865,W,98,93,5
13730,18,6865,L,93,98,-5
13731,678,6866,W,105,100,5
13732,677,6866,L,100,105,-5
13733,261,6867,L,85,112,-27
13734,262,6867,W,112,85,27
13735,460,6868,W,100,85,15
13736,459,6868,L,85,100,-15
13737,660,6869,L,85,88,-3
13738,659,6869,W,88,85,3
13739,572,6870,W,120,112,8
13740,571,6870,L,112,120,-8
13741,692,6871,L,118,123,-5
13742,691,6871,W,123,118,5
13743,60,6872,W,115,91,24
13744,59,6872,L,91,115,-24
13745,107,6873,L,82,105,-23
13746,108,6873,W,105,82,23
13747,96,6874,L,93,102,-9
13748,95,6874,W,102,93,9
13749,123,6875,L,94,100,-6
13750,124,6875,W,100,94,6
13751,335,6876,L,84,85,-1
13752,336,6876,W,85,84,1
13753,860,6877,L,103,104,-1
13754,859,6877,W,104,103,1
13755,216,6878,W,93,82,11
13756,215,6878,L,82,93,-11
13757,353,6879,L,79,110,-31
13758,354,6879,W,110,79,31
13759,289,6880,L,95,106,-11
13760,290,6880,W,106,95,11
13761,766,6881,W,124,86,38
13762,765,6881,L,86,124,-38
13763,683,6882,L,96,104,-8
13764,684,6882,W,104,96,8
13765,10,6883,L,92,97,-5
13766,9,6883,W,97,92,5
13767,39,6884,W,114,103,11
13768,40,6884,L,103,114,-11
13769,201,6885,L,98,115,-17
13770,202,6885,W,115,98,17
13771,121,6886,L,108,110,-2
13772,122,6886,W,110,108,2
13773,38,6887,W,110,105,5
13774,37,6887,L,105,110,-5
13775,357,6888,L,93,102,-9
13776,358,6888,W,102,93,9
13777,217,6889,W,108,101,7
13778,218,6889,L,101,108,-7
13779,249,6890,L,74,94,-20
13780,250,6890,W,94,74,20
13781,567,6891,W,106,101,5
13782,568,6891,L,101,106,-5
13783,316,6892,W,110,99,11
13784,315,6892,L,99,110,-11
13785,604,6893,W,99,92,7
13786,603,6893,L,92,99,-7
13787,556,6894,W,98,83,15
13788,555,6894,L,83,98,-15
13789,774,6895,L,103,105,-2
13790,773,6895,W,105,103,2
13791,761,6896,W,96,86,10
13792,762,6896,L,86,96,-10
13793,617,6897,L,95,99,-4
13794,618,6897,W,99,95,4
13795,709,6898,W,104,94,10
13796,710,6898,L,94,104,-10
13797,602,6899,W,101,74,27
13798,601,6899,L,74,101,-27
13799,480,6900,W,93,91,2
13800,479,6900,L,91,93,-2
13801,686,6901,W,101,97,4
13802,685,6901,L,97,101,-4
13803,824,6902,L,75,82,-7
13804,823,6902,W,82,75,7
13805,14,6903,L,98,103,-5
13806,13,6903,W,103,98,5
13807,262,6904,W,107,96,11
13808,261,6904,L,96,107,-11
13809,444,6905,W,97,79,18
13810,443,6905,L,79,97,-18
13811,344,6906,W,113,89,24
13812,343,6906,L,89,113,-24
13813,296,6907,W,121,115,6
13814,295,6907,L,115,121,-6
13815,337,6908,L,93,101,-8
13816,338,6908,W,101,93,8
13817,724,6909,L,98,106,-8
13818,723,6909,W,106,98,8
13819,105,6910,L,81,89,-8
13820,106,6910,W,89,81,8
13821,11,6911,L,86,93,-7
13822,12,6911,W,93,86,7
13823,350,6912,L,89,96,-7
13824,349,6912,W,96,89,7
13825,733,6913,L,98,102,-4
13826,734,6913,W,102,98,4
13827,90,6914,L,102,104,-2
13828,89,6914,W,104,102,2
13829,630,6915,L,112,115,-3
13830,629,6915,W,115,112,3
13831,427,6916,L,88,95,-7
13832,428,6916,W,95,88,7
13833,135,6917,W,104,82,22
13834,136,6917,L,82,104,-22
13835,181,6918,L,113,117,-4
13836,182,6918,W,117,113,4
13837,563,6919,L,99,110,-11
13838,564,6919,W,110,99,11
13839,520,6920,W,110,96,14
13840,519,6920,L,96,110,-14
13841,345,6921,L,105,110,-5
13842,346,6921,W,110,105,5
13843,749,6922,L,96,102,-6
13844,750,6922,W,102,96,6
13845,463,6923,L,87,104,-17
13846,464,6923,W,104,87,17
13847,533,6924,L,95,111,-16
13848,534,6924,W,111,95,16
13849,465,6925,L,88,104,-16
13850,466,6925,W,104,88,16
13851,408,6926,L,90,102,-12
13852,407,6926,W,102,90,12
13853,229,6927,W,100,97,3
13854,230,6927,L,97,100,-3
13855,837,6928,L,77,97,-20
13856,838,6928,W,97,77,20
13857,487,6929,W,98,86,12
13858,488,6929,L,86,98,-12
13859,812,6930,L,94,115,-21
13860,811,6930,W,115,94,21
13861,115,6931,W,93,90,3
13862,116,6931,L,90,93,-3
13863,801,6932,L,92,105,-13
13864,802,6932,W,105,92,13
13865,386,6933,W,114,107,7
13866,385,6933,L,107,114,-7
13867,740,6934,L,92,99,-7
13868,739,6934,W,99,92,7
13869,71,6935,W,102,93,9
13870,72,6935,L,93,102,-9
13871,616,6936,L,71,87,-16
13872,615,6936,W,87,71,16
13873,786,6937,W,110,82,28
13874,785,6937,L,82,110,-28
13875,157,6938,L,81,90,-9
13876,158,6938,W,90,81,9
13877,557,6939,L,108,119,-11
13878,558,6939,W,119,108,11
13879,443,6940,W,90,87,3
13880,444,6940,L,87,90,-3
13881,114,6941,L,97,100,-3
13882,113,6941,W,100,97,3
13883,287,6942,L,102,113,-11
13884,288,6942,W,113,102,11
13885,626,6943,W,115,110,5
13886,625,6943,L,110,115,-5
13887,145,6944,W,98,92,6
13888,146,6944,L,92,98,-6
13889,618,6945,L,89,106,-17
13890,617,6945,W,106,89,17
13891,3,6946,L,98,103,-5
13892,4,6946,W,103,98,5
13893,596,6947,L,98,104,-6
13894,595,6947,W,104,98,6
13895,30,6948,W,101,83,18
13896,29,6948,L,83,101,-18
13897,239,6949,L,94,119,-25
13898,240,6949,W,119,94,25
13899,19,6950,L,81,92,-11
13900,20,6950,W,92,81,11
13901,455,6951,L,111,118,-7
13902,456,6951,W,118,111,7
13903,736,6952,W,97,86,11
13904,735,6952,L,86,97,-11
13905,469,6953,L,99,126,-27
13906,470,6953,W,126,99,27
13907,85,6954,W,110,103,7
13908,86,6954,L,103,110,-7
13909,89,6955,W,105,91,14
13910,90,6955,L,91,105,-14
13911,467,6956,L,107,112,-5
13912,468,6956,W,112,107,5
13913,798,6957,L,76,98,-22
13914,797,6957,W,98,76,22
13915,665,6958,W,111,87,24
13916,666,6958,L,87,111,-24
13917,259,6959,L,100,111,-11
13918,260,6959,W,111,100,11
13919,250,6960,W,106,95,11
13920,249,6960,L,95,106,-11
13921,471,6961,W,127,89,38
13922,472,6961,L,89,127,-38
13923,285,6962,W,114,105,9
13924,286,6962,L,105,114,-9
13925,780,6963,L,109,111,-2
13926,779,6963,W,111,109,2
13927,669,6964,L,91,100,-9
13928,670,6964,W,100,91,9
13929,290,6965,L,81,89,-8
13930,289,6965,W,89,81,8
13931,153,6966,L,84,95,-11
13932,154,6966,W,95,84,11
13933,98,6967,L,76,92,-16
13934,97,6967,W,92,76,16
13935,722,6968,L,99,110,-11
13936,721,6968,W,110,99,11
13937,826,6969,L,101,109,-8
13938,825,6969,W,109,101,8
13939,580,6970,W,105,80,25
13940,579,6970,L,80,105,-25
13941,581,6971,L,89,104,-15
13942,582,6971,W,104,89,15
13943,547,6972,L,115,119,-4
13944,548,6972,W,119,115,4
13945,273,6973,L,98,113,-15
13946,274,6973,W,113,98,15
13947,184,6974,L,82,87,-5
13948,183,6974,W,87,82,5
13949,523,6975,L,88,89,-1
13950,524,6975,W,89,88,1
13951,447,6976,L,93,113,-20
13952,448,6976,W,113,93,20
13953,713,6977,W,94,91,3
13954,714,6977,L,91,94,-3
13955,536,6978,L,83,89,-6
13956,535,6978,W,89,83,6
13957,46,6979,L,86,102,-16
13958,45,6979,W,102,86,16
13959,509,6980,L,103,111,-8
13960,510,6980,W,111,103,8
13961,522,6981,W,106,93,13
13962,521,6981,L,93,106,-13
13963,346,6982,L,95,110,-15
13964,345,6982,W,110,95,15
13965,732,6983,W,104,87,17
13966,731,6983,L,87,104,-17
13967,637,6984,L,93,95,-2
13968,638,6984,W,95,93,2
13969,208,6985,L,89,105,-16
13970,207,6985,W,105,89,16
13971,597,6986,L,86,104,-18
13972,598,6986,W,104,86,18
13973,127,6987,W,106,96,10
13974,128,6987,L,96,106,-10
13975,529,6988,W,127,118,9
13976,530,6988,L,118,127,-9
13977,48,6989,L,86,95,-9
13978,47,6989,W,95,86,9
13979,506,6990,W,106,78,28
13980,505,6990,L,78,106,-28
13981,57,6991,L,80,96,-16
13982,58,6991,W,96,80,16
13983,666,6992,L,95,109,-14
13984,665,6992,W,109,95,14
13985,263,6993,W,100,96,4
13986,264,6993,L,96,100,-4
13987,66,6994,W,115,98,17
13988,65,6994,L,98,115,-17
13989,543,6995,W,117,105,12
13990,544,6995,L,105,117,-12
13991,227,6996,L,97,103,-6
13992,228,6996,W,103,97,6
13993,240,6997,W,124,114,10
13994,239,6997,L,114,124,-10
13995,378,6998,W,95,93,2
13996,377,6998,L,93,95,-2
13997,324,6999,W,89,84,5
13998,323,6999,L,84,89,-5
13999,112,7000,W,112,101,11
14000,111,7000,L,101,112,-11
14001,82,7001,L,82,87,-5
14002,81,7001,W,87,82,5
14003,53,7002,L,83,85,-2
14004,54,7002,W,85,83,2
14005,77,7003,L,88,94,-6
14006,78,7003,W,94,88,6
14007,438,7004,W,103,102,1
14008,437,7004,L,102,103,-1
14009,148,7005,L,108,131,-23
14010,147,7005,W,131,108,23
14011,658,7006,L,105,120,-15
14012,657,7006,W,120,105,15
14013,74,7007,W,109,98,11
14014,73,7007,L,98,109,-11
14015,737,7008,W,98,97,1
14016,738,7008,L,97,98,-1
14017,173,7009,L,101,111,-10
14018,174,7009,W,111,101,10
14019,538,7010,W,107,72,35
14020,537,7010,L,72,107,-35
14021,772,7011,W,106,92,14
14022,771,7011,L,92,106,-14
14023,100,7012,L,93,96,-3
14024,99,7012,W,96,93,3
14025,627,7013,L,90,102,-12
14026,628,7013,W,102,90,12
14027,244,7014,L,77,114,-37
14028,243,7014,W,114,77,37
14029,843,7015,L,81,89,-8
14030,844,7015,W,89,81,8
14031,11,7016,L,99,103,-4
14032,12,7016,W,103,99,4
14033,592,7017,L,88,92,-4
14034,591,7017,W,92,88,4
14035,619,7018,L,85,98,-13
14036,620,7018,W,98,85,13
14037,775,7019,L,107,123,-16
14038,776,7019,W,123,107,16
14039,2,7020,L,93,100,-7
14040,1,7020,W,100,93,7
14041,5,7021,W,116,113,3
14042,6,7021,L,113,116,-3
14043,241,7022,L,111,117,-6
14044,242,7022,W,117,111,6
14045,144,7023,L,96,107,-11
14046,143,7023,W,107,96,11
14047,807,7024,L,116,124,-8
14048,808,7024,W,124,116,8
14049,646,7025,L,97,103,-6
14050,645,7025,W,103,97,6
14051,440,7026,L,88,98,-10
14052,439,7026,W,98,88,10
14053,686,7027,L,89,90,-1
14054,685,7027,W,90,89,1
14055,221,7028,W,101,78,23
14056,222,7028,L,78,101,-23
14057,517,7029,L,94,105,-11
14058,518,7029,W,105,94,11
14059,283,7030,L,87,108,-21
14060,284,7030,W,108,87,21
14061,570,7031,L,87,94,-7
14062,569,7031,W,94,87,7
14063,6,7032,W,102,91,11
14064,5,7032,L,91,102,-11
14065,846,7033,L,90,101,-11
14066,845,7033,W,101,90,11
14067,326,7034,L,96,105,-9
14068,325,7034,W,105,96,9
14069,338,7035,L,105,113,-8
14070,337,7035,W,113,105,8
14071,393,7036,L,103,110,-7
14072,394,7036,W,110,103,7
14073,215,7037,W,100,90,10
14074,216,7037,L,90,100,-10
14075,793,7038,L,100,104,-4
14076,794,7038,W,104,100,4
14077,432,7039,L,101,102,-1
14078,431,7039,W,102,101,1
14079,792,7040,L,109,114,-5
14080,791,7040,W,114,109,5
14081,142,7041,W,109,93,16
14082,141,7041,L,93,109,-16
14083,651,7042,L,114,128,-14
14084,652,7042,W,128,114,14
14085,842,7043,L,91,108,-17
14086,841,7043,W,108,91,17
14087,777,7044,L,98,105,-7
14088,778,7044,W,105,98,7
14089,811,7045,W,108,97,11
14090,812,7045,L,97,108,-11
14091,97,7046,L,102,103,-1
14092,98,7046,W,103,102,1
14093,436,7047,W,121,96,25
14094,435,7047,L,96,121,-25
14095,865,7048,L,100,115,-15
14096,866,7048,W,115,100,15
14097,569,7049,W,92,88,4
14098,570,7049,L,88,92,-4
14099,35,7050,L,97,104,-7
14100,36,7050,W,104,97,7
14101,69,7051,L,84,97,-13
14102,70,7051,W,97,84,13
14103,382,7052,L,94,100,-6
14104,381,7052,W,100,94,6
14105,194,7053,L,100,102,-2
14106,193,7053,W,102,100,2
14107,186,7054,W,82,75,7
14108,185,7054,L,75,82,-7
14109,586,7055,W,102,101,1
14110,585,7055,L,101,102,-1
14111,126,7056,W,83,75,8
14112,125,7056,L,75,83,-8
14113,609,7057,L,80,92,-12
14114,610,7057,W,92,80,12
14115,340,7058,W,104,86,18
14116,339,7058,L,86,104,-18
14117,741,7059,W,99,94,5
14118,742,7059,L,94,99,-5
14119,402,7060,L,87,106,-19
14120,401,7060,W,106,87,19
14121,548,7061,W,105,85,20
14122,547,7061,L,85,105,-20
14123,700,7062,W,106,90,16
14124,699,7062,L,90,106,-16
14125,672,7063,L,88,95,-7
14126,671,7063,W,95,88,7
14127,207,7064,L,74,85,-11
14128,208,7064,W,85,74,11
14129,760,7065,L,101,114,-13
14130,759,7065,W,114,101,13
14131,473,7066,W,108,93,15
14132,474,7066,L,93,108,-15
14133,446,7067,L,85,91,-6
14134,445,7067,W,91,85,6
14135,638,7068,W,120,116,4
14136,637,7068,L,116,120,-4
14137,862,7069,L,90,101,-11
14138,861,7069,W,101,90,11
14139,397,7070,L,99,105,-6
14140,398,7070,W,105,99,6
14141,608,7071,L,100,110,-10
14142,607,7071,W,110,100,10
14143,417,7072,W,93,72,21
14144,418,7072,L,72,93,-21
14145,254,7073,L,103,108,-5
14146,253,7073,W,108,103,5
14147,468,7074,L,93,99,-6
14148,467,7074,W,99,93,6
14149,405,7075,W,93,87,6
14150,406,7075,L,87,93,-6
14151,853,7076,L,94,103,-9
14152,854,7076,W,103,94,9
14153,141,7077,W,127,122,5
14154,142,7077,L,122,127,-5
14155,577,7078,L,69,99,-30
14156,578,7078,W,99,69,30
14157,852,7079,L,118,123,-5
14158,851,7079,W,123,118,5
14159,107,7080,L,82,103,-21
14160,108,7080,W,103,82,21
14161,138,7081,W,115,100,15
14162,137,7081,L,100,115,-15
14163,306,7082,L,102,119,-17
14164,305,7082,W,119,102,17
14165,258,7083,L,98,106,-8
14166,257,7083,W,106,98,8
14167,603,7084,W,93,85,8
14168,604,7084,L,85,93,-8
14169,22,7085,L,102,113,-11
14170,21,7085,W,113,102,11
14171,329,7086,L,92,100,-8
14172,330,7086,W,100,92,8
14173,265,7087,L,69,89,-20
14174,266,7087,W,89,69,20
14175,260,7088,L,94,99,-5
14176,259,7088,W,99,94,5
14177,730,7089,W,94,89,5
14178,729,7089,L,89,94,-5
14179,477,7090,L,98,110,-12
14180,478,7090,W,110,98,12
14181,831,7091,L,94,99,-5
14182,832,7091,W,99,94,5
14183,366,7092,L,86,95,-9
14184,365,7092,W,95,86,9
14185,813,7093,W,98,92,6
14186,814,7093,L,92,98,-6
14187,454,7094,W,104,91,13
14188,453,7094,L,91,104,-13
14189,333,7095,W,109,90,19
14190,334,7095,L,90,109,-19
14191,62,7096,W,113,111,2
14192,61,7096,L,111,113,-2
14193,25,7097,W,109,102,7
14194,26,7097,L,102,109,-7
14195,71,7098,W,103,95,8
14196,72,7098,L,95,103,-8
14197,281,7099,L,94,103,-9
14198,282,7099,W,103,94,9
14199,594,7100,L,84,92,-8
14200,593,7100,W,92,84,8
14201,336,7101,W,99,90,9
14202,335,7101,L,90,99,-9
14203,768,7102,L,74,99,-25
14204,767,7102,W,99,74,25
14205,88,7103,L,98,102,-4
14206,87,7103,W,102,98,4
14207,226,7104,W,106,99,7
14208,225,7104,L,99,106,-7
14209,540,7105,L,98,108,-10
14210,539,7105,W,108,98,10
14211,568,7106,L,111,114,-3
14212,567,7106,W,114,111,3
14213,129,7107,W,99,87,12
14214,130,7107,L,87,99,-12
14215,566,7108,L,110,114,-4
14216,565,7108,W,114,110,4
14217,788,7109,W,96,84,12
14218,787,7109,L,84,96,-12
14219,544,7110,L,100,112,-12
14220,543,7110,W,112,100,12
14221,695,7111,L,95,101,-6
14222,696,7111,W,101,95,6
14223,224,7112,W,120,100,20
14224,223,7112,L,100,120,-20
14225,706,7113,W,117,115,2
14226,705,7113,L,115,117,-2
14227,358,7114,L,106,109,-3
14228,357,7114,W,109,106,3
14229,648,7115,L,73,108,-35
14230,647,7115,W,108,73,35
14231,486,7116,L,86,101,-15
14232,485,7116,W,101,86,15
14233,351,7117,L,96,103,-7
14234,352,7117,W,103,96,7
14235,532,7118,L,83,101,-18
14236,531,7118,W,101,83,18
14237,429,7119,L,71,76,-5
14238,430,7119,W,76,71,5
14239,15,7120,L,85,99,-14
14240,16,7120,W,99,85,14
14241,380,7121,W,102,98,4
14242,379,7121,L,98,102,-4
14243,103,7122,L,90,129,-39
14244,104,7122,W,129,90,39
14245,435,7123,L,101,126,-25
14246,436,7123,W,126,101,25
14247,535,7124,L,106,113,-7
14248,536,7124,W,113,106,7
14249,600,7125,L,93,103,-10
14250,599,7125,W,103,93,10
14251,303,7126,W,92,84,8
14252,304,7126,L,84,92,-8
14253,39,7127,W,91,86,5
14254,40,7127,L,86,91,-5
14255,529,7128,W,113,111,2
14256,530,7128,L,111,113,-2
14257,139,7129,L,87,89,-2
14258,140,7129,W,89,87,2
14259,794,7130,W,100,99,1
14260,793,7130,L,99,100,-1
14261,823,7131,W,101,99,2
14262,824,7131,L,99,101,-2
14263,248,7132,W,90,89,1
14264,247,7132,L,89,90,-1
14265,193,7133,L,84,123,-39
14266,194,7133,W,123,84,39
14267,583,7134,L,81,104,-23
14268,584,7134,W,104,81,23
14269,707,7135,L,91,110,-19
14270,708,7135,W,110,91,19
14271,383,7136,L,80,96,-16
14272,384,7136,W,96,80,16
14273,284,7137,L,113,118,-5
14274,283,7137,W,118,113,5
14275,190,7138,L,86,92,-6
14276,189,7138,W,92,86,6
14277,270,7139,L,76,78,-2
14278,269,7139,W,78,76,2
14279,84,7140,W,98,91,7
14280,83,7140,L,91,98,-7
14281,492,7141,L,118,128,-10
14282,491,7141,W,128,118,10
14283,483,7142,L,113,126,-13
14284,484,7142,W,126,113,13
14285,375,7143,L,92,106,-14
14286,376,7143,W,106,92,14
14287,381,7144,W,98,75,23
14288,382,7144,L,75,98,-23
14289,188,7145,W,105,103,2
14290,187,7145,L,103,105,-2
14291,206,7146,W,103,100,3
14292,205,7146,L,100,103,-3
14293,168,7147,W,94,86,8
14294,167,7147,L,86,94,-8
14295,220,7148,W,109,99,10
14296,219,7148,L,99,109,-10
14297,315,7149,L,94,98,-4
14298,316,7149,W,98,94,4
14299,490,7150,L,93,102,-9
14300,489,7150,W,102,93,9
14301,496,7151,L,80,105,-25
14302,495,7151,W,105,80,25
14303,334,7152,W,103,95,8
14304,333,7152,L,95,103,-8
14305,106,7153,L,76,111,-35
14306,105,7153,W,111,76,35
14307,274,7154,L,94,108,-14
14308,273,7154,W,108,94,14
14309,504,7155,L,100,115,-15
14310,503,7155,W,115,100,15
14311,370,7156,L,79,122,-43
14312,369,7156,W,122,79,43
14313,185,7157,W,92,89,3
14314,186,7157,L,89,92,-3
14315,675,7158,L,92,99,-7
14316,676,7158,W,99,92,7
14317,43,7159,L,82,93,-11
14318,44,7159,W,93,82,11
14319,165,7160,L,98,110,-12
14320,166,7160,W,110,98,12
14321,113,7161,W,95,93,2
14322,114,7161,L,93,95,-2
14323,36,7162,W,127,99,28
14324,35,7162,L,99,127,-28
14325,158,7163,L,69,89,-20
14326,157,7163,W,89,69,20
14327,101,7164,W,107,99,8
14328,102,7164,L,99,107,-8
14329,438,7165,L,71,80,-9
14330,437,7165,W,80,71,9
14331,243,7166,W,99,90,9
14332,244,7166,L,90,99,-9
14333,266,7167,L,89,107,-18
14334,265,7167,W,107,89,18
14335,484,7168,W,131,106,25
14336,483,7168,L,106,131,-25
14337,459,7169,W,113,105,8
14338,460,7169,L,105,113,-8
14339,470,7170,W,117,108,9
14340,469,7170,L,108,117,-9
14341,146,7171,L,98,102,-4
14342,145,7171,W,102,98,4
14343,229,7172,L,85,94,-9
14344,230,7172,W,94,85,9
14345,653,7173,W,119,103,16
14346,654,7173,L,103,119,-16
14347,267,7174,L,89,97,-8
14348,268,7174,W,97,89,8
14349,527,7175,W,95,83,12
14350,528,7175,L,83,95,-12
14351,792,7176,W,98,96,2
14352,791,7176,L,96,98,-2
14353,828,7177,L,115,127,-12
14354,827,7177,W,127,115,12
14355,767,7178,L,81,96,-15
14356,768,7178,W,96,81,15
14357,282,7179,W,106,96,10
14358,281,7179,L,96,106,-10
14359,779,7180,L,99,110,-11
14360,780,7180,W,110,99,11
14361,579,7181,W,110,89,21
14362,580,7181,L,89,110,-21
14363,244,7182,W,102,80,22
14364,243,7182,L,80,102,-22
14365,518,7183,W,126,121,5
14366,517,7183,L,121,126,-5
14367,534,7184,L,96,110,-14
14368,533,7184,W,110,96,14
14369,133,7185,L,101,112,-11
14370,134,7185,W,112,101,11
14371,68,7186,L,79,95,-16
14372,67,7186,W,95,79,16
14373,657,7187,W,109,102,7
14374,658,7187,L,102,109,-7
14375,40,7188,L,84,100,-16
14376,39,7188,W,100,84,16
14377,47,7189,W,103,92,11
14378,48,7189,L,92,103,-11
14379,18,7190,W,100,94,6
14380,17,7190,L,94,100,-6
14381,499,7191,L,89,104,-15
14382,500,7191,W,104,89,15
14383,659,7192,W,105,94,11
14384,660,7192,L,94,105,-11
14385,314,7193,L,113,120,-7
14386,313,7193,W,120,113,7
14387,268,7194,L,107,114,-7
14388,267,7194,W,114,107,7
14389,523,7195,W,105,91,14
14390,524,7195,L,91,105,-14
14391,10,7196,W,105,99,6
14392,9,7196,L,99,105,-6
14393,365,7197,W,98,93,5
14394,366,7197,L,93,98,-5
14395,124,7198,W,78,75,3
14396,123,7198,L,75,78,-3
14397,635,7199,W,110,101,9
14398,636,7199,L,101,110,-9
14399,221,7200,W,108,104,4
14400,222,7200,L,104,108,-4
14401,835,7201,L,93,101,-8
14402,836,7201,W,101,93,8
14403,863,7202,L,100,107,-7
14404,864,7202,W,107,100,7
14405,608,7203,W,116,105,11
14406,607,7203,L,105,116,-11
14407,445,7204,W,105,87,18
14408,446,7204,L,87,105,-18
14409,738,7205,W,121,114,7
14410,737,7205,L,114,121,-7
14411,734,7206,W,113,99,14
14412,733,7206,L,99,113,-14
14413,588,7207,L,100,108,-8
14414,587,7207,W,108,100,8
14415,566,7208,W,114,111,3
14416,565,7208,L,111,114,-3
14417,541,7209,W,104,90,14
14418,542,7209,L,90,104,-14
14419,45,7210,W,106,94,12
14420,46,7210,L,94,106,-12
14421,326,7211,L,89,120,-31
14422,325,7211,W,120,89,31
14423,861,7212,L,84,103,-19
14424,862,7212,W,103,84,19
14425,585,7213,L,110,122,-12
14426,586,7213,W,122,110,12
14427,250,7214,L,92,93,-1
14428,249,7214,W,93,92,1
14429,576,7215,L,93,98,-5
14430,575,7215,W,98,93,5
14431,374,7216,L,92,103,-11
14432,373,7216,W,103,92,11
14433,616,7217,L,87,95,-8
14434,615,7217,W,95,87,8
14435,430,7218,W,110,82,28
14436,429,7218,L,82,110,-28
14437,818,7219,W,108,93,15
14438,817,7219,L,93,108,-15
14439,65,7220,L,100,120,-20
14440,66,7220,W,120,100,20
14441,131,7221,L,96,109,-13
14442,132,7221,W,109,96,13
14443,462,7222,L,82,97,-15
14444,461,7222,W,97,82,15
14445,44,7223,W,106,103,3
14446,43,7223,L,103,106,-3
14447,564,7224,L,94,112,-18
14448,563,7224,W,112,94,18
14449,51,7225,L,94,99,-5
14450,52,7225,W,99,94,5
14451,9,7226,L,86,102,-16
14452,10,7226,W,102,86,16
14453,41,7227,L,103,107,-4
14454,42,7227,W,107,103,4
14455,482,7228,W,90,88,2
14456,481,7228,L,88,90,-2
14457,717,7229,L,84,98,-14
14458,718,7229,W,98,84,14
14459,31,7230,W,118,108,10
14460,32,7230,L,108,118,-10
14461,233,7231,L,95,106,-11
14462,234,7231,W,106,95,11
14463,601,7232,L,95,100,-5
14464,602,7232,W,100,95,5
14465,645,7233,L,84,101,-17
14466,646,7233,W,101,84,17
14467,371,7234,W,120,96,24
14468,372,7234,L,96,120,-24
14469,415,7235,W,103,95,8
14470,416,7235,L,95,103,-8
14471,511,7236,L,83,99,-16
14472,512,7236,W,99,83,16
14473,92,7237,W,89,81,8
14474,91,7237,L,81,89,-8
14475,847,7238,L,94,98,-4
14476,848,7238,W,98,94,4
14477,780,7239,W,113,111,2
14478,779,7239,L,111,113,-2
14479,78,7240,L,86,96,-10
14480,77,7240,W,96,86,10
14481,466,7241,W,97,77,20
14482,465,7241,L,77,97,-20
14483,747,7242,L,90,93,-3
14484,748,7242,W,93,90,3
14485,711,7243,W,97,77,20
14486,712,7243,L,77,97,-20
14487,770,7244,W,108,95,13
14488,769,7244,L,95,108,-13
14489,120,7245,L,89,114,-25
14490,119,7245,W,114,89,25
14491,426,7246,L,83,104,-21
14492,425,7246,W,104,83,21
14493,773,7247,W,105,93,12
14494,774,7247,L,93,105,-12
14495,279,7248,L,91,101,-10
14496,280,7248,W,101,91,10
14497,595,7249,L,102,117,-15
14498,596,7249,W,117,102,15
14499,731,7250,W,105,104,1
14500,732,7250,L,104,105,-1
14501,310,7251,W,102,96,6
14502,309,7251,L,96,102,-6
14503,203,7252,W,92,85,7
14504,204,7252,L,85,92,-7
14505,70,7253,L,92,95,-3
14506,69,7253,W,95,92,3
14507,606,7254,W,107,98,9
14508,605,7254,L,98,107,-9
14509,460,7255,W,110,101,9
14510,459,7255,L,101,110,-9
14511,827,7256,L,91,117,-26
14512,828,7256,W,117,91,26
14513,613,7257,W,105,101,4
14514,614,7257,L,101,105,-4
14515,724,7258,W,104,95,9
14516,723,7258,L,95,104,-9
14517,46,7259,L,94,98,-4
14518,45,7259,W,98,94,4
14519,710,7260,W,96,88,8
14520,709,7260,L,88,96,-8
14521,574,7261,L,83,105,-22
14522,573,7261,W,105,83,22
14523,845,7262,L,105,114,-9
14524,846,7262,W,114,105,9
14525,390,7263,L,95,114,-19
14526,389,7263,W,114,95,19
14527,67,7264,W,95,82,13
14528,68,7264,L,82,95,-13
14529,395,7265,L,84,88,-4
14530,396,7265,W,88,84,4
14531,363,7266,L,109,125,-16
14532,364,7266,W,125,109,16
14533,200,7267,L,87,88,-1
14534,199,7267,W,88,87,1
14535,834,7268,W,109,90,19
14536,833,7268,L,90,109,-19
14537,836,7269,L,92,101,-9
14538,835,7269,W,101,92,9
14539,654,7270,L,104,109,-5
14540,653,7270,W,109,104,5
14541,819,7271,L,79,115,-36
14542,820,7271,W,115,79,36
14543,578,7272,L,85,114,-29
14544,577,7272,W,114,85,29
14545,391,7273,L,91,127,-36
14546,392,7273,W,127,91,36
14547,398,7274,W,115,107,8
14548,397,7274,L,107,115,-8
14549,556,7275,W,98,90,8
14550,555,7275,L,90,98,-8
14551,80,7276,W,101,89,12
14552,79,7276,L,89,101,-12
14553,179,7277,W,100,98,2
14554,180,7277,L,98,100,-2
14555,744,7278,W,98,92,6
14556,743,7278,L,92,98,-6
14557,295,7279,W,97,81,16
14558,296,7279,L,81,97,-16
14559,562,7280,L,83,111,-28
14560,561,7280,W,111,83,28
14561,746,7281,W,119,101,18
14562,745,7281,L,101,119,-18
14563,359,7282,W,94,91,3
14564,360,7282,L,91,94,-3
14565,104,7283,W,91,87,4
14566,103,7283,L,87,91,-4
14567,404,7284,W,109,106,3
14568,403,7284,L,106,109,-3
14569,343,7285,L,105,126,-21
14570,344,7285,W,126,105,21
14571,172,7286,L,96,112,-16
14572,171,7286,W,112,96,16
14573,187,7287,L,102,109,-7
14574,188,7287,W,109,102,7
14575,554,7288,W,110,107,3
14576,553,7288,L,107,110,-3
14577,870,7289,L,101,106,-5
14578,869,7289,W,106,101,5
14579,56,7290,L,93,95,-2
14580,55,7290,W,95,93,2
14581,182,7291,L,134,137,-3
14582,181,7291,W,137,134,3
14583,764,7292,W,96,80,16
14584,763,7292,L,80,96,-16
14585,697,7293,L,78,99,-21
14586,698,7293,W,99,78,21
14587,825,7294,L,84,106,-22
14588,826,7294,W,106,84,22
14589,140,7295,L,95,106,-11
14590,139,7295,W,106,95,11
14591,318,7296,L,83,102,-19
14592,317,7296,W,102,83,19
14593,494,7297,L,101,109,-8
14594,493,7297,W,109,101,8
14595,109,7298,L,87,95,-8
14596,110,7298,W,95,87,8
14597,79,7299,L,94,100,-6
14598,80,7299,W,100,94,6
14599,298,7300,W,96,82,14
14600,297,7300,L,82,96,-14
14601,28,7301,L,106,110,-4
14602,27,7301,W,110,106,4
14603,491,7302,W,109,86,23
14604,492,7302,L,86,109,-23
14605,526,7303,L,87,114,-27
14606,525,7303,W,114,87,27
14607,690,7304,L,97,102,-5
14608,689,7304,W,102,97,5
14609,323,7305,L,86,126,-40
14610,324,7305,W,126,86,40
14611,128,7306,W,111,103,8
14612,127,7306,L,103,111,-8
14613,856,7307,W,104,103,1
14614,855,7307,L,103,104,-1
14615,387,7308,W,104,94,10
14616,388,7308,L,94,104,-10
14617,205,7309,L,99,107,-8
14618,206,7309,W,107,99,8
14619,116,7310,W,102,101,1
14620,115,7310,L,101,102,-1
14621,729,7311,L,97,101,-4
14622,730,7311,W,101,97,4
14623,76,7312,W,92,90,2
14624,75,7312,L,90,92,-2
14625,582,7313,L,107,112,-5
14626,581,7313,W,112,107,5
14627,503,7314,W,116,107,9
14628,504,7314,L,107,116,-9
14629,150,7315,W,116,102,14
14630,149,7315,L,102,116,-14
14631,72,7316,W,103,80,23
14632,71,7316,L,80,103,-23
14633,720,7317,L,79,101,-22
14634,719,7317,W,101,79,22
14635,169,7318,L,106,110,-4
14636,170,7318,W,110,106,4
14637,537,7319,L,100,107,-7
14638,538,7319,W,107,100,7
14639,502,7320,W,110,85,25
14640,501,7320,L,85,110,-25
14641,806,7321,L,71,88,-17
14642,805,7321,W,88,71,17
14643,776,7322,W,110,98,12
14644,775,7322,L,98,110,-12
14645,736,7323,W,90,85,5
14646,735,7323,L,85,90,-5
14647,555,7324,W,102,94,8
14648,556,7324,L,94,102,-8
14649,156,7325,L,88,101,-13
14650,155,7325,W,101,88,13
14651,714,7326,L,97,110,-13
14652,713,7326,W,110,97,13
14653,754,7327,W,103,95,8
14654,753,7327,L,95,103,-8
14655,765,7328,L,129,135,-6
14656,766,7328,W,135,129,6
14657,91,7329,W,109,107,2
14658,92,7329,L,107,109,-2
14659,94,7330,L,98,102,-4
14660,93,7330,W,102,98,4
14661,434,7331,W,117,111,6
14662,433,7331,L,111,117,-6
14663,53,7332,W,115,106,9
14664,54,7332,L,106,115,-9
14665,86,7333,L,75,98,-23
14666,85,7333,W,98,75,23
14667,796,7334,W,98,89,9
14668,795,7334,L,89,98,-9
14669,791,7335,L,109,119,-10
14670,792,7335,W,119,109,10
14671,459,7336,L,102,106,-4
14672,460,7336,W,106,102,4
14673,191,7337,L,93,114,-21
14674,192,7337,W,114,93,21
14675,735,7338,W,107,77,30
14676,736,7338,L,77,107,-30
14677,55,7339,L,90,97,-7
14678,56,7339,W,97,90,7
14679,280,7340,W,102,91,11
14680,279,7340,L,91,102,-11
14681,448,7341,L,91,101,-10
14682,447,7341,W,101,91,10
14683,276,7342,L,86,100,-14
14684,275,7342,W,100,86,14
14685,851,7343,L,93,113,-20
14686,852,7343,W,113,93,20
14687,458,7344,W,114,106,8
14688,457,7344,L,106,114,-8
14689,785,7345,L,96,102,-6
14690,786,7345,W,102,96,6
14691,605,7346,L,104,107,-3
14692,606,7346,W,107,104,3
14693,117,7347,L,115,124,-9
14694,118,7347,W,124,115,9
14695,9,7348,W,99,91,8
14696,10,7348,L,91,99,-8
14697,557,7349,W,91,87,4
14698,558,7349,L,87,91,-4
14699,422,7350,L,105,115,-10
14700,421,7350,W,115,105,10
14701,699,7351,L,104,125,-21
14702,700,7351,W,125,104,21
14703,629,7352,W,115,111,4
14704,630,7352,L,111,115,-4
14705,388,7353,W,108,101,7
14706,387,7353,L,101,108,-7
14707,521,7354,L,84,96,-12
14708,522,7354,W,96,84,12
14709,196,7355,L,95,100,-5
14710,195,7355,W,100,95,5
14711,464,7356,W,105,102,3
14712,463,7356,L,102,105,-3
14713,216,7357,W,97,91,6
14714,215,7357,L,91,97,-6
14715,560,7358,L,120,129,-9
14716,559,7358,W,129,120,9
14717,74,7359,L,95,110,-15
14718,73,7359,W,110,95,15
14719,548,7360,L,118,125,-7
14720,547,7360,W,125,118,7
14721,435,7361,L,108,128,-20
14722,436,7361,W,128,108,20
14723,339,7362,L,82,110,-28
14724,340,7362,W,110,82,28
14725,160,7363,L,101,108,-7
14726,159,7363,W,108,101,7
14727,5,7364,W,101,99,2
14728,6,7364,L,99,101,-2
14729,257,7365,W,104,92,12
14730,258,7365,L,92,104,-12
14731,636,7366,W,100,96,4
14732,635,7366,L,96,100,-4
14733,575,7367,L,105,110,-5
14734,576,7367,W,110,105,5
14735,632,7368,L,91,105,-14
14736,631,7368,W,105,91,14
14737,13,7369,L,108,118,-10
14738,14,7369,W,118,108,10
14739,3,7370,W,96,88,8
14740,4,7370,L,88,96,-8
14741,125,7371,L,84,100,-16
14742,126,7371,W,100,84,16
14743,790,7372,L,102,106,-4
14744,789,7372,W,106,102,4
14745,621,7373,L,73,76,-3
14746,622,7373,W,76,73,3
14747,476,7374,W,114,88,26
14748,475,7374,L,88,114,-26
14749,639,7375,W,99,90,9
14750,640,7375,L,90,99,-9
14751,278,7376,L,93,99,-6
14752,277,7376,W,99,93,6
14753,684,7377,W,104,97,7
14754,683,7377,L,97,104,-7
14755,674,7378,L,86,104,-18
14756,673,7378,W,104,86,18
14757,308,7379,W,105,103,2
14758,307,7379,L,103,105,-2
14759,821,7380,L,91,95,-4
14760,822,7380,W,95,91,4
14761,478,7381,L,98,114,-16
14762,477,7381,W,114,98,16
14763,87,7382,L,106,109,-3
14764,88,7382,W,109,106,3
14765,843,7383,W,109,91,18
14766,844,7383,L,91,109,-18
14767,800,7384,W,103,97,6
14768,799,7384,L,97,103,-6
14769,534,7385,W,129,119,10
14770,533,7385,L,119,129,-10
14771,217,7386,W,104,103,1
14772,218,7386,L,103,104,-1
14773,703,7387,W,101,94,7
14774,704,7387,L,94,101,-7
14775,565,7388,W,110,100,10
14776,566,7388,L,100,110,-10
14777,827,7389,L,109,114,-5
14778,828,7389,W,114,109,5
14779,510,7390,W,108,107,1
14780,509,7390,L,107,108,-1
14781,400,7391,L,97,103,-6
14782,399,7391,W,103,97,6
14783,561,7392,W,99,90,9
14784,562,7392,L,90,99,-9
14785,662,7393,W,111,106,5
14786,661,7393,L,106,111,-5
14787,493,7394,W,127,98,29
14788,494,7394,L,98,127,-29
14789,498,7395,W,105,87,18
14790,497,7395,L,87,105,-18
14791,671,7396,L,97,104,-7
14792,672,7396,W,104,97,7
14793,49,7397,W,115,111,4
14794,50,7397,L,111,115,-4
14795,195,7398,L,92,109,-17
14796,196,7398,W,109,92,17
14797,769,7399,W,117,106,11
14798,770,7399,L,106,117,-11
14799,110,7400,W,117,116,1
14800,109,7400,L,116,117,-1
14801,142,7401,L,89,105,-16
14802,141,7401,W,105,89,16
14803,782,7402,L,100,102,-2
14804,781,7402,W,102,100,2
14805,838,7403,L,95,109,-14
14806,837,7403,W,109,95,14
14807,396,7404,W,95,91,4
14808,395,7404,L,91,95,-4
14809,663,7405,L,98,105,-7
14810,664,7405,W,105,98,7
14811,263,7406,L,111,119,-8
14812,264,7406,W,119,111,8
14813,839,7407,W,107,87,20
14814,840,7407,L,87,107,-20
14815,426,7408,W,104,92,12
14816,425,7408,L,92,104,-12
14817,533,7409,L,95,108,-13
14818,534,7409,W,108,95,13
14819,102,7410,L,86,93,-7
14820,101,7410,W,93,86,7
14821,103,7411,L,88,97,-9
14822,104,7411,W,97,88,9
14823,143,7412,W,105,87,18
14824,144,7412,L,87,105,-18
14825,214,7413,L,82,95,-13
14826,213,7413,W,95,82,13
14827,309,7414,W,96,94,2
14828,310,7414,L,94,96,-2
14829,199,7415,L,91,110,-19
14830,200,7415,W,110,91,19
14831,715,7416,L,91,113,-22
14832,716,7416,W,113,91,22
14833,182,7417,L,88,112,-24
14834,181,7417,W,112,88,24
14835,64,7418,W,100,94,6
14836,63,7418,L,94,100,-6
14837,220,7419,W,99,91,8
14838,219,7419,L,91,99,-8
14839,14,7420,W,95,90,5
14840,13,7420,L,90,95,-5
14841,787,7421,W,93,75,18
14842,788,7421,L,75,93,-18
14843,410,7422,L,84,93,-9
14844,409,7422,W,93,84,9
14845,450,7423,W,128,122,6
14846,449,7423,L,122,128,-6
14847,423,7424,W,95,85,10
14848,424,7424,L,85,95,-10
14849,50,7425,L,96,108,-12
14850,49,7425,W,108,96,12
14851,531,7426,W,120,115,5
14852,532,7426,L,115,120,-5
14853,389,7427,W,95,90,5
14854,390,7427,L,90,95,-5
14855,652,7428,W,105,98,7
14856,651,7428,L,98,105,-7
14857,789,7429,L,106,111,-5
14858,790,7429,W,111,106,5
14859,428,7430,L,99,100,-1
14860,427,7430,W,100,99,1
14861,59,7431,W,114,87,27
14862,60,7431,L,87,114,-27
14863,427,7432,L,81,87,-6
14864,428,7432,W,87,81,6
14865,15,7433,W,112,110,2
14866,16,7433,L,110,112,-2
14867,593,7434,W,111,92,19
14868,594,7434,L,92,111,-19
14869,419,7435,L,114,119,-5
14870,420,7435,W,119,114,5
14871,453,7436,L,94,106,-12
14872,454,7436,W,106,94,12
14873,783,7437,L,96,104,-8
14874,784,7437,W,104,96,8
14875,816,7438,L,106,115,-9
14876,815,7438,W,115,106,9
14877,812,7439,W,101,95,6
14878,811,7439,L,95,101,-6
14879,727,7440,L,107,113,-6
14880,728,7440,W,113,107,6
14881,497,7441,W,100,95,5
14882,498,7441,L,95,100,-5
14883,482,7442,L,70,88,-18
14884,481,7442,W,88,70,18
14885,413,7443,W,105,103,2
14886,414,7443,L,103,105,-2
14887,8,7444,W,113,109,4
14888,7,7444,L,109,113,-4
14889,539,7445,L,94,103,-9
14890,540,7445,W,103,94,9
14891,446,7446,L,79,95,-16
14892,445,7446,W,95,79,16
14893,298,7447,L,80,105,-25
14894,297,7447,W,105,80,25
14895,483,7448,L,93,105,-12
14896,484,7448,W,105,93,12
14897,781,7449,W,103,96,7
14898,782,7449,L,96,103,-7
14899,723,7450,L,87,96,-9
14900,724,7450,W,96,87,9
14901,357,7451,L,107,112,-5
14902,358,7451,W,112,107,5
14903,830,7452,L,95,109,-14
14904,829,7452,W,109,95,14
14905,679,7453,L,82,90,-8
14906,680,7453,W,90,82,8
14907,255,7454,L,82,102,-20
14908,256,7454,W,102,82,20
14909,58,7455,W,91,89,2
14910,57,7455,L,89,91,-2
14911,159,7456,L,95,98,-3
14912,160,7456,W,98,95,3
14913,157,7457,L,96,100,-4
14914,158,7457,W,100,96,4
14915,571,7458,L,101,105,-4
14916,572,7458,W,105,101,4
14917,202,7459,W,103,97,6
14918,201,7459,L,97,103,-6
14919,334,7460,L,105,114,-9
14920,333,7460,W,114,105,9
14921,676,7461,L,93,104,-11
14922,675,7461,W,104,93,11
14923,452,7462,W,98,86,12
14924,451,7462,L,86,98,-12
14925,412,7463,L,101,114,-13
14926,411,7463,W,114,101,13
14927,223,7464,L,120,121,-1
14928,224,7464,W,121,120,1
14929,156,7465,L,132,133,-1
14930,155,7465,W,133,132,1
14931,708,7466,W,108,92,16
14932,707,7466,L,92,108,-16
14933,713,7467,W,102,86,16
14934,714,7467,L,86,102,-16
14935,822,7468,W,110,88,22
14936,821,7468,L,88,110,-22
14937,628,7469,L,92,101,-9
14938,627,7469,W,101,92,9
14939,149,7470,L,107,112,-5
14940,150,7470,W,112,107,5
14941,155,7471,L,93,101,-8
14942,156,7471,W,101,93,8
14943,384,7472,W,104,87,17
14944,383,7472,L,87,104,-17
14945,753,7473,L,87,103,-16
14946,754,7473,W,103,87,16
14947,719,7474,W,103,99,4
14948,720,7474,L,99,103,-4
14949,355,7475,W,96,94,2
14950,356,7475,L,94,96,-2
14951,693,7476,L,84,96,-12
14952,694,7476,W,96,84,12
14953,197,7477,L,102,125,-23
14954,198,7477,W,125,102,23
14955,246,7478,W,105,96,9
14956,245,7478,L,96,105,-9
14957,253,7479,L,100,120,-20
14958,254,7479,W,120,100,20
14959,817,7480,L,101,123,-22
14960,818,7480,W,123,101,22
14961,61,7481,W,112,102,10
14962,62,7481,L,102,112,-10
14963,530,7482,L,95,100,-5
14964,529,7482,W,100,95,5
14965,266,7483,W,108,101,7
14966,265,7483,L,101,108,-7
14967,742,7484,L,101,102,-1
14968,741,7484,W,102,101,1
14969,456,7485,L,96,113,-17
14970,455,7485,W,113,96,17
14971,21,7486,W,98,75,23
14972,22,7486,L,75,98,-23
14973,691,7487,W,103,91,12
14974,692,7487,L,91,103,-12
14975,118,7488,W,118,106,12
14976,117,7488,L,106,118,-12
14977,288,7489,W,114,112,2
14978,287,7489,L,112,114,-2
14979,705,7490,L,89,119,-30
14980,706,7490,W,119,89,30
14981,704,7491,W,98,93,5
14982,703,7491,L,93,98,-5
14983,429,7492,L,102,103,-1
14984,430,7492,W,103,102,1
14985,26,7493,L,85,109,-24
14986,25,7493,W,109,85,24
14987,109,7494,W,107,101,6
14988,110,7494,L,101,107,-6
14989,572,7495,W,105,91,14
14990,571,7495,L,91,105,-14
14991,30,7496,W,90,87,3
14992,29,7496,L,87,90,-3
14993,449,7497,L,85,112,-27
14994,450,7497,W,112,85,27
14995,424,7498,L,82,88,-6
14996,423,7498,W,88,82,6
14997,488,7499,W,102,95,7
14998,487,7499,L,95,102,-7
14999,641,7500,L,102,109,-7
15000,642,7500,W,109,102,7
15001,327,7501,L,93,95,-2
15002,328,7501,W,95,93,2
15003,590,7502,L,86,114,-28
15004,589,7502,W,114,86,28
15005,198,7503,W,107,105,2
15006,197,7503,L,105,107,-2
15007,293,7504,W,123,104,19
15008,294,7504,L,104,123,-19
15009,814,7505,L,95,111,-16
15010,813,7505,W,111,95,16
15011,433,7506,L,96,105,-9
15012,434,7506,W,105,96,9
15013,480,7507,W,112,102,10
15014,479,7507,L,102,112,-10
15015,854,7508,W,85,77,8
15016,853,7508,L,77,85,-8
15017,702,7509,W,106,96,10
15018,701,7509,L,96,106,-10
15019,305,7510,W,117,109,8
15020,306,7510,L,109,117,-8
15021,209,7511,W,105,103,2
15022,210,7511,L,103,105,-2
15023,379,7512,W,132,129,3
15024,380,7512,L,129,132,-3
15025,6,7513,L,104,112,-8
15026,5,7513,W,112,104,8
15027,591,7514,W,98,93,5
15028,592,7514,L,93,98,-5
15029,623,7515,L,97,98,-1
15030,624,7515,W,98,97,1
15031,211,7516,L,99,116,-17
15032,212,7516,W,116,99,17
15033,524,7517,L,105,109,-4
15034,523,7517,W,109,105,4
15035,764,7518,L,108,111,-3
15036,763,7518,W,111,108,3
15037,37,7519,L,101,127,-26
15038,38,7519,W,127,101,26
15039,136,7520,W,103,101,2
15040,135,7520,L,101,103,-2
15041,307,7521,L,86,107,-21
15042,308,7521,W,107,86,21
15043,235,7522,W,109,103,6
15044,236,7522,L,103,109,-6
15045,33,7523,W,104,93,11
15046,34,7523,L,93,104,-11
15047,297,7524,W,102,84,18
15048,298,7524,L,84,102,-18
15049,680,7525,L,93,107,-14
15050,679,7525,W,107,93,14
15051,681,7526,W,111,89,22
15052,682,7526,L,89,111,-22
15053,665,7527,W,86,79,7
15054,666,7527,L,79,86,-7
15055,677,7528,W,93,90,3
15056,678,7528,L,90,93,-3
15057,252,7529,L,122,129,-7
15058,251,7529,W,129,122,7
15059,408,7530,W,97,85,12
15060,407,7530,L,85,97,-12
15061,668,7531,W,110,103,7
15062,667,7531,L,103,110,-7
15063,12,7532,L,97,109,-12
15064,11,7532,W,109,97,12
15065,730,7533,W,112,96,16
15066,729,7533,L,96,112,-16
15067,291,7534,L,75,105,-30
15068,292,7534,W,105,75,30
15069,242,7535,W,117,103,14
15070,241,7535,L,103,117,-14
15071,204,7536,L,80,83,-3
15072,203,7536,W,83,80,3
15073,803,7537,W,106,101,5
15074,804,7537,L,101,106,-5
15075,653,7538,W,109,102,7
15076,654,7538,L,102,109,-7
15077,739,7539,W,106,102,4
15078,740,7539,L,102,106,-4
15079,345,7540,W,102,85,17
15080,346,7540,L,85,102,-17
15081,520,7541,L,97,122,-25
15082,519,7541,W,122,97,25
15083,866,7542,L,91,100,-9
15084,865,7542,W,100,91,9
15085,225,7543,L,83,98,-15
15086,226,7543,W,98,83,15
15087,330,7544,L,78,105,-27
15088,329,7544,W,105,78,27
15089,63,7545,W,120,119,1
15090,64,7545,L,119,120,-1
15091,145,7546,W,112,99,13
15092,146,7546,L,99,112,-13
15093,485,7547,W,104,88,16
15094,486,7547,L,88,104,-16
15095,261,7548,L,104,112,-8
15096,262,7548,W,112,104,8
15097,51,7549,L,82,97,-15
15098,52,7549,W,97,82,15
15099,840,7550,L,102,109,-7
15100,839,7550,W,109,102,7
15101,377,7551,L,100,106,-6
15102,378,7551,W,106,100,6
15103,656,7552,W,105,97,8
15104,655,7552,L,97,105,-8
15105,519,7553,L,112,120,-8
15106,520,7553,W,120,112,8
15107,624,7554,W,111,96,15
15108,623,7554,L,96,111,-15
15109,716,7555,W,104,98,6
15110,715,7555,L,98,104,-6
15111,580,7556,W,126,115,11
15112,579,7556,L,115,126,-11
15113,7,7557,L,89,102,-13
15114,8,7557,W,102,89,13
15115,718,7558,W,103,86,17
15116,717,7558,L,86,103,-17
15117,404,7559,W,99,93,6
15118,403,7559,L,93,99,-6
15119,481,7560,W,99,91,8
15120,482,7560,L,91,99,-8
15121,472,7561,L,87,113,-26
15122,471,7561,W,113,87,26
15123,486,7562,L,86,98,-12
15124,485,7562,W,98,86,12
15125,500,7563,W,114,97,17
15126,499,7563,L,97,114,-17
15127,869,7564,L,109,114,-5
15128,870,7564,W,114,109,5
15129,178,7565,W,99,89,10
15130,177,7565,L,89,99,-10
15131,325,7566,W,106,102,4
15132,326,7566,L,102,106,-4
15133,364,7567,L,100,104,-4
15134,363,7567,W,104,100,4
15135,795,7568,L,74,106,-32
15136,796,7568,W,106,74,32
15137,192,7569,W,114,104,10
15138,191,7569,L,104,114,-10
15139,372,7570,L,86,91,-5
15140,371,7570,W,91,86,5
15141,311,7571,W,111,100,11
15142,312,7571,L,100,111,-11
15143,858,7572,W,113,92,21
15144,857,7572,L,92,113,-21
15145,712,7573,W,97,95,2
15146,711,7573,L,95,97,-2
15147,828,7574,W,91,86,5
15148,827,7574,L,86,91,-5
15149,269,7575,L,93,94,-1
15150,270,7575,W,94,93,1
15151,247,7576,W,94,88,6
15152,248,7576,L,88,94,-6
15153,127,7577,W,101,94,7
15154,128,7577,L,94,101,-7
15155,444,7578,L,91,107,-16
15156,443,7578,W,107,91,16
15157,115,7579,W,99,92,7
15158,116,7579,L,92,99,-7
15159,328,7580,L,87,99,-12
15160,327,7580,W,99,87,12
15161,554,7581,W,113,101,12
15162,553,7581,L,101,113,-12
15163,264,7582,W,106,94,12
15164,263,7582,L,94,106,-12
15165,212,7583,W,106,83,23
15166,211,7583,L,83,106,-23
15167,260,7584,L,92,95,-3
15168,259,7584,W,95,92,3
15169,176,7585,W,111,100,11
15170,175,7585,L,100,111,-11
15171,571,7586,W,110,93,17
15172,572,7586,L,93,110,-17
15173,83,7587,L,83,91,-8
15174,84,7587,W,91,83,8
15175,24,7588,L,100,117,-17
15176,23,7588,W,117,100,17
15177,607,7589,L,88,101,-13
15178,608,7589,W,101,88,13
15179,604,7590,L,97,117,-20
15180,603,7590,W,117,97,20
15181,471,7591,L,78,91,-13
15182,472,7591,W,91,78,13
15183,43,7592,L,89,99,-10
15184,44,7592,W,99,89,10
15185,171,7593,W,122,96,26
15186,172,7593,L,96,122,-26
15187,815,7594,L,87,105,-18
15188,816,7594,W,105,87,18
15189,186,7595,L,82,124,-42
15190,185,7595,W,124,82,42
15191,94,7596,L,106,140,-34
15192,93,7596,W,140,106,34
15193,555,7597,W,105,100,5
15194,556,7597,L,100,105,-5
15195,818,7598,W,121,92,29
15196,817,7598,L,92,121,-29
15197,688,7599,W,94,92,2
15198,687,7599,L,92,94,-2
15199,542,7600,W,110,93,17
15200,541,7600,L,93,110,-17
15201,598,7601,L,88,103,-15
15202,597,7601,W,103,88,15
15203,525,7602,W,105,102,3
15204,526,7602,L,102,105,-3
15205,240,7603,L,100,107,-7
15206,239,7603,W,107,100,7
15207,143,7604,W,101,90,11
15208,144,7604,L,90,101,-11
15209,437,7605,L,86,88,-2
15210,438,7605,W,88,86,2
15211,867,7606,L,99,115,-16
15212,868,7606,W,115,99,16
15213,589,7607,W,114,90,24
15214,590,7607,L,90,114,-24
15215,414,7608,W,88,86,2
15216,413,7608,L,86,88,-2
15217,301,7609,W,92,90,2
15218,302,7609,L,90,92,-2
15219,189,7610,L,92,96,-4
15220,190,7610,W,96,92,4
15221,228,7611,W,122,118,4
15222,227,7611,L,118,122,-4
15223,130,7612,W,98,92,6
15224,129,7612,L,92,98,-6
15225,68,7613,L,113,117,-4
15226,67,7613,W,117,113,4
15227,757,7614,W,114,109,5
15228,758,7614,L,109,114,-5
15229,177,7615,W,106,100,6
15230,178,7615,L,100,106,-6
15231,52,7616,L,81,98,-17
15232,51,7616,W,98,81,17
15233,319,7617,W,106,97,9
15234,320,7617,L,97,106,-9
15235,396,7618,W,95,83,12
15236,395,7618,L,83,95,-12
15237,762,7619,W,105,89,16
15238,761,7619,L,89,105,-16
15239,236,7620,L,75,100,-25
15240,235,7620,W,100,75,25
15241,475,7621,L,93,102,-9
15242,476,7621,W,102,93,9
15243,492,7622,W,107,93,14
15244,491,7622,L,93,107,-14
15245,20,7623,W,107,80,27
15246,19,7623,L,80,107,-27
15247,434,7624,L,93,119,-26
15248,433,7624,W,119,93,26
15249,625,7625,W,118,114,4
15250,626,7625,L,114,118,-4
15251,25,7626,W,91,84,7
15252,26,7626,L,84,91,-7
15253,756,7627,L,93,109,-16
15254,755,7627,W,109,93,16
15255,134,7628,W,69,65,4
15256,133,7628,L,65,69,-4
15257,422,7629,W,136,115,21
15258,421,7629,L,115,136,-21
15259,223,7630,L,107,120,-13
15260,224,7630,W,120,107,13
15261,262,7631,L,91,94,-3
15262,261,7631,W,94,91,3
15263,804,7632,L,87,112,-25
15264,803,7632,W,112,87,25
15265,493,7633,L,94,127,-33
15266,494,7633,W,127,94,33
15267,57,7634,L,93,98,-5
15268,58,7634,W,98,93,5
15269,549,7635,L,88,95,-7
15270,550,7635,W,95,88,7
15271,75,7636,W,99,90,9
15272,76,7636,L,90,99,-9
15273,294,7637,L,93,111,-18
15274,293,7637,W,111,93,18
15275,382,7638,L,117,131,-14
15276,381,7638,W,131,117,14
15277,164,7639,L,87,97,-10
15278,163,7639,W,97,87,10
15279,151,7640,L,87,88,-1
15280,152,7640,W,88,87,1
15281,479,7641,L,103,114,-11
15282,480,7641,W,114,103,11
15283,304,7642,L,91,139,-48
15284,303,7642,W,139,91,48
15285,138,7643,L,85,101,-16
15286,137,7643,W,101,85,16
15287,661,7644,W,103,95,8
15288,662,7644,L,95,103,-8
15289,347,7645,W,102,100,2
15290,348,7645,L,100,102,-2
15291,16,7646,W,93,80,13
15292,15,7646,L,80,93,-13
15293,356,7647,W,96,89,7
15294,355,7647,L,89,96,-7
15295,354,7648,W,122,121,1
15296,353,7648,L,121,122,-1
15297,622,7649,W,108,87,21
15298,621,7649,L,87,108,-21
15299,667,7650,L,70,123,-53
15300,668,7650,W,123,70,53
15301,122,7651,L,99,107,-8
15302,121,7651,W,107,99,8
15303,559,7652,W,100,93,7
15304,560,7652,L,93,100,-7
15305,407,7653,L,110,111,-1
15306,408,7653,W,111,110,1
15307,209,7654,W,130,113,17
15308,210,7654,L,113,130,-17
15309,139,7655,W,81,75,6
15310,140,7655,L,75,81,-6
15311,288,7656,W,113,101,12
15312,287,7656,L,101,113,-12
15313,299,7657,W,109,94,15
15314,300,7657,L,94,109,-15
15315,535,7658,W,97,95,2
15316,536,7658,L,95,97,-2
15317,743,7659,L,97,100,-3
15318,744,7659,W,100,97,3
15319,552,7660,L,104,112,-8
15320,551,7660,W,112,104,8
15321,617,7661,L,103,107,-4
15322,618,7661,W,107,103,4
15323,383,7662,L,102,109,-7
15324,384,7662,W,109,102,7
15325,222,7663,L,98,106,-8
15326,221,7663,W,106,98,8
15327,722,7664,W,113,100,13
15328,721,7664,L,100,113,-13
15329,403,7665,L,102,107,-5
15330,404,7665,W,107,102,5
15331,655,7666,L,100,102,-2
15332,656,7666,W,102,100,2
15333,214,7667,L,100,104,-4
15334,213,7667,W,104,100,4
15335,411,7668,L,78,85,-7
15336,412,7668,W,85,78,7
15337,420,7669,L,111,118,-7
15338,419,7669,W,118,111,7
15339,547,7670,W,89,85,4
15340,548,7670,L,85,89,-4
15341,614,7671,L,86,97,-11
15342,613,7671,W,97,86,11
15343,670,7672,L,91,102,-11
15344,669,7672,W,102,91,11
15345,272,7673,W,91,85,6
15346,271,7673,L,85,91,-6
15347,210,7674,L,100,116,-16
15348,209,7674,W,116,100,16
15349,425,7675,L,93,101,-8
15350,426,7675,W,101,93,8
15351,180,7676,L,96,104,-8
15352,179,7676,W,104,96,8
15353,418,7677,W,105,96,9
15354,417,7677,L,96,105,-9
15355,321,7678,W,97,96,1
15356,322,7678,L,96,97,-1
15357,40,7679,L,88,120,-32
15358,39,7679,W,120,88,32
15359,859,7680,L,92,107,-15
15360,860,7680,W,107,92,15
15361,401,7681,L,95,107,-12
15362,402,7681,W,107,95,12
15363,654,7682,W,106,101,5
15364,653,7682,L,101,106,-5
15365,17,7683,L,102,106,-4
15366,18,7683,W,106,102,4
15367,162,7684,L,92,93,-1
15368,161,7684,W,93,92,1
15369,238,7685,W,97,90,7
15370,237,7685,L,90,97,-7
15371,56,7686,W,100,99,1
15372,55,7686,L,99,100,-1
15373,484,7687,W,98,87,11
15374,483,7687,L,87,98,-11
15375,271,7688,L,96,103,-7
15376,272,7688,W,103,96,7
15377,431,7689,L,92,102,-10
15378,432,7689,W,102,92,10
15379,592,7690,L,99,110,-11
15380,591,7690,W,110,99,11
15381,208,7691,W,91,89,2
15382,207,7691,L,89,91,-2
15383,42,7692,L,98,101,-3
15384,41,7692,W,101,98,3
15385,637,7693,L,84,103,-19
15386,638,7693,W,103,84,19
15387,332,7694,L,103,112,-9
15388,331,7694,W,112,103,9
15389,513,7695,W,118,115,3
15390,514,7695,L,115,118,-3
15391,292,7696,L,119,122,-3
15392,291,7696,W,122,119,3
15393,485,7697,L,95,98,-3
15394,486,7697,W,98,95,3
15395,183,7698,W,105,82,23
15396,184,7698,L,82,105,-23
15397,320,7699,W,110,101,9
15398,319,7699,L,101,110,-9
15399,54,7700,W,114,112,2
15400,53,7700,L,112,114,-2
15401,170,7701,L,81,98,-17
15402,169,7701,W,98,81,17
15403,174,7702,L,87,108,-21
15404,173,7702,W,108,87,21
15405,4,7703,W,91,89,2
15406,3,7703,L,89,91,-2
15407,633,7704,L,92,94,-2
15408,634,7704,W,94,92,2
15409,586,7705,W,102,91,11
15410,585,7705,L,91,102,-11
15411,237,7706,L,94,96,-2
15412,238,7706,W,96,94,2
15413,275,7707,L,104,121,-17
15414,276,7707,W,121,104,17
15415,296,7708,L,95,98,-3
15416,295,7708,W,98,95,3
15417,132,7709,W,110,107,3
15418,131,7709,L,107,110,-3
15419,376,7710,L,100,102,-2
15420,375,7710,W,102,100,2
15421,726,7711,W,98,91,7
15422,725,7711,L,91,98,-7
15423,31,7712,L,109,131,-22
15424,32,7712,W,131,109,22
15425,270,7713,L,89,96,-7
15426,269,7713,W,96,89,7
15427,615,7714,W,95,86,9
15428,616,7714,L,86,95,-9
15429,280,7715,W,98,83,15
15430,279,7715,L,83,98,-15
15431,738,7716,L,90,98,-8
15432,737,7716,W,98,90,8
15433,644,7717,L,88,100,-12
15434,643,7717,W,100,88,12
15435,503,7718,W,112,106,6
15436,504,7718,L,106,112,-6
15437,360,7719,W,87,81,6
15438,359,7719,L,81,87,-6
15439,848,7720,L,91,100,-9
15440,847,7720,W,100,91,9
15441,832,7721,L,82,101,-19
15442,831,7721,W,101,82,19
15443,820,7722,W,108,91,17
15444,819,7722,L,91,108,-17
15445,234,7723,L,81,93,-12
15446,233,7723,W,93,81,12
15447,729,7724,L,101,107,-6
15448,730,7724,W,107,101,6
15449,152,7725,W,104,93,11
15450,151,7725,L,93,104,-11
15451,745,7726,L,113,118,-5
15452,746,7726,W,118,113,5
15453,32,7727,W,110,105,5
15454,31,7727,L,105,110,-5
15455,687,7728,L,85,116,-31
15456,688,7728,W,116,85,31
15457,430,7729,L,93,96,-3
15458,429,7729,W,96,93,3
15459,231,7730,L,102,107,-5
15460,232,7730,W,107,102,5
15461,469,7731,W,98,92,6
15462,470,7731,L,92,98,-6
15463,611,7732,W,95,90,5
15464,612,7732,L,90,95,-5
15465,213,7733,W,108,95,13
15466,214,7733,L,95,108,-13
15467,558,7734,W,114,96,18
15468,557,7734,L,96,114,-18
15469,239,7735,L,91,102,-11
15470,240,7735,W,102,91,11
15471,576,7736,W,102,90,12
15472,575,7736,L,90,102,-12
15473,707,7737,L,92,102,-10
15474,708,7737,W,102,92,10
15475,349,7738,W,106,105,1
15476,350,7738,L,105,106,-1
15477,421,7739,L,104,127,-23
15478,422,7739,W,127,104,23
15479,175,7740,L,97,108,-11
15480,176,7740,W,108,97,11
15481,1,7741,L,91,118,-27
15482,2,7741,W,118,91,27
15483,358,7742,W,109,104,5
15484,357,7742,L,104,109,-5
15485,728,7743,W,71,69,2
15486,727,7743,L,69,71,-2
15487,406,7744,L,90,104,-14
15488,405,7744,W,104,90,14
15489,602,7745,L,89,94,-5
15490,601,7745,W,94,89,5
15491,316,7746,L,94,103,-9
15492,315,7746,W,103,94,9
15493,273,7747,W,114,108,6
15494,274,7747,L,108,114,-6
15495,119,7748,W,118,111,7
15496,120,7748,L,111,118,-7
15497,810,7749,W,97,89,8
15498,809,7749,L,89,97,-8
15499,465,7750,L,81,93,-12
15500,466,7750,W,93,81,12
15501,147,7751,L,90,93,-3
15502,148,7751,W,93,90,3
15503,29,7752,W,95,90,5
15504,30,7752,L,90,95,-5
15505,111,7753,L,91,97,-6
15506,112,7753,W,97,91,6
15507,184,7754,L,102,120,-18
15508,183,7754,W,120,102,18
15509,58,7755,W,105,98,7
15510,57,7755,L,98,105,-7
15511,461,7756,W,104,93,11
15512,462,7756,L,93,104,-11
15513,308,7757,L,95,107,-12
15514,307,7757,W,107,95,12
15515,436,7758,W,95,77,18
15516,435,7758,L,77,95,-18
15517,249,7759,L,91,103,-12
15518,250,7759,W,103,91,12
15519,387,7760,L,106,108,-2
15520,388,7760,W,108,106,2
15521,579,7761,L,102,109,-7
15522,580,7761,W,109,102,7
15523,91,7762,L,105,121,-16
15524,92,7762,W,121,105,16
15525,630,7763,L,89,106,-17
15526,629,7763,W,106,89,17
15527,685,7764,L,101,105,-4
15528,686,7764,W,105,101,4
15529,399,7765,W,104,80,24
15530,400,7765,L,80,104,-24
15531,439,7766,L,79,89,-10
15532,440,7766,W,89,79,10
15533,504,7767,L,99,119,-20
15534,503,7767,W,119,99,20
15535,277,7768,L,100,101,-1
15536,278,7768,W,101,100,1
15537,129,7769,W,108,90,18
15538,130,7769,L,90,108,-18
15539,154,7770,L,84,101,-17
15540,153,7770,W,101,84,17
15541,619,7771,L,87,104,-17
15542,620,7771,W,104,87,17
15543,620,7772,W,107,86,21
15544,619,7772,L,86,107,-21
15545,620,7773,W,111,92,19
15546,619,7773,L,92,111,-19
15547,619,7774,W,98,96,2
15548,620,7774,L,96,98,-2
15549,619,7775,L,95,110,-15
15550,620,7775,W,110,95,15
15551,457,7776,W,112,107,5
15552,458,7776,L,107,112,-5
15553,139,7777,L,92,117,-25
15554,140,7777,W,117,92,25
15555,458,7778,L,89,117,-28
15556,457,7778,W,117,89,28
15557,140,7779,L,90,93,-3
15558,139,7779,W,93,90,3
15559,457,7780,L,92,105,-13
15560,458,7780,W,105,92,13
15561,139,7781,L,90,102,-12
15562,140,7781,W,102,90,12
15563,457,7782,L,97,106,-9
15564,458,7782,W,106,97,9
15565,139,7783,L,87,99,-12
15566,140,7783,W,99,87,12
15567,458,7784,L,77,112,-35
15568,457,7784,W,112,77,35
15569,140,7785,W,87,83,4
15570,139,7785,L,83,87,-4
15571,458,7786,L,105,122,-17
15572,457,7786,W,122,105,17
15573,140,7787,L,96,107,-11
15574,139,7787,W,107,96,11
15575,237,7788,W,93,80,13
15576,238,7788,L,80,93,-13
15577,147,7789,W,104,98,6
15578,148,7789,L,98,104,-6
15579,534,7790,L,82,104,-22
15580,533,7790,W,104,82,22
15581,395,7791,L,94,96,-2
15582,396,7791,W,96,94,2
15583,238,7792,W,102,79,23
15584,237,7792,L,79,102,-23
15585,148,7793,L,104,105,-1
15586,147,7793,W,105,104,1
15587,396,7794,W,102,96,6
15588,395,7794,L,96,102,-6
15589,533,7795,L,92,103,-11
15590,534,7795,W,103,92,11
15591,147,7796,L,99,101,-2
15592,148,7796,W,101,99,2
15593,237,7797,W,95,92,3
15594,238,7797,L,92,95,-3
15595,533,7798,W,118,103,15
15596,534,7798,L,103,118,-15
15597,396,7799,L,90,104,-14
15598,395,7799,W,104,90,14
15599,147,7800,W,118,112,6
15600,148,7800,L,112,118,-6
15601,237,7801,W,85,63,22
15602,238,7801,L,63,85,-22
15603,395,7802,L,82,94,-12
15604,396,7802,W,94,82,12
15605,534,7803,L,97,114,-17
15606,533,7803,W,114,97,17
15607,238,7804,L,82,86,-4
15608,237,7804,W,86,82,4
15609,148,7805,L,101,112,-11
15610,147,7805,W,112,101,11
15611,534,7806,L,92,116,-24
15612,533,7806,W,116,92,24
15613,395,7807,L,86,107,-21
15614,396,7807,W,107,86,21
15615,148,7808,W,122,105,17
15616,147,7808,L,105,122,-17
15617,238,7809,W,102,96,6
15618,237,7809,L,96,102,-6
15619,277,7810,L,96,119,-23
15620,278,7810,W,119,96,23
15621,142,7811,W,104,103,1
15622,141,7811,L,103,104,-1
15623,208,7812,L,109,120,-11
15624,207,7812,W,120,109,11
15625,708,7813,L,80,92,-12
15626,707,7813,W,92,80,12
15627,276,7814,L,121,126,-5
15628,275,7814,W,126,121,5
15629,141,7815,L,83,97,-14
15630,142,7815,W,97,83,14
15631,278,7816,L,111,113,-2
15632,277,7816,W,113,111,2
15633,73,7817,L,98,99,-1
15634,74,7817,W,99,98,1
15635,275,7818,L,99,100,-1
15636,276,7818,W,100,99,1
15637,207,7819,W,104,84,20
15638,208,7819,L,84,104,-20
15639,707,7820,W,95,88,7
15640,708,7820,L,88,95,-7
15641,142,7821,L,113,115,-2
15642,141,7821,W,115,113,2
15643,74,7822,L,98,108,-10
15644,73,7822,W,108,98,10
15645,277,7823,L,103,109,-6
15646,278,7823,W,109,103,6
15647,10,7824,W,75,69,6
15648,9,7824,L,69,75,-6
15649,208,7825,W,100,99,1
15650,207,7825,L,99,100,-1
15651,276,7826,L,103,113,-10
15652,275,7826,W,113,103,10
15653,708,7827,W,107,97,10
15654,707,7827,L,97,107,-10
15655,871,7828,W,109,98,11
15656,872,7828,L,98,109,-11
15657,278,7829,W,93,89,4
15658,277,7829,L,89,93,-4
15659,141,7830,W,87,79,8
15660,142,7830,L,79,87,-8
15661,73,7831,L,120,123,-3
15662,74,7831,W,123,120,3
15663,9,7832,L,89,98,-9
15664,10,7832,W,98,89,9
15665,275,7833,L,97,118,-21
15666,276,7833,W,118,97,21
15667,278,7834,L,108,109,-1
15668,277,7834,W,109,108,1
15669,207,7835,W,92,89,3
15670,208,7835,L,89,92,-3
15671,871,7836,W,98,85,13
15672,872,7836,L,85,98,-13
15673,707,7837,W,91,88,3
15674,708,7837,L,88,91,-3
15675,9,7838,W,100,97,3
15676,10,7838,L,97,100,-3
15677,141,7839,L,98,102,-4
15678,142,7839,W,102,98,4
15679,73,7840,W,121,116,5
15680,74,7840,L,116,121,-5
15681,707,7841,L,85,98,-13
15682,708,7841,W,98,85,13
15683,275,7842,W,98,96,2
15684,276,7842,L,96,98,-2
15685,207,7843,L,95,98,-3
15686,208,7843,W,98,95,3
15687,872,7844,L,97,101,-4
15688,871,7844,W,101,97,4
15689,74,7845,W,112,105,7
15690,73,7845,L,105,112,-7
15691,277,7846,W,113,92,21
15692,278,7846,L,92,113,-21
15693,10,7847,W,101,99,2
15694,9,7847,L,99,101,-2
15695,142,7848,L,95,100,-5
15696,141,7848,W,100,95,5
15697,708,7849,L,85,101,-16
15698,707,7849,W,101,85,16
15699,208,7850,W,111,105,6
15700,207,7850,L,105,111,-6
15701,276,7851,L,98,138,-40
15702,275,7851,W,138,98,40
15703,10,7852,W,102,93,9
15704,9,7852,L,93,102,-9
15705,74,7853,W,122,120,2
15706,73,7853,L,120,122,-2
15707,277,7854,L,85,90,-5
15708,278,7854,W,90,85,5
15709,872,7855,L,88,99,-11
15710,871,7855,W,99,88,11
15711,208,7856,L,86,100,-14
15712,207,7856,W,100,86,14
15713,142,7857,W,94,87,7
15714,141,7857,L,87,94,-7
15715,708,7858,W,101,93,8
15716,707,7858,L,93,101,-8
15717,276,7859,W,109,105,4
15718,275,7859,L,105,109,-4
15719,226,7860,W,101,86,15
15720,225,7860,L,86,101,-15
15721,562,7861,L,100,105,-5
15722,561,7861,W,105,100,5
15723,80,7862,W,136,130,6
15724,79,7862,L,130,136,-6
15725,369,7863,W,116,112,4
15726,370,7863,L,112,116,-4
15727,736,7864,W,111,103,8
15728,735,7864,L,103,111,-8
15729,14,7865,L,92,95,-3
15730,13,7865,W,95,92,3
15731,155,7866,W,118,102,16
15732,156,7866,L,102,118,-16
15733,53,7867,W,104,99,5
15734,54,7867,L,99,104,-5
15735,821,7868,L,85,114,-29
15736,822,7868,W,114,85,29
15737,15,7869,W,113,100,13
15738,16,7869,L,100,113,-13
15739,356,7870,L,111,112,-1
15740,355,7870,W,112,111,1
15741,334,7871,L,105,106,-1
15742,333,7871,W,106,105,1
15743,873,7872,L,86,91,-5
15744,874,7872,W,91,86,5
15745,18,7873,L,104,110,-6
15746,17,7873,W,110,104,6
15747,557,7874,W,100,87,13
15748,558,7874,L,87,100,-13
15749,592,7875,W,109,98,11
15750,591,7875,L,98,109,-11
15751,88,7876,L,105,117,-12
15752,87,7876,W,117,105,12
15753,6,7877,L,89,101,-12
15754,5,7877,W,101,89,12
15755,170,7878,L,98,104,-6
15756,169,7878,W,104,98,6
15757,586,7879,W,97,91,6
15758,585,7879,L,91,97,-6
15759,229,7880,W,119,104,15
15760,230,7880,L,104,119,-15
15761,307,7881,L,93,114,-21
15762,308,7881,W,114,93,21
15763,143,7882,L,108,113,-5
15764,144,7882,W,113,108,5
15765,738,7883,L,95,108,-13
15766,737,7883,W,108,95,13
15767,186,7884,L,100,110,-10
15768,185,7884,W,110,100,10
15769,875,7885,W,95,93,2
15770,876,7885,L,93,95,-2
15771,714,7886,L,120,130,-10
15772,713,7886,W,130,120,10
15773,180,7887,L,88,97,-9
15774,179,7887,W,97,88,9
15775,802,7888,L,97,102,-5
15776,801,7888,W,102,97,5
15777,399,7889,L,89,100,-11
15778,400,7889,W,100,89,11
15779,611,7890,L,117,119,-2
15780,612,7890,W,119,117,2
15781,565,7891,W,116,107,9
15782,566,7891,L,107,116,-9
15783,553,7892,L,103,106,-3
15784,554,7892,W,106,103,3
15785,404,7893,W,102,90,12
15786,403,7893,L,90,102,-12
15787,469,7894,L,101,117,-16
15788,470,7894,W,117,101,16
15789,118,7895,L,98,101,-3
15790,117,7895,W,101,98,3
15791,561,7896,L,104,111,-7
15792,562,7896,W,111,104,7
15793,877,7897,L,105,111,-6
15794,878,7897,W,111,105,6
15795,135,7898,L,94,101,-7
15796,136,7898,W,101,94,7
15797,175,7899,L,91,104,-13
15798,176,7899,W,104,91,13
15799,479,7900,L,85,98,-13
15800,480,7900,W,98,85,13
15801,353,7901,W,111,99,12
15802,354,7901,L,99,111,-12
15803,288,7902,L,110,112,-2
15804,287,7902,W,112,110,2
15805,879,7903,L,103,106,-3
15806,880,7903,W,106,103,3
15807,670,7904,L,98,106,-8
15808,669,7904,W,106,98,8
15809,532,7905,L,95,117,-22
15810,531,7905,W,117,95,22
15811,21,7906,W,93,88,5
15812,22,7906,L,88,93,-5
15813,58,7907,W,96,86,10
15814,57,7907,L,86,96,-10
15815,13,7908,W,108,100,8
15816,14,7908,L,100,108,-8
15817,763,7909,L,116,119,-3
15818,764,7909,W,119,116,3
15819,98,7910,W,111,99,12
15820,97,7910,L,99,111,-12
15821,422,7911,W,112,95,17
15822,421,7911,L,95,112,-17
15823,5,7912,L,94,116,-22
15824,6,7912,W,116,94,22
15825,139,7913,L,86,98,-12
15826,140,7913,W,98,86,12
15827,601,7914,L,104,112,-8
15828,602,7914,W,112,104,8
15829,278,7915,W,109,100,9
15830,277,7915,L,100,109,-9
15831,370,7916,W,100,99,1
15832,369,7916,L,99,100,-1
15833,524,7917,L,97,105,-8
15834,523,7917,W,105,97,8
15835,49,7918,L,116,123,-7
15836,50,7918,W,123,116,7
15837,28,7919,W,94,88,6
15838,27,7919,L,88,94,-6
15839,315,7920,L,99,100,-1
15840,316,7920,W,100,99,1
15841,179,7921,L,111,115,-4
15842,180,7921,W,115,111,4
15843,40,7922,L,114,125,-11
15844,39,7922,W,125,114,11
15845,349,7923,W,102,87,15
15846,350,7923,L,87,102,-15
15847,881,7924,W,94,88,6
15848,882,7924,L,88,94,-6
15849,147,7925,W,107,101,6
15850,148,7925,L,101,107,-6
15851,753,7926,L,102,107,-5
15852,754,7926,W,107,102,5
15853,359,7927,W,104,102,2
15854,360,7927,L,102,104,-2
15855,72,7928,L,100,122,-22
15856,71,7928,W,122,100,22
15857,395,7929,W,88,87,1
15858,396,7929,L,87,88,-1
15859,183,7930,W,95,83,12
15860,184,7930,L,83,95,-12
15861,43,7931,W,102,95,7
15862,44,7931,L,95,102,-7
15863,129,7932,W,145,130,15
15864,130,7932,L,130,145,-15
15865,818,7933,L,91,110,-19
15866,817,7933,W,110,91,19
15867,426,7934,W,107,92,15
15868,425,7934,L,92,107,-15
15869,607,7935,L,102,130,-28
15870,608,7935,W,130,102,28
15871,475,7936,L,94,100,-6
15872,476,7936,W,100,94,6
15873,110,7937,L,92,112,-20
15874,109,7937,W,112,92,20
15875,181,7938,L,115,122,-7
15876,182,7938,W,122,115,7
15877,666,7939,L,91,102,-11
15878,665,7939,W,102,91,11
15879,221,7940,W,93,91,2
15880,222,7940,L,91,93,-2
15881,708,7941,W,107,88,19
15882,707,7941,L,88,107,-19
15883,50,7942,L,125,130,-5
15884,49,7942,W,130,125,5
15885,120,7943,L,97,120,-23
15886,119,7943,W,120,97,23
15887,185,7944,W,102,98,4
15888,186,7944,L,98,102,-4
15889,481,7945,W,105,101,4
15890,482,7945,L,101,105,-4
15891,332,7946,L,92,100,-8
15892,331,7946,W,100,92,8
15893,9,7947,W,96,78,18
15894,10,7947,L,78,96,-18
15895,642,7948,L,111,115,-4
15896,641,7948,W,115,111,4
15897,883,7949,W,96,94,2
15898,884,7949,L,94,96,-2
15899,616,7950,L,90,102,-12
15900,615,7950,W,102,90,12
15901,283,7951,W,109,93,16
15902,284,7951,L,93,109,-16
15903,494,7952,L,98,117,-19
15904,493,7952,W,117,98,19
15905,133,7953,L,107,111,-4
15906,134,7953,W,111,107,4
15907,453,7954,L,94,102,-8
15908,454,7954,W,102,94,8
15909,431,7955,W,122,121,1
15910,432,7955,L,121,122,-1
15911,264,7956,L,96,100,-4
15912,263,7956,W,100,96,4
15913,280,7957,W,90,89,1
15914,279,7957,L,89,90,-1
15915,577,7958,L,92,100,-8
15916,578,7958,W,100,92,8
15917,144,7959,W,111,102,9
15918,143,7959,L,102,111,-9
15919,435,7960,L,69,102,-33
15920,436,7960,W,102,69,33
15921,885,7961,L,80,91,-11
15922,886,7961,W,91,80,11
15923,575,7962,L,104,116,-12
15924,576,7962,W,116,104,12
15925,93,7963,W,107,95,12
15926,94,7963,L,95,107,-12
15927,65,7964,W,113,107,6
15928,66,7964,L,107,113,-6
15929,457,7965,L,94,106,-12
15930,458,7965,W,106,94,12
15931,160,7966,L,102,107,-5
15932,159,7966,W,107,102,5
15933,156,7967,L,92,118,-26
15934,155,7967,W,118,92,26
15935,25,7968,L,77,96,-19
15936,26,7968,W,96,77,19
15937,797,7969,L,103,107,-4
15938,798,7969,W,107,103,4
15939,591,7970,L,81,110,-29
15940,592,7970,W,110,81,29
15941,224,7971,W,112,108,4
15942,223,7971,L,108,112,-4
15943,686,7972,L,88,102,-14
15944,685,7972,W,102,88,14
15945,796,7973,W,119,98,21
15946,795,7973,L,98,119,-21
15947,878,7974,W,123,93,30
15948,877,7974,L,93,123,-30
15949,792,7975,L,94,101,-7
15950,791,7975,W,101,94,7
15951,102,7976,W,105,92,13
15952,101,7976,L,92,105,-13
15953,721,7977,L,90,111,-21
15954,722,7977,W,111,90,21
15955,604,7978,L,107,137,-30
15956,603,7978,W,137,107,30
15957,45,7979,W,124,112,12
15958,46,7979,L,112,124,-12
15959,734,7980,L,96,105,-9
15960,733,7980,W,105,96,9
15961,652,7981,W,122,120,2
15962,651,7981,L,120,122,-2
15963,38,7982,W,114,104,10
15964,37,7982,L,104,114,-10
15965,178,7983,W,102,97,5
15966,177,7983,L,97,102,-5
15967,578,7984,W,94,92,2
15968,577,7984,L,92,94,-2
15969,882,7985,L,94,100,-6
15970,881,7985,W,100,94,6
15971,485,7986,L,111,116,-5
15972,486,7986,W,116,111,5
15973,348,7987,W,92,83,9
15974,347,7987,L,83,92,-9
15975,231,7988,L,83,93,-10
15976,232,7988,W,93,83,10
15977,378,7989,W,103,77,26
15978,377,7989,L,77,103,-26
15979,654,7990,L,80,94,-14
15980,653,7990,W,94,80,14
15981,446,7991,L,95,103,-8
15982,445,7991,W,103,95,8
15983,653,7992,W,107,102,5
15984,654,7992,L,102,107,-5
15985,503,7993,L,99,115,-16
15986,504,7993,W,115,99,16
15987,145,7994,L,98,105,-7
15988,146,7994,W,105,98,7
15989,213,7995,W,98,93,5
15990,214,7995,L,93,98,-5
15991,726,7996,L,99,114,-15
15992,725,7996,W,114,99,15
15993,51,7997,L,96,116,-20
15994,52,7997,W,116,96,20
15995,12,7998,L,76,90,-14
15996,11,7998,W,90,76,14
15997,771,7999,W,89,84,5
15998,772,7999,L,84,89,-5
15999,345,8000,W,118,107,11
16000,346,8000,L,107,118,-11
16001,265,8001,L,98,123,-25
16002,266,8001,W,123,98,25
16003,325,8002,L,97,101,-4
16004,326,8002,W,101,97,4
16005,26,8003,W,88,67,21
16006,25,8003,L,67,88,-21
16007,222,8004,L,100,103,-3
16008,221,8004,W,103,100,3
16009,56,8005,L,80,96,-16
16010,55,8005,W,96,80,16
16011,816,8006,W,91,74,17
16012,815,8006,L,74,91,-17
16013,886,8007,L,105,110,-5
16014,885,8007,W,110,105,5
16015,220,8008,W,133,102,31
16016,219,8008,L,102,133,-31
16017,640,8009,L,88,112,-24
16018,639,8009,W,112,88,24
16019,131,8010,L,103,105,-2
16020,132,8010,W,105,103,2
16021,822,8011,L,97,108,-11
16022,821,8011,W,108,97,11
16023,842,8012,W,110,78,32
16024,841,8012,L,78,110,-32
16025,263,8013,L,95,102,-7
16026,264,8013,W,102,95,7
16027,237,8014,L,78,91,-13
16028,238,8014,W,91,78,13
16029,64,8015,L,107,143,-36
16030,63,8015,W,143,107,36
16031,425,8016,L,81,94,-13
16032,426,8016,W,94,81,13
16033,664,8017,L,93,100,-7
16034,663,8017,W,100,93,7
16035,66,8018,W,109,103,6
16036,65,8018,L,103,109,-6
16037,151,8019,L,98,120,-22
16038,152,8019,W,120,98,22
16039,338,8020,L,105,108,-3
16040,337,8020,W,108,105,3
16041,397,8021,W,100,85,15
16042,398,8021,L,85,100,-15
16043,254,8022,L,96,98,-2
16044,253,8022,W,98,96,2
16045,215,8023,W,91,87,4
16046,216,8023,L,87,91,-4
16047,543,8024,L,83,107,-24
16048,544,8024,W,107,83,24
16049,132,8025,W,99,90,9
16050,131,8025,L,90,99,-9
16051,887,8026,L,111,116,-5
16052,888,8026,W,116,111,5
16053,765,8027,W,107,99,8
16054,766,8027,L,99,107,-8
16055,257,8028,W,99,93,6
16056,258,8028,L,93,99,-6
16057,219,8029,L,103,108,-5
16058,220,8029,W,108,103,5
16059,71,8030,W,97,96,1
16060,72,8030,L,96,97,-1
16061,140,8031,L,83,84,-1
16062,139,8031,W,84,83,1
16063,571,8032,L,100,102,-2
16064,572,8032,W,102,100,2
16065,373,8033,L,85,95,-10
16066,374,8033,W,95,85,10
16067,582,8034,L,119,128,-9
16068,581,8034,W,128,119,9
16069,610,8035,L,96,127,-31
16070,609,8035,W,127,96,31
16071,75,8036,L,77,89,-12
16072,76,8036,W,89,77,12
16073,236,8037,L,91,113,-22
16074,235,8037,W,113,91,22
16075,322,8038,W,114,94,20
16076,321,8038,L,94,114,-20
16077,685,8039,L,92,109,-17
16078,686,8039,W,109,92,17
16079,889,8040,W,100,89,11
16080,890,8040,L,89,100,-11
16081,512,8041,L,91,93,-2
16082,511,8041,W,93,91,2
16083,749,8042,L,104,109,-5
16084,750,8042,W,109,104,5
16085,790,8043,L,98,106,-8
16086,789,8043,W,106,98,8
16087,649,8044,W,102,95,7
16088,650,8044,L,95,102,-7
16089,239,8045,L,96,117,-21
16090,240,8045,W,117,96,21
16091,645,8046,L,94,103,-9
16092,646,8046,W,103,94,9
16093,30,8047,W,106,100,6
16094,29,8047,L,100,106,-6
16095,579,8048,L,86,96,-10
16096,580,8048,W,96,86,10
16097,709,8049,W,107,104,3
16098,710,8049,L,104,107,-3
16099,706,8050,L,102,105,-3
16100,705,8050,W,105,102,3
16101,510,8051,L,107,124,-17
16102,509,8051,W,124,107,17
16103,780,8052,W,127,120,7
16104,779,8052,L,120,127,-7
16105,773,8053,W,118,111,7
16106,774,8053,L,111,118,-7
16107,715,8054,L,103,112,-9
16108,716,8054,W,112,103,9
16109,90,8055,L,95,105,-10
16110,89,8055,W,105,95,10
16111,514,8056,L,81,91,-10
16112,513,8056,W,91,81,10
16113,704,8057,L,88,89,-1
16114,703,8057,W,89,88,1
16115,809,8058,L,71,82,-11
16116,810,8058,W,82,71,11
16117,891,8059,L,94,124,-30
16118,892,8059,W,124,94,30
16119,722,8060,W,99,90,9
16120,721,8060,L,90,99,-9
16121,754,8061,L,86,91,-5
16122,753,8061,W,91,86,5
16123,813,8062,W,117,107,10
16124,814,8062,L,107,117,-10
16125,262,8063,W,99,79,20
16126,261,8063,L,79,99,-20
16127,267,8064,L,106,122,-16
16128,268,8064,W,122,106,16
16129,644,8065,W,119,118,1
16130,643,8065,L,118,119,-1
16131,866,8066,W,111,105,6
16132,865,8066,L,105,111,-6
16133,84,8067,W,93,92,1
16134,83,8067,L,92,93,-1
16135,413,8068,L,92,98,-6
16136,414,8068,W,98,92,6
16137,92,8069,L,98,114,-16
16138,91,8069,W,114,98,16
16139,76,8070,L,79,91,-12
16140,75,8070,W,91,79,12
16141,96,8071,L,110,115,-5
16142,95,8071,W,115,110,5
16143,351,8072,L,103,116,-13
16144,352,8072,W,116,103,13
16145,287,8073,L,106,129,-23
16146,288,8073,W,129,106,23
16147,540,8074,W,102,95,7
16148,539,8074,L,95,102,-7
16149,513,8075,W,102,94,8
16150,514,8075,L,94,102,-8
16151,677,8076,L,93,109,-16
16152,678,8076,W,109,93,16
16153,114,8077,W,107,100,7
16154,113,8077,L,100,107,-7
16155,888,8078,L,99,104,-5
16156,887,8078,W,104,99,5
16157,126,8079,L,96,101,-5
16158,125,8079,W,101,96,5
16159,16,8080,W,125,109,16
16160,15,8080,L,109,125,-16
16161,382,8081,W,123,122,1
16162,381,8081,L,122,123,-1
16163,216,8082,L,86,96,-10
16164,215,8082,W,96,86,10
16165,439,8083,L,109,118,-9
16166,440,8083,W,118,109,9
16167,108,8084,L,86,92,-6
16168,107,8084,W,92,86,6
16169,671,8085,L,115,120,-5
16170,672,8085,W,120,115,5
16171,447,8086,W,100,96,4
16172,448,8086,L,96,100,-4
16173,623,8087,L,89,103,-14
16174,624,8087,W,103,89,14
16175,361,8088,L,111,117,-6
16176,362,8088,W,117,111,6
16177,580,8089,L,113,118,-5
16178,579,8089,W,118,113,5
16179,876,8090,W,97,83,14
16180,875,8090,L,83,97,-14
16181,551,8091,L,95,108,-13
16182,552,8091,W,108,95,13
16183,249,8092,L,90,99,-9
16184,250,8092,W,99,90,9
16185,745,8093,L,89,94,-5
16186,746,8093,W,94,89,5
16187,462,8094,L,86,124,-38
16188,461,8094,W,124,86,38
16189,87,8095,L,100,110,-10
16190,88,8095,W,110,100,10
16191,441,8096,W,97,85,12
16192,442,8096,L,85,97,-12
16193,581,8097,W,109,86,23
16194,582,8097,L,86,109,-23
16195,518,8098,L,80,102,-22
16196,517,8098,W,102,80,22
16197,554,8099,L,102,104,-2
16198,553,8099,W,104,102,2
16199,611,8100,W,113,112,1
16200,612,8100,L,112,113,-1
16201,587,8101,L,120,121,-1
16202,588,8101,W,121,120,1
16203,893,8102,W,101,92,9
16204,894,8102,L,92,101,-9
16205,820,8103,L,104,113,-9
16206,819,8103,W,113,104,9
16207,364,8104,W,121,113,8
16208,363,8104,L,113,121,-8
16209,158,8105,L,104,122,-18
16210,157,8105,W,122,104,18
16211,693,8106,L,92,97,-5
16212,694,8106,W,97,92,5
16213,791,8107,W,112,104,8
16214,792,8107,L,104,112,-8
16215,244,8108,L,94,101,-7
16216,243,8108,W,101,94,7
16217,67,8109,L,94,115,-21
16218,68,8109,W,115,94,21
16219,597,8110,L,87,94,-7
16220,598,8110,W,94,87,7
16221,531,8111,W,103,77,26
16222,532,8111,L,77,103,-26
16223,895,8112,L,93,105,-12
16224,896,8112,W,105,93,12
16225,58,8113,W,105,101,4
16226,57,8113,L,101,105,-4
16227,476,8114,W,111,103,8
16228,475,8114,L,103,111,-8
16229,15,8115,L,85,119,-34
16230,16,8115,W,119,85,34
16231,250,8116,W,101,94,7
16232,249,8116,L,94,101,-7
16233,730,8117,W,96,87,9
16234,729,8117,L,87,96,-9
16235,564,8118,W,103,94,9
16236,563,8118,L,94,103,-9
16237,625,8119,W,87,80,7
16238,626,8119,L,80,87,-7
16239,189,8120,L,86,99,-13
16240,190,8120,W,99,86,13
16241,256,8121,W,111,107,4
16242,255,8121,L,107,111,-4
16243,218,8122,L,102,131,-29
16244,217,8122,W,131,102,29
16245,735,8123,L,97,102,-5
16246,736,8123,W,102,97,5
16247,845,8124,L,87,111,-24
16248,846,8124,W,111,87,24
16249,863,8125,W,110,101,9
16250,864,8125,L,101,110,-9
16251,534,8126,L,90,103,-13
16252,533,8126,W,103,90,13
16253,395,8127,W,96,95,1
16254,396,8127,L,95,96,-1
16255,342,8128,W,115,98,17
16256,341,8128,L,98,115,-17
16257,748,8129,W,120,112,8
16258,747,8129,L,112,120,-8
16259,881,8130,W,98,85,13
16260,882,8130,L,85,98,-13
16261,276,8131,L,98,111,-13
16262,275,8131,W,111,98,13
16263,566,8132,L,87,101,-14
16264,565,8132,W,101,87,14
16265,183,8133,W,108,101,7
16266,184,8133,L,101,108,-7
16267,233,8134,W,90,88,2
16268,234,8134,L,88,90,-2
16269,812,8135,W,116,92,24
16270,811,8135,L,92,116,-24
16271,390,8136,L,89,99,-10
16272,389,8136,W,99,89,10
16273,134,8137,L,98,106,-8
16274,133,8137,W,106,98,8
16275,41,8138,L,83,94,-11
16276,42,8138,W,94,83,11
16277,583,8139,W,104,96,8
16278,584,8139,L,96,104,-8
16279,651,8140,L,85,108,-23
16280,652,8140,W,108,85,23
16281,718,8141,L,101,112,-11
16282,717,8141,W,112,101,11
16283,146,8142,L,99,109,-10
16284,145,8142,W,109,99,10
16285,897,8143,L,98,105,-7
16286,898,8143,W,105,98,7
16287,83,8144,L,110,123,-13
16288,84,8144,W,123,110,13
16289,141,8145,L,97,101,-4
16290,142,8145,W,101,97,4
16291,744,8146,W,112,110,2
16292,743,8146,L,110,112,-2
16293,223,8147,L,105,112,-7
16294,224,8147,W,112,105,7
16295,308,8148,L,90,99,-9
16296,307,8148,W,99,90,9
16297,137,8149,L,98,105,-7
16298,138,8149,W,105,98,7
16299,788,8150,L,88,95,-7
16300,787,8150,W,95,88,7
16301,508,8151,W,111,104,7
16302,507,8151,L,104,111,-7
16303,402,8152,L,107,113,-6
16304,401,8152,W,113,107,6
16305,603,8153,L,107,111,-4
16306,604,8153,W,111,107,4
16307,217,8154,L,110,114,-4
16308,218,8154,W,114,110,4
16309,205,8155,L,89,104,-15
16310,206,8155,W,104,89,15
16311,74,8156,L,113,118,-5
16312,73,8156,W,118,113,5
16313,641,8157,L,111,118,-7
16314,642,8157,W,118,111,7
16315,311,8158,L,94,105,-11
16316,312,8158,W,105,94,11
16317,805,8159,W,104,92,12
16318,806,8159,L,92,104,-12
16319,393,8160,L,112,121,-9
16320,394,8160,W,121,112,9
16321,176,8161,W,114,107,7
16322,175,8161,L,107,114,-7
16323,29,8162,W,107,97,10
16324,30,8162,L,97,107,-10
16325,899,8163,L,89,111,-22
16326,900,8163,W,111,89,22
16327,606,8164,L,108,109,-1
16328,605,8164,W,109,108,1
16329,799,8165,W,85,77,8
16330,800,8165,L,77,85,-8
16331,128,8166,L,126,134,-8
16332,127,8166,W,134,126,8
16333,347,8167,L,81,108,-27
16334,348,8167,W,108,81,27
16335,808,8168,L,97,111,-14
16336,807,8168,W,111,97,14
16337,111,8169,L,101,114,-13
16338,112,8169,W,114,101,13
16339,545,8170,L,104,112,-8
16340,546,8170,W,112,104,8
16341,884,8171,L,92,101,-9
16342,883,8171,W,101,92,9
16343,91,8172,L,84,91,-7
16344,92,8172,W,91,84,7
16345,173,8173,L,98,103,-5
16346,174,8173,W,103,98,5
16347,306,8174,L,87,99,-12
16348,305,8174,W,99,87,12
16349,165,8175,L,86,112,-26
16350,166,8175,W,112,86,26
16351,619,8176,L,87,111,-24
16352,620,8176,W,111,87,24
16353,181,8177,L,122,128,-6
16354,182,8177,W,128,122,6
16355,119,8178,W,142,94,48
16356,120,8178,L,94,142,-48
16357,410,8179,L,91,104,-13
16358,409,8179,W,104,91,13
16359,567,8180,W,108,88,20
16360,568,8180,L,88,108,-20
16361,509,8181,W,116,102,14
16362,510,8181,L,102,116,-14
16363,669,8182,W,105,94,11
16364,670,8182,L,94,105,-11
16365,398,8183,L,78,102,-24
16366,397,8183,W,102,78,24
16367,47,8184,L,94,103,-9
16368,48,8184,W,103,94,9
16369,314,8185,W,101,89,12
16370,313,8185,L,89,101,-12
16371,268,8186,L,110,115,-5
16372,267,8186,W,115,110,5
16373,867,8187,W,118,106,12
16374,868,8187,L,106,118,-12
16375,901,8188,L,87,109,-22
16376,902,8188,W,109,87,22
16377,596,8189,W,98,96,2
16378,595,8189,L,96,98,-2
16379,301,8190,W,122,101,21
16380,302,8190,L,101,122,-21
16381,819,8191,L,103,106,-3
16382,820,8191,W,106,103,3
16383,384,8192,W,132,125,7
16384,383,8192,L,125,132,-7
16385,224,8193,W,104,96,8
16386,223,8193,L,96,104,-8
16387,692,8194,L,92,125,-33
16388,691,8194,W,125,92,33
16389,515,8195,W,110,104,6
16390,516,8195,L,104,110,-6
16391,872,8196,L,107,124,-17
16392,871,8196,W,124,107,17
16393,459,8197,W,132,128,4
16394,460,8197,L,128,132,-4
16395,297,8198,L,80,96,-16
16396,298,8198,W,96,80,16
16397,823,8199,L,88,114,-26
16398,824,8199,W,114,88,26
16399,177,8200,L,89,96,-7
16400,178,8200,W,96,89,7
16401,296,8201,L,85,96,-11
16402,295,8201,W,96,85,11
16403,46,8202,W,107,106,1
16404,45,8202,L,106,107,-1
16405,344,8203,L,98,104,-6
16406,343,8203,W,104,98,6
16407,277,8204,L,106,112,-6
16408,278,8204,W,112,106,6
16409,903,8205,L,99,116,-17
16410,904,8205,W,116,99,17
16411,400,8206,L,90,109,-19
16412,399,8206,W,109,90,19
16413,650,8207,L,120,129,-9
16414,649,8207,W,129,120,9
16415,614,8208,L,91,94,-3
16416,613,8208,W,94,91,3
16417,3,8209,L,81,92,-11
16418,4,8209,W,92,81,11
16419,105,8210,W,122,103,19
16420,106,8210,L,103,122,-19
16421,116,8211,L,98,112,-14
16422,115,8211,W,112,98,14
16423,227,8212,W,107,98,9
16424,228,8212,L,98,107,-9
16425,42,8213,W,102,97,5
16426,41,8213,L,97,102,-5
16427,631,8214,L,96,110,-14
16428,632,8214,W,110,96,14
16429,253,8215,L,76,108,-32
16430,254,8215,W,108,76,32
16431,759,8216,L,110,118,-8
16432,760,8216,W,118,110,8
16433,553,8217,W,108,97,11
16434,554,8217,L,97,108,-11
16435,210,8218,L,96,102,-6
16436,209,8218,W,102,96,6
16437,159,8219,L,122,126,-4
16438,160,8219,W,126,122,4
16439,375,8220,L,79,99,-20
16440,376,8220,W,99,79,20
16441,380,8221,W,100,91,9
16442,379,8221,L,91,100,-9
16443,208,8222,L,107,113,-6
16444,207,8222,W,113,107,6
16445,772,8223,W,126,103,23
16446,771,8223,L,103,126,-23
16447,905,8224,L,82,92,-10
16448,906,8224,W,92,82,10
16449,27,8225,L,104,116,-12
16450,28,8225,W,116,104,12
16451,666,8226,L,82,108,-26
16452,665,8226,W,108,82,26
16453,637,8227,W,134,129,5
16454,638,8227,L,129,134,-5
16455,360,8228,L,96,101,-5
16456,359,8228,W,101,96,5
16457,786,8229,W,112,89,23
16458,785,8229,L,89,112,-23
16459,4,8230,W,101,90,11
16460,3,8230,L,90,101,-11
16461,1,8231,L,86,109,-23
16462,2,8231,W,109,86,23
16463,164,8232,L,80,124,-44
16464,163,8232,W,124,80,44
16465,731,8233,L,110,120,-10
16466,732,8233,W,120,110,10
16467,357,8234,L,89,108,-19
16468,358,8234,W,108,89,19
16469,523,8235,L,104,115,-11
16470,524,8235,W,115,104,11
16471,403,8236,L,103,108,-5
16472,404,8236,W,108,103,5
16473,346,8237,L,93,101,-8
16474,345,8237,W,101,93,8
16475,539,8238,W,114,104,10
16476,540,8238,L,104,114,-10
16477,61,8239,L,83,103,-20
16478,62,8239,W,103,83,20
16479,209,8240,W,100,95,5
16480,210,8240,L,95,100,-5
16481,779,8241,W,110,101,9
16482,780,8241,L,101,110,-9
16483,102,8242,W,107,103,4
16484,101,8242,L,103,107,-4
16485,571,8243,W,99,93,6
16486,572,8243,L,93,99,-6
16487,8,8244,W,129,103,26
16488,7,8244,L,103,129,-26
16489,199,8245,L,98,118,-20
16490,200,8245,W,118,98,20
16491,57,8246,L,106,115,-9
16492,58,8246,W,115,106,9
16493,254,8247,W,123,110,13
16494,253,8247,L,110,123,-13
16495,336,8248,L,98,110,-12
16496,335,8248,W,110,98,12
16497,466,8249,W,130,110,20
16498,465,8249,L,110,130,-20
16499,33,8250,W,104,96,8
16500,34,8250,L,96,104,-8
16501,839,8251,W,110,108,2
16502,840,8251,L,108,110,-2
16503,32,8252,W,109,95,14
16504,31,8252,L,95,109,-14
16505,787,8253,L,79,93,-14
16506,788,8253,W,93,79,14
16507,529,8254,W,115,112,3
16508,530,8254,L,112,115,-3
16509,285,8255,W,108,102,6
16510,286,8255,L,102,108,-6
16511,680,8256,L,97,108,-11
16512,679,8256,W,108,97,11
16513,214,8257,L,90,105,-15
16514,213,8257,W,105,90,15
16515,472,8258,W,96,83,13
16516,471,8258,L,83,96,-13
16517,148,8259,W,125,117,8
16518,147,8259,L,117,125,-8
16519,826,8260,L,98,105,-7
16520,825,8260,W,105,98,7
16521,769,8261,W,113,102,11
16522,770,8261,L,102,113,-11
16523,204,8262,L,93,94,-1
16524,203,8262,W,94,93,1
16525,122,8263,L,86,93,-7
16526,121,8263,W,93,86,7
16527,900,8264,L,89,92,-3
16528,899,8264,W,92,89,3
16529,271,8265,L,98,107,-9
16530,272,8265,W,107,98,9
16531,79,8266,W,121,104,17
16532,80,8266,L,104,121,-17
16533,359,8267,W,110,100,10
16534,360,8267,L,100,110,-10
16535,444,8268,L,96,102,-6
16536,443,8268,W,102,96,6
16537,44,8269,L,107,115,-8
16538,43,8269,W,115,107,8
16539,870,8270,L,89,117,-28
16540,869,8270,W,117,89,28
16541,572,8271,L,91,98,-7
16542,571,8271,W,98,91,7
16543,668,8272,W,124,112,12
16544,667,8272,L,112,124,-12
16545,97,8273,L,94,102,-8
16546,98,8273,W,102,94,8
16547,907,8274,L,87,90,-3
16548,908,8274,W,90,87,3
16549,455,8275,L,92,101,-9
16550,456,8275,W,101,92,9
16551,536,8276,L,121,129,-8
16552,535,8276,W,129,121,8
16553,602,8277,L,85,106,-21
16554,601,8277,W,106,85,21
16555,483,8278,L,99,102,-3
16556,484,8278,W,102,99,3
16557,167,8279,W,103,81,22
16558,168,8279,L,81,103,-22
16559,290,8280,W,101,90,11
16560,289,8280,L,90,101,-11
16561,129,8281,W,134,108,26
16562,130,8281,L,108,134,-26
16563,795,8282,L,93,101,-8
16564,796,8282,W,101,93,8
16565,909,8283,L,98,116,-18
16566,910,8283,W,116,98,18
16567,533,8284,W,111,109,2
16568,534,8284,L,109,111,-2
16569,559,8285,W,94,92,2
16570,560,8285,L,92,94,-2
16571,436,8286,W,101,92,9
16572,435,8286,L,92,101,-9
16573,676,8287,W,98,91,7
16574,675,8287,L,91,98,-7
16575,326,8288,W,114,97,17
16576,325,8288,L,97,114,-17
16577,636,8289,L,91,104,-13
16578,635,8289,W,104,91,13
16579,648,8290,W,105,99,6
16580,647,8290,L,99,105,-6
16581,626,8291,L,94,100,-6
16582,625,8291,W,100,94,6
16583,70,8292,W,114,85,29
16584,69,8292,L,85,114,-29
16585,418,8293,W,117,106,11
16586,417,8293,L,106,117,-11
16587,574,8294,L,93,98,-5
16588,573,8294,W,98,93,5
16589,638,8295,W,103,93,10
16590,637,8295,L,93,103,-10
16591,910,8296,W,108,96,12
16592,909,8296,L,96,108,-12
16593,137,8297,L,100,104,-4
16594,138,8297,W,104,100,4
16595,708,8298,L,98,108,-10
16596,707,8298,W,108,98,10
16597,520,8299,W,112,107,5
16598,519,8299,L,107,112,-5
16599,547,8300,W,113,103,10
16600,548,8300,L,103,113,-10
16601,217,8301,W,107,103,4
16602,218,8301,L,103,107,-4
16603,298,8302,L,76,92,-16
16604,297,8302,W,92,76,16
16605,806,8303,L,100,105,-5
16606,805,8303,W,105,100,5
16607,17,8304,L,117,122,-5
16608,18,8304,W,122,117,5
16609,856,8305,L,112,113,-1
16610,855,8305,W,113,112,1
16611,888,8306,L,89,105,-16
16612,887,8306,W,105,89,16
16613,282,8307,W,86,81,5
16614,281,8307,L,81,86,-5
16615,681,8308,W,104,92,12
16616,682,8308,L,92,104,-12
16617,71,8309,W,93,89,4
16618,72,8309,L,89,93,-4
16619,499,8310,W,111,110,1
16620,500,8310,L,110,111,-1
16621,460,8311,L,90,117,-27
16622,459,8311,W,117,90,27
16623,546,8312,W,102,98,4
16624,545,8312,L,98,102,-4
16625,766,8313,W,106,101,5
16626,765,8313,L,101,106,-5
16627,312,8314,W,81,73,8
16628,311,8314,L,73,81,-8
16629,579,8315,L,83,104,-21
16630,580,8315,W,104,83,21
16631,630,8316,W,98,95,3
16632,629,8316,L,95,98,-3
16633,101,8317,L,85,100,-15
16634,102,8317,W,100,85,15
16635,911,8318,L,89,114,-25
16636,912,8318,W,114,89,25
16637,202,8319,W,103,97,6
16638,201,8319,L,97,103,-6
16639,862,8320,L,99,109,-10
16640,861,8320,W,109,99,10
16641,230,8321,W,96,79,17
16642,229,8321,L,79,96,-17
16643,516,8322,L,89,92,-3
16644,515,8322,W,92,89,3
16645,732,8323,L,100,109,-9
16646,731,8323,W,109,100,9
16647,622,8324,L,80,119,-39
16648,621,8324,W,119,80,39
16649,288,8325,W,107,89,18
16650,287,8325,L,89,107,-18
16651,323,8326,L,80,123,-43
16652,324,8326,W,123,80,43
16653,100,8327,W,102,86,16
16654,99,8327,L,86,102,-16
16655,113,8328,L,101,108,-7
16656,114,8328,W,108,101,7
16657,330,8329,L,100,112,-12
16658,329,8329,W,112,100,12
16659,852,8330,W,92,86,6
16660,851,8330,L,86,92,-6
16661,746,8331,W,102,91,11
16662,745,8331,L,91,102,-11
16663,632,8332,L,83,91,-8
16664,631,8332,W,91,83,8
16665,750,8333,L,81,93,-12
16666,749,8333,W,93,81,12
16667,391,8334,L,78,123,-45
16668,392,8334,W,123,78,45
16669,226,8335,L,92,93,-1
16670,225,8335,W,93,92,1
16671,362,8336,L,84,93,-9
16672,361,8336,W,93,84,9
16673,78,8337,W,79,76,3
16674,77,8337,L,76,79,-3
16675,679,8338,W,117,110,7
16676,680,8338,L,110,117,-7
16677,906,8339,W,104,100,4
16678,905,8339,L,100,104,-4
16679,497,8340,L,89,94,-5
16680,498,8340,W,94,89,5
16681,242,8341,W,101,95,6
16682,241,8341,L,95,101,-6
16683,401,8342,L,109,122,-13
16684,402,8342,W,122,109,13
16685,440,8343,L,109,126,-17
16686,439,8343,W,126,109,17
16687,36,8344,L,102,103,-1
16688,35,8344,W,103,102,1
16689,423,8345,L,113,118,-5
16690,424,8345,W,118,113,5
16691,368,8346,W,112,98,14
16692,367,8346,L,98,112,-14
16693,304,8347,L,91,98,-7
16694,303,8347,W,98,91,7
16695,825,8348,L,89,99,-10
16696,826,8348,W,99,89,10
16697,184,8349,L,81,103,-22
16698,183,8349,W,103,81,22
16699,756,8350,L,90,117,-27
16700,755,8350,W,117,90,27
16701,471,8351,W,115,113,2
16702,472,8351,L,113,115,-2
16703,576,8352,L,95,111,-16
16704,575,8352,W,111,95,16
16705,776,8353,L,105,118,-13
16706,775,8353,W,118,105,13
16707,62,8354,L,87,102,-15
16708,61,8354,W,102,87,15
16709,327,8355,L,89,103,-14
16710,328,8355,W,103,89,14
16711,865,8356,L,100,105,-5
16712,866,8356,W,105,100,5
16713,719,8357,W,94,90,4
16714,720,8357,L,90,94,-4
16715,530,8358,L,108,122,-14
16716,529,8358,W,122,108,14
16717,658,8359,W,119,108,11
16718,657,8359,L,108,119,-11
16719,334,8360,W,110,96,14
16720,333,8360,L,96,110,-14
16721,835,8361,W,125,118,7
16722,836,8361,L,118,125,-7
16723,491,8362,L,98,112,-14
16724,492,8362,W,112,98,14
16725,594,8363,L,97,106,-9
16726,593,8363,W,106,97,9
16727,541,8364,W,116,112,4
16728,542,8364,L,112,116,-4
16729,289,8365,L,100,110,-10
16730,290,8365,W,110,100,10
16731,305,8366,L,101,109,-8
16732,306,8366,W,109,101,8
16733,143,8367,W,114,108,6
16734,144,8367,L,108,114,-6
16735,468,8368,W,101,92,9
16736,467,8368,L,92,101,-9
16737,707,8369,W,89,85,4
16738,708,8369,L,85,89,-4
16739,913,8370,W,91,75,16
16740,914,8370,L,75,91,-16
16741,64,8371,L,99,109,-10
16742,63,8371,W,109,99,10
16743,482,8372,L,102,108,-6
16744,481,8372,W,108,102,6
16745,833,8373,L,107,124,-17
16746,834,8373,W,124,107,17
16747,225,8374,L,79,98,-19
16748,226,8374,W,98,79,19
16749,598,8375,L,70,99,-29
16750,597,8375,W,99,70,29
16751,841,8376,L,96,102,-6
16752,842,8376,W,102,96,6
16753,55,8377,W,102,95,7
16754,56,8377,L,95,102,-7
16755,68,8378,L,98,101,-3
16756,67,8378,W,101,98,3
16757,87,8379,L,115,116,-1
16758,88,8379,W,116,115,1
16759,352,8380,L,90,100,-10
16760,351,8380,W,100,90,10
16761,293,8381,W,94,79,15
16762,294,8381,L,79,94,-15
16763,208,8382,L,77,86,-9
16764,207,8382,W,86,77,9
16765,195,8383,L,89,96,-7
16766,196,8383,W,96,89,7
16767,665,8384,W,106,91,15
16768,666,8384,L,91,106,-15
16769,729,8385,L,87,102,-15
16770,730,8385,W,102,87,15
16771,261,8386,L,93,95,-2
16772,262,8386,W,95,93,2
16773,544,8387,L,113,120,-7
16774,543,8387,W,120,113,7
16775,188,8388,L,81,96,-15
16776,187,8388,W,96,81,15
16777,915,8389,L,95,105,-10
16778,916,8389,W,105,95,10
16779,266,8390,L,96,113,-17
16780,265,8390,W,113,96,17
16781,538,8391,L,79,88,-9
16782,537,8391,W,88,79,9
16783,774,8392,L,92,106,-14
16784,773,8392,W,106,92,14
16785,161,8393,L,90,99,-9
16786,162,8393,W,99,90,9
16787,501,8394,L,96,97,-1
16788,502,8394,W,97,96,1
16789,690,8395,L,103,106,-3
16790,689,8395,W,106,103,3
16791,608,8396,W,95,90,5
16792,607,8396,L,90,95,-5
16793,138,8397,L,102,113,-11
16794,137,8397,W,113,102,11
16795,687,8398,W,120,95,25
16796,688,8398,L,95,120,-25
16797,222,8399,L,103,107,-4
16798,221,8399,W,107,103,4
16799,150,8400,W,100,90,10
16800,149,8400,L,90,100,-10
16801,445,8401,W,125,99,26
16802,446,8401,L,99,125,-26
16803,686,8402,W,94,90,4
16804,685,8402,L,90,94,-4
16805,917,8403,W,110,100,10
16806,918,8403,L,100,110,-10
16807,212,8404,W,102,94,8
16808,211,8404,L,94,102,-8
16809,275,8405,L,92,111,-19
16810,276,8405,W,111,92,19
16811,30,8406,L,86,117,-31
16812,29,8406,W,117,86,31
16813,408,8407,W,99,89,10
16814,407,8407,L,89,99,-10
16815,214,8408,L,83,98,-15
16816,213,8408,W,98,83,15
16817,584,8409,W,96,86,10
16818,583,8409,L,86,96,-10
16819,303,8410,L,77,88,-11
16820,304,8410,W,88,77,11
16821,259,8411,W,117,115,2
16822,260,8411,L,115,117,-2
16823,898,8412,W,101,98,3
16824,897,8412,L,98,101,-3
16825,784,8413,L,103,110,-7
16826,783,8413,W,110,103,7
16827,144,8414,W,95,94,1
16828,143,8414,L,94,95,-1
16829,168,8415,W,112,95,17
16830,167,8415,L,95,112,-17
16831,310,8416,W,126,117,9
16832,309,8416,L,117,126,-9
16833,385,8417,W,88,85,3
16834,386,8417,L,85,88,-3
16835,170,8418,L,90,97,-7
16836,169,8418,W,97,90,7
16837,811,8419,L,88,114,-26
16838,812,8419,W,114,88,26
16839,145,8420,W,98,81,17
16840,146,8420,L,81,98,-17
16841,420,8421,W,100,89,11
16842,419,8421,L,89,100,-11
16843,492,8422,L,87,103,-16
16844,491,8422,W,103,87,16
16845,200,8423,W,104,92,12
16846,199,8423,L,92,104,-12
16847,141,8424,W,104,103,1
16848,142,8424,L,103,104,-1
16849,350,8425,W,95,86,9
16850,349,8425,L,86,95,-9
16851,599,8426,L,109,111,-2
16852,600,8426,W,111,109,2
16853,171,8427,W,124,113,11
16854,172,8427,L,113,124,-11
16855,627,8428,L,99,106,-7
16856,628,8428,W,106,99,7
16857,789,8429,W,114,86,28
16858,790,8429,L,86,114,-28
16859,612,8430,L,88,103,-15
16860,611,8430,W,103,88,15
16861,864,8431,W,99,90,9
16862,863,8431,L,90,99,-9
16863,154,8432,L,92,100,-8
16864,153,8432,W,100,92,8
16865,91,8433,W,85,79,6
16866,92,8433,L,79,85,-6
16867,609,8434,L,103,110,-7
16868,610,8434,W,110,103,7
16869,770,8435,L,106,116,-10
16870,769,8435,W,116,106,10
16871,620,8436,L,101,113,-12
16872,619,8436,W,113,101,12
16873,31,8437,W,125,117,8
16874,32,8437,L,117,125,-8
16875,434,8438,L,81,99,-18
16876,433,8438,W,99,81,18
16877,736,8439,W,112,87,25
16878,735,8439,L,87,112,-25
16879,680,8440,L,104,115,-11
16880,679,8440,W,115,104,11
16881,621,8441,L,96,109,-13
16882,622,8441,W,109,96,13
16883,873,8442,W,89,87,2
16884,874,8442,L,87,89,-2
16885,691,8443,W,103,91,12
16886,692,8443,L,91,103,-12
16887,409,8444,L,101,104,-3
16888,410,8444,W,104,101,3
16889,775,8445,W,126,118,8
16890,776,8445,L,118,126,-8
16891,433,8446,W,88,87,1
16892,434,8446,L,87,88,-1
16893,742,8447,W,116,111,5
16894,741,8447,L,111,116,-5
16895,258,8448,W,101,95,6
16896,257,8448,L,95,101,-6
16897,634,8449,W,105,79,26
16898,633,8449,L,79,105,-26
16899,39,8450,W,104,95,9
16900,40,8450,L,95,104,-9
16901,646,8451,L,105,114,-9
16902,645,8451,W,114,105,9
16903,714,8452,W,121,120,1
16904,713,8452,L,120,121,-1
16905,710,8453,L,106,107,-1
16906,709,8453,W,107,106,1
16907,659,8454,W,103,101,2
16908,660,8454,L,101,103,-2
16909,919,8455,L,96,125,-29
16910,920,8455,W,125,96,29
16911,761,8456,W,112,95,17
16912,762,8456,L,95,112,-17
16913,764,8457,L,78,93,-15
16914,763,8457,W,93,78,15
16915,299,8458,W,101,83,18
16916,300,8458,L,83,101,-18
16917,123,8459,L,102,109,-7
16918,124,8459,W,109,102,7
16919,210,8460,L,105,110,-5
16920,209,8460,W,110,105,5
16921,458,8461,W,111,105,6
16922,457,8461,L,105,111,-6
16923,211,8462,L,100,124,-24
16924,212,8462,W,124,100,24
16925,83,8463,W,110,106,4
16926,84,8463,L,106,110,-4
16927,921,8464,L,91,95,-4
16928,922,8464,W,95,91,4
16929,156,8465,W,113,111,2
16930,155,8465,L,111,113,-2
16931,486,8466,L,101,104,-3
16932,485,8466,W,104,101,3
16933,7,8467,L,98,119,-21
16934,8,8467,W,119,98,21
16935,274,8468,W,98,87,11
16936,273,8468,L,87,98,-11
16937,739,8469,L,85,93,-8
16938,740,8469,W,93,85,8
16939,428,8470,W,112,109,3
16940,427,8470,L,109,112,-3
16941,79,8471,W,112,97,15
16942,80,8471,L,97,112,-15
16943,125,8472,L,86,93,-7
16944,126,8472,W,93,86,7
16945,180,8473,L,90,101,-11
16946,179,8473,W,101,90,11
16947,178,8474,W,114,97,17
16948,177,8474,L,97,114,-17
16949,629,8475,L,97,105,-8
16950,630,8475,W,105,97,8
16951,851,8476,L,100,102,-2
16952,852,8476,W,102,100,2
16953,716,8477,W,112,103,9
16954,715,8477,L,103,112,-9
16955,106,8478,L,99,107,-8
16956,105,8478,W,107,99,8
16957,923,8479,L,95,100,-5
16958,924,8479,W,100,95,5
16959,74,8480,L,113,126,-13
16960,73,8480,W,126,113,13
16961,834,8481,W,102,97,5
16962,833,8481,L,97,102,-5
16963,234,8482,W,95,92,3
16964,233,8482,L,92,95,-3
16965,595,8483,W,102,94,8
16966,596,8483,L,94,102,-8
16967,591,8484,W,103,80,23
16968,592,8484,L,80,103,-23
16969,479,8485,L,114,121,-7
16970,480,8485,W,121,114,7
16971,251,8486,W,112,106,6
16972,252,8486,L,106,112,-6
16973,695,8487,L,82,110,-28
16974,696,8487,W,110,82,28
16975,425,8488,L,93,108,-15
16976,426,8488,W,108,93,15
16977,196,8489,L,91,93,-2
16978,195,8489,W,93,91,2
16979,519,8490,L,103,117,-14
16980,520,8490,W,117,103,14
16981,241,8491,L,104,114,-10
16982,242,8491,W,114,104,10
16983,617,8492,W,104,98,6
16984,618,8492,L,98,104,-6
16985,871,8493,W,104,96,8
16986,872,8493,L,96,104,-8
16987,173,8494,W,127,111,16
16988,174,8494,L,111,127,-16
16989,514,8495,L,78,103,-25
16990,513,8495,W,103,78,25
16991,80,8496,L,72,98,-26
16992,79,8496,W,98,72,26
16993,781,8497,L,92,106,-14
16994,782,8497,W,106,92,14
16995,450,8498,W,97,87,10
16996,449,8498,L,87,97,-10
16997,698,8499,W,109,95,14
16998,697,8499,L,95,109,-14
16999,320,8500,W,117,109,8
17000,319,8500,L,109,117,-8
17001,534,8501,W,109,100,9
17002,533,8501,L,100,109,-9
17003,407,8502,L,90,91,-1
17004,408,8502,W,91,90,1
17005,886,8503,W,111,101,10
17006,885,8503,L,101,111,-10
17007,117,8504,W,110,107,3
17008,118,8504,L,107,110,-3
17009,321,8505,W,110,89,21
17010,322,8505,L,89,110,-21
17011,507,8506,L,89,94,-5
17012,508,8506,W,94,89,5
17013,828,8507,L,121,127,-6
17014,827,8507,W,127,121,6
17015,558,8508,W,101,86,15
17016,557,8508,L,86,101,-15
17017,9,8509,L,93,96,-3
17018,10,8509,W,96,93,3
17019,456,8510,W,107,104,3
17020,455,8510,L,104,107,-3
17021,22,8511,W,127,110,17
17022,21,8511,L,110,127,-17
17023,133,8512,W,104,92,12
17024,134,8512,L,92,104,-12
17025,107,8513,L,89,117,-28
17026,108,8513,W,117,89,28
17027,158,8514,L,105,109,-4
17028,157,8514,W,109,105,4
17029,307,8515,L,97,114,-17
17030,308,8515,W,114,97,17
17031,832,8516,L,96,108,-12
17032,831,8516,W,108,96,12
17033,562,8517,W,103,100,3
17034,561,8517,L,100,103,-3
17035,504,8518,L,114,121,-7
17036,503,8518,W,121,114,7
17037,162,8519,W,82,77,5
17038,161,8519,L,77,82,-5
17039,65,8520,L,127,129,-2
17040,66,8520,W,129,127,2
17041,737,8521,W,128,125,3
17042,738,8521,L,125,128,-3
17043,878,8522,L,92,95,-3
17044,877,8522,W,95,92,3
17045,370,8523,W,123,116,7
17046,369,8523,L,116,123,-7
17047,132,8524,L,83,88,-5
17048,131,8524,W,88,83,5
17049,554,8525,W,111,108,3
17050,553,8525,L,108,111,-3
17051,741,8526,L,92,116,-24
17052,742,8526,W,116,92,24
17053,207,8527,L,87,90,-3
17054,208,8527,W,90,87,3
17055,657,8528,W,120,118,2
17056,658,8528,L,118,120,-2
17057,920,8529,L,98,108,-10
17058,919,8529,W,108,98,10
17059,186,8530,L,94,116,-22
17060,185,8530,W,116,94,22
17061,639,8531,L,96,98,-2
17062,640,8531,W,98,96,2
17063,136,8532,L,103,118,-15
17064,135,8532,W,118,103,15
17065,474,8533,L,88,107,-19
17066,473,8533,W,107,88,19
17067,10,8534,W,102,88,14
17068,9,8534,L,88,102,-14
17069,405,8535,W,104,92,12
17070,406,8535,L,92,104,-12
17071,55,8536,W,101,95,6
17072,56,8536,L,95,101,-6
17073,861,8537,L,80,124,-44
17074,862,8537,W,124,80,44
17075,77,8538,L,101,108,-7
17076,78,8538,W,108,101,7
17077,817,8539,L,86,104,-18
17078,818,8539,W,104,86,18
17079,357,8540,L,107,110,-3
17080,358,8540,W,110,107,3
17081,747,8541,L,94,120,-26
17082,748,8541,W,120,94,26
17083,855,8542,W,114,107,7
17084,856,8542,L,107,114,-7
17085,412,8543,L,85,101,-16
17086,411,8543,W,101,85,16
17087,84,8544,W,102,92,10
17088,83,8544,L,92,102,-10
17089,142,8545,L,80,96,-16
17090,141,8545,W,96,80,16
17091,874,8546,L,97,103,-6
17092,873,8546,W,103,97,6
17093,414,8547,L,108,110,-2
17094,413,8547,W,110,108,2
17095,248,8548,L,104,112,-8
17096,247,8548,W,112,104,8
17097,585,8549,L,99,104,-5
17098,586,8549,W,104,99,5
17099,396,8550,L,95,104,-9
17100,395,8550,W,104,95,9
17101,615,8551,W,81,72,9
17102,616,8551,L,72,81,-9
17103,358,8552,W,107,90,17
17104,357,8552,L,90,107,-17
17105,238,8553,L,66,93,-27
17106,237,8553,W,93,66,27
17107,120,8554,L,87,123,-36
17108,119,8554,W,123,87,36
17109,896,8555,L,92,119,-27
17110,895,8555,W,119,92,27
17111,265,8556,W,114,104,10
17112,266,8556,L,104,114,-10
17113,376,8557,W,113,102,11
17114,375,8557,L,102,113,-11
17115,246,8558,L,83,103,-20
17116,245,8558,W,103,83,20
17117,683,8559,L,80,83,-3
17118,684,8559,W,83,80,3
17119,568,8560,L,97,99,-2
17120,567,8560,W,99,97,2
17121,665,8561,L,92,102,-10
17122,666,8561,W,102,92,10
17123,240,8562,L,88,101,-13
17124,239,8562,W,101,88,13
17125,130,8563,L,99,113,-14
17126,129,8563,W,113,99,14
17127,566,8564,L,91,112,-21
17128,565,8564,W,112,91,21
17129,374,8565,L,94,110,-16
17130,373,8565,W,110,94,16
17131,277,8566,L,90,112,-22
17132,278,8566,W,112,90,22
17133,121,8567,L,98,102,-4
17134,122,8567,W,102,98,4
17135,707,8568,L,87,97,-10
17136,708,8568,W,97,87,10
17137,203,8569,W,102,96,6
17138,204,8569,L,96,102,-6
17139,490,8570,L,105,111,-6
17140,489,8570,W,111,105,6
17141,780,8571,W,104,103,1
17142,779,8571,L,103,104,-1
17143,454,8572,L,79,86,-7
17144,453,8572,W,86,79,7
17145,794,8573,L,98,129,-31
17146,793,8573,W,129,98,31
17147,95,8574,W,101,80,21
17148,96,8574,L,80,101,-21
17149,94,8575,L,97,110,-13
17150,93,8575,W,110,97,13
17151,89,8576,L,88,107,-19
17152,90,8576,W,107,88,19
17153,109,8577,W,110,108,2
17154,110,8577,L,108,110,-2
17155,882,8578,W,97,83,14
17156,881,8578,L,83,97,-14
17157,295,8579,L,85,89,-4
17158,296,8579,W,89,85,4
17159,467,8580,L,87,92,-5
17160,468,8580,W,92,87,5
17161,69,8581,L,93,111,-18
17162,70,8581,W,111,93,18
17163,316,8582,L,119,123,-4
17164,315,8582,W,123,119,4
17165,52,8583,L,101,112,-11
17166,51,8583,W,112,101,11
17167,21,8584,L,86,91,-5
17168,22,8584,W,91,86,5
17169,590,8585,L,81,101,-20
17170,589,8585,W,101,81,20
17171,853,8586,W,126,95,31
17172,854,8586,L,95,126,-31
17173,840,8587,W,92,80,12
17174,839,8587,L,80,92,-12
17175,386,8588,W,112,96,16
17176,385,8588,L,96,112,-16
17177,550,8589,W,112,84,28
17178,549,8589,L,84,112,-28
17179,300,8590,L,96,119,-23
17180,299,8590,W,119,96,23
17181,127,8591,W,137,115,22
17182,128,8591,L,115,137,-22
17183,231,8592,L,97,102,-5
17184,232,8592,W,102,97,5
17185,12,8593,W,82,78,4
17186,11,8593,L,78,82,-4
17187,548,8594,L,92,116,-24
17188,547,8594,W,116,92,24
17189,115,8595,W,110,94,16
17190,116,8595,L,94,110,-16
17191,309,8596,L,100,116,-16
17192,310,8596,W,116,100,16
17193,593,8597,W,115,111,4
17194,594,8597,L,111,115,-4
17195,925,8598,W,113,103,10
17196,926,8598,L,103,113,-10
17197,521,8599,L,82,99,-17
17198,522,8599,W,99,82,17
17199,101,8600,L,84,91,-7
17200,102,8600,W,91,84,7
17201,822,8601,L,82,89,-7
17202,821,8601,W,89,82,7
17203,191,8602,W,101,99,2
17204,192,8602,L,99,101,-2
17205,588,8603,W,95,92,3
17206,587,8603,L,92,95,-3
17207,638,8604,W,101,88,13
17208,637,8604,L,88,101,-13
17209,66,8605,W,119,112,7
17210,65,8605,L,112,119,-7
17211,230,8606,L,99,110,-11
17212,229,8606,W,110,99,11
17213,372,8607,L,100,102,-2
17214,371,8607,W,102,100,2
17215,807,8608,W,101,100,1
17216,808,8608,L,100,101,-1
17217,578,8609,L,108,111,-3
17218,577,8609,W,111,108,3
17219,341,8610,W,113,104,9
17220,342,8610,L,104,113,-9
17221,654,8611,L,82,94,-12
17222,653,8611,W,94,82,12
17223,892,8612,L,104,134,-30
17224,891,8612,W,134,104,30
17225,795,8613,L,81,87,-6
17226,796,8613,W,87,81,6
17227,500,8614,W,123,114,9
17228,499,8614,L,114,123,-9
17229,586,8615,W,99,91,8
17230,585,8615,L,91,99,-8
17231,830,8616,W,105,101,4
17232,829,8616,L,101,105,-4
17233,824,8617,L,87,96,-9
17234,823,8617,W,96,87,9
17235,688,8618,W,95,93,2
17236,687,8618,L,93,95,-2
17237,525,8619,W,87,78,9
17238,526,8619,L,78,87,-9
17239,778,8620,W,114,102,12
17240,777,8620,L,102,114,-12
17241,303,8621,L,112,124,-12
17242,304,8621,W,124,112,12
17243,453,8622,L,82,95,-13
17244,454,8622,W,95,82,13
17245,922,8623,L,85,112,-27
17246,921,8623,W,112,85,27
17247,11,8624,L,76,91,-15
17248,12,8624,W,91,76,15
17249,560,8625,W,85,79,6
17250,559,8625,L,79,85,-6
17251,624,8626,W,94,81,13
17252,623,8626,L,81,94,-13
17253,7,8627,W,110,106,4
17254,8,8627,L,106,110,-4
17255,523,8628,W,92,91,1
17256,524,8628,L,91,92,-1
17257,328,8629,L,92,113,-21
17258,327,8629,W,113,92,21
17259,337,8630,W,94,79,15
17260,338,8630,L,79,94,-15
17261,629,8631,W,98,94,4
17262,630,8631,L,94,98,-4
17263,381,8632,W,100,98,2
17264,382,8632,L,98,100,-2
17265,618,8633,W,106,99,7
17266,617,8633,L,99,106,-7
17267,255,8634,W,97,94,3
17268,256,8634,L,94,97,-3
17269,476,8635,L,108,110,-2
17270,475,8635,W,110,108,2
17271,800,8636,W,95,91,4
17272,799,8636,L,91,95,-4
17273,927,8637,L,80,83,-3
17274,928,8637,W,83,80,3
17275,223,8638,W,107,88,19
17276,224,8638,L,88,107,-19
17277,261,8639,L,104,112,-8
17278,262,8639,W,112,104,8
17279,367,8640,W,111,104,7
17280,368,8640,L,104,111,-7
17281,563,8641,W,108,104,4
17282,564,8641,L,104,108,-4
17283,134,8642,L,86,117,-31
17284,133,8642,W,117,86,31
17285,428,8643,L,102,109,-7
17286,427,8643,W,109,102,7
17287,577,8644,L,99,120,-21
17288,578,8644,W,120,99,21
17289,561,8645,L,98,107,-9
17290,562,8645,W,107,98,9
17291,501,8646,L,91,105,-14
17292,502,8646,W,105,91,14
17293,617,8647,L,82,106,-24
17294,618,8647,W,106,82,24
17295,379,8648,W,105,83,22
17296,380,8648,L,83,105,-22
17297,354,8649,L,100,103,-3
17298,353,8649,W,103,100,3
17299,729,8650,L,90,98,-8
17300,730,8650,W,98,90,8
17301,511,8651,W,108,107,1
17302,512,8651,L,107,108,-1
17303,717,8652,W,117,95,22
17304,718,8652,L,95,117,-22
17305,172,8653,L,101,115,-14
17306,171,8653,W,115,101,14
17307,875,8654,L,116,118,-2
17308,876,8654,W,118,116,2
17309,13,8655,L,100,115,-15
17310,14,8655,W,115,100,15
17311,402,8656,L,86,115,-29
17312,401,8656,W,115,86,29
17313,837,8657,L,98,120,-22
17314,838,8657,W,120,98,22
17315,904,8658,W,89,85,4
17316,903,8658,L,85,89,-4
17317,228,8659,L,93,104,-11
17318,227,8659,W,104,93,11
17319,14,8660,W,95,83,12
17320,13,8660,L,83,95,-12
17321,527,8661,L,103,108,-5
17322,528,8661,W,108,103,5
17323,229,8662,L,103,105,-2
17324,230,8662,W,105,103,2
17325,603,8663,L,89,105,-16
17326,604,8663,W,105,89,16
17327,491,8664,L,92,109,-17
17328,492,8664,W,109,92,17
17329,433,8665,L,92,100,-8
17330,434,8665,W,100,92,8
17331,278,8666,W,116,107,9
17332,277,8666,L,107,116,-9
17333,18,8667,L,112,116,-4
17334,17,8667,W,116,112,4
17335,493,8668,W,127,125,2
17336,494,8668,L,125,127,-2
17337,329,8669,W,123,94,29
17338,330,8669,L,94,123,-29
17339,275,8670,L,103,105,-2
17340,276,8670,W,105,103,2
17341,297,8671,W,95,78,17
17342,298,8671,L,78,95,-17
17343,124,8672,W,101,95,6
17344,123,8672,L,95,101,-6
17345,169,8673,W,111,98,13
17346,170,8673,L,98,111,-13
17347,502,8674,W,103,86,17
17348,501,8674,L,86,103,-17
17349,216,8675,L,94,104,-10
17350,215,8675,W,104,94,10
17351,894,8676,L,110,111,-1
17352,893,8676,W,111,110,1
17353,260,8677,W,111,104,7
17354,259,8677,L,104,111,-7
17355,504,8678,L,90,117,-27
17356,503,8678,W,117,90,27
17357,177,8679,W,113,100,13
17358,178,8679,L,100,113,-13
17359,369,8680,W,89,81,8
17360,370,8680,L,81,89,-8
17361,536,8681,W,103,98,5
17362,535,8681,L,98,103,-5
17363,480,8682,L,119,121,-2
17364,479,8682,W,121,119,2
17365,81,8683,L,99,112,-13
17366,82,8683,W,112,99,13
17367,72,8684,W,115,92,23
17368,71,8684,L,92,115,-23
17369,37,8685,L,116,120,-4
17370,38,8685,W,120,116,4
17371,41,8686,L,79,106,-27
17372,42,8686,W,106,79,27
17373,643,8687,W,104,98,6
17374,644,8687,L,98,104,-6
17375,928,8688,W,88,85,3
17376,927,8688,L,85,88,-3
17377,117,8689,L,108,123,-15
17378,118,8689,W,123,108,15
17379,475,8690,L,107,110,-3
17380,476,8690,W,110,107,3
17381,421,8691,L,83,102,-19
17382,422,8691,W,102,83,19
17383,245,8692,W,105,100,5
17384,246,8692,L,100,105,-5
17385,760,8693,W,114,97,17
17386,759,8693,L,97,114,-17
17387,88,8694,L,91,112,-21
17388,87,8694,W,112,91,21
17389,155,8695,W,106,99,7
17390,156,8695,L,99,106,-7
17391,465,8696,L,106,116,-10
17392,466,8696,W,116,106,10
17393,573,8697,W,95,87,8
17394,574,8697,L,87,95,-8
17395,458,8698,W,113,100,13
17396,457,8698,L,100,113,-13
17397,273,8699,L,84,100,-16
17398,274,8699,W,100,84,16
17399,764,8700,L,111,114,-3
17400,763,8700,W,114,111,3
17401,63,8701,L,91,104,-13
17402,64,8701,W,104,91,13
17403,743,8702,L,85,118,-33
17404,744,8702,W,118,85,33
17405,740,8703,W,109,108,1
17406,739,8703,L,108,109,-1
17407,481,8704,L,120,121,-1
17408,482,8704,W,121,120,1
17409,520,8705,W,103,99,4
17410,519,8705,L,99,103,-4
17411,528,8706,L,103,122,-19
17412,527,8706,W,122,103,19
17413,910,8707,W,116,106,10
17414,909,8707,L,106,116,-10
17415,166,8708,L,81,114,-33
17416,165,8708,W,114,81,33
17417,442,8709,L,95,107,-12
17418,441,8709,W,107,95,12
17419,722,8710,W,104,102,2
17420,721,8710,L,102,104,-2
17421,849,8711,L,107,124,-17
17422,850,8711,W,124,107,17
17423,253,8712,L,95,108,-13
17424,254,8712,W,108,95,13
17425,333,8713,L,91,105,-14
17426,334,8713,W,105,91,14
17427,703,8714,W,86,82,4
17428,704,8714,L,82,86,-4
17429,924,8715,W,104,102,2
17430,923,8715,L,102,104,-2
17431,679,8716,L,109,120,-11
17432,680,8716,W,120,109,11
17433,641,8717,W,107,106,1
17434,642,8717,L,106,107,-1
17435,243,8718,W,113,107,6
17436,244,8718,L,107,113,-6
17437,68,8719,W,107,101,6
17438,67,8719,L,101,107,-6
17439,139,8720,L,94,97,-3
17440,140,8720,W,97,94,3
17441,602,8721,W,108,101,7
17442,601,8721,L,101,108,-7
17443,846,8722,L,94,109,-15
17444,845,8722,W,109,94,15
17445,926,8723,L,87,95,-8
17446,925,8723,W,95,87,8
17447,403,8724,W,96,92,4
17448,404,8724,L,92,96,-4
17449,449,8725,L,93,104,-11
17450,450,8725,W,104,93,11
17451,831,8726,W,119,116,3
17452,832,8726,L,116,119,-3
17453,240,8727,W,105,93,12
17454,239,8727,L,93,105,-12
17455,738,8728,W,83,82,1
17456,737,8728,L,82,83,-1
17457,547,8729,L,92,115,-23
17458,548,8729,W,115,92,23
17459,478,8730,L,97,101,-4
17460,477,8730,W,101,97,4
17461,280,8731,W,102,101,1
17462,279,8731,L,101,102,-1
17463,498,8732,L,94,117,-23
17464,497,8732,W,117,94,23
17465,757,8733,L,100,114,-14
17466,758,8733,W,114,100,14
17467,792,8734,W,101,96,5
17468,791,8734,L,96,101,-5
17469,482,8735,L,94,130,-36
17470,481,8735,W,130,94,36
17471,685,8736,W,101,93,8
17472,686,8736,L,93,101,-8
17473,452,8737,W,111,109,2
17474,451,8737,L,109,111,-2
17475,401,8738,L,102,106,-4
17476,402,8738,W,106,102,4
17477,8,8739,L,91,106,-15
17478,7,8739,W,106,91,15
17479,35,8740,L,98,101,-3
17480,36,8740,W,101,98,3
17481,604,8741,L,93,102,-9
17482,603,8741,W,102,93,9
17483,272,8742,L,106,111,-5
17484,271,8742,W,111,106,5
17485,560,8743,W,99,77,22
17486,559,8743,L,77,99,-22
17487,783,8744,W,113,97,16
17488,784,8744,L,97,113,-16
17489,192,8745,W,139,105,34
17490,191,8745,L,105,139,-34
17491,157,8746,W,100,84,16
17492,158,8746,L,84,100,-16
17493,448,8747,L,107,114,-7
17494,447,8747,W,114,107,7
17495,197,8748,L,93,106,-13
17496,198,8748,W,106,93,13
17497,918,8749,W,88,85,3
17498,917,8749,L,85,88,-3
17499,615,8750,W,91,90,1
17500,616,8750,L,90,91,-1
17501,40,8751,L,100,108,-8
17502,39,8751,W,108,100,8
17503,135,8752,W,103,93,10
17504,136,8752,L,93,103,-10
17505,812,8753,L,86,90,-4
17506,811,8753,W,90,86,4
17507,483,8754,W,116,112,4
17508,484,8754,L,112,116,-4
17509,233,8755,L,98,104,-6
17510,234,8755,W,104,98,6
17511,218,8756,L,97,122,-25
17512,217,8756,W,122,97,25
17513,902,8757,L,94,99,-5
17514,901,8757,W,99,94,5
17515,796,8758,W,109,100,9
17516,795,8758,L,100,109,-9
17517,326,8759,L,99,101,-2
17518,325,8759,W,101,99,2
17519,54,8760,L,107,116,-9
17520,53,8760,W,116,107,9
17521,817,8761,L,110,117,-7
17522,818,8761,W,117,110,7
17523,576,8762,L,99,103,-4
17524,575,8762,W,103,99,4
17525,73,8763,L,104,111,-7
17526,74,8763,W,111,104,7
17527,194,8764,L,93,102,-9
17528,193,8764,W,102,93,9
17529,660,8765,L,106,111,-5
17530,659,8765,W,111,106,5
17531,651,8766,L,93,95,-2
17532,652,8766,W,95,93,2
17533,399,8767,L,78,83,-5
17534,400,8767,W,83,78,5
17535,489,8768,W,96,88,8
17536,490,8768,L,88,96,-8
17537,628,8769,W,122,101,21
17538,627,8769,L,101,122,-21
17539,854,8770,L,99,106,-7
17540,853,8770,W,106,99,7
17541,696,8771,W,109,77,32
17542,695,8771,L,77,109,-32
17543,885,8772,W,92,83,9
17544,886,8772,L,83,92,-9
17545,207,8773,W,116,100,16
17546,208,8773,L,100,116,-16
17547,82,8774,W,116,103,13
17548,81,8774,L,103,116,-13
17549,140,8775,L,84,90,-6
17550,139,8775,W,90,84,6
17551,112,8776,W,121,94,27
17552,111,8776,L,94,121,-27
17553,600,8777,W,101,92,9
17554,599,8777,L,92,101,-9
17555,503,8778,W,114,108,6
17556,504,8778,L,108,114,-6
17557,29,8779,L,94,109,-15
17558,30,8779,W,109,94,15
17559,616,8780,W,78,74,4
17560,615,8780,L,74,78,-4
17561,92,8781,L,96,104,-8
17562,91,8781,W,104,96,8
17563,392,8782,W,94,83,11
17564,391,8782,L,83,94,-11
17565,281,8783,L,85,94,-9
17566,282,8783,W,94,85,9
17567,221,8784,L,97,112,-15
17568,222,8784,W,112,97,15
17569,705,8785,W,75,74,1
17570,706,8785,L,74,75,-1
17571,914,8786,L,111,115,-4
17572,913,8786,W,115,111,4
17573,98,8787,W,105,94,11
17574,97,8787,L,94,105,-11
17575,842,8788,W,110,95,15
17576,841,8788,L,95,110,-15
17577,801,8789,L,94,118,-24
17578,802,8789,W,118,94,24
17579,811,8790,W,114,73,41
17580,812,8790,L,73,114,-41
17581,252,8791,W,106,94,12
17582,251,8791,L,94,106,-12
17583,313,8792,L,88,98,-10
17584,314,8792,W,98,88,10
17585,627,8793,W,112,102,10
17586,628,8793,L,102,112,-10
17587,663,8794,W,108,82,26
17588,664,8794,L,82,108,-26
17589,670,8795,W,92,75,17
17590,669,8795,L,75,92,-17
17591,777,8796,W,103,92,11
17592,778,8796,L,92,103,-11
17593,517,8797,L,82,88,-6
17594,518,8797,W,88,82,6
17595,432,8798,W,103,82,21
17596,431,8798,L,82,103,-21
17597,174,8799,W,108,106,2
17598,173,8799,L,106,108,-2
17599,227,8800,W,90,82,8
17600,228,8800,L,82,90,-8
17601,377,8801,W,111,100,11
17602,378,8801,L,100,111,-11
17603,494,8802,L,89,108,-19
17604,493,8802,W,108,89,19
17605,363,8803,L,97,106,-9
17606,364,8803,W,106,97,9
17607,484,8804,L,83,105,-22
17608,483,8804,W,105,83,22
17609,877,8805,L,88,105,-17
17610,878,8805,W,105,88,17
17611,6,8806,W,109,95,14
17612,5,8806,L,95,109,-14
17613,97,8807,L,98,130,-32
17614,98,8807,W,130,98,32
17615,793,8808,L,98,106,-8
17616,794,8808,W,106,98,8
17617,175,8809,W,109,105,4
17618,176,8809,L,105,109,-4
17619,160,8810,W,106,100,6
17620,159,8810,L,100,106,-6
17621,535,8811,L,83,121,-38
17622,536,8811,W,121,83,38
17623,788,8812,L,87,107,-20
17624,787,8812,W,107,87,20
17625,592,8813,W,113,83,30
17626,591,8813,L,83,113,-30
17627,444,8814,W,101,81,20
17628,443,8814,L,81,101,-20
17629,605,8815,L,97,107,-10
17630,606,8815,W,107,97,10
17631,613,8816,W,95,86,9
17632,614,8816,L,86,95,-9
17633,530,8817,W,97,88,9
17634,529,8817,L,88,97,-9
17635,486,8818,W,105,98,7
17636,485,8818,L,98,105,-7
17637,630,8819,L,104,111,-7
17638,629,8819,W,111,104,7
17639,319,8820,L,88,98,-10
17640,320,8820,W,98,88,10
17641,358,8821,W,100,97,3
17642,357,8821,L,97,100,-3
17643,585,8822,L,91,110,-19
17644,586,8822,W,110,91,19
17645,343,8823,L,103,112,-9
17646,344,8823,W,112,103,9
17647,99,8824,L,100,108,-8
17648,100,8824,W,108,100,8
17649,841,8825,W,107,97,10
17650,842,8825,L,97,107,-10
17651,912,8826,L,82,89,-7
17652,911,8826,W,89,82,7
17653,4,8827,L,125,126,-1
17654,3,8827,W,126,125,1
17655,785,8828,W,111,87,24
17656,786,8828,L,87,111,-24
17657,426,8829,W,97,95,2
17658,425,8829,L,95,97,-2
17659,424,8830,L,102,106,-4
17660,423,8830,W,106,102,4
17661,57,8831,L,80,98,-18
17662,58,8831,W,98,80,18
17663,461,8832,L,103,109,-6
17664,462,8832,W,109,103,6
17665,633,8833,L,100,102,-2
17666,634,8833,W,102,100,2
17667,537,8834,W,131,128,3
17668,538,8834,L,128,131,-3
17669,782,8835,W,105,100,5
17670,781,8835,L,100,105,-5
17671,675,8836,W,103,99,4
17672,676,8836,L,99,103,-4
17673,594,8837,L,103,113,-10
17674,593,8837,W,113,103,10
17675,436,8838,W,115,113,2
17676,435,8838,L,113,115,-2
17677,872,8839,L,98,99,-1
17678,871,8839,W,99,98,1
17679,149,8840,W,112,98,14
17680,150,8840,L,98,112,-14
17681,266,8841,L,100,115,-15
17682,265,8841,W,115,100,15
17683,45,8842,W,114,108,6
17684,46,8842,L,108,114,-6
17685,382,8843,W,112,106,6
17686,381,8843,L,106,112,-6
17687,48,8844,W,97,88,9
17688,47,8844,L,88,97,-9
17689,169,8845,W,112,106,6
17690,170,8845,L,106,112,-6
17691,325,8846,L,101,108,-7
17692,326,8846,W,108,101,7
17693,274,8847,L,93,97,-4
17694,273,8847,W,97,93,4
17695,2,8848,W,112,104,8
17696,1,8848,L,104,112,-8
17697,100,8849,L,85,92,-7
17698,99,8849,W,92,85,7
17699,1,8850,W,112,101,11
17700,2,8850,L,101,112,-11
17701,238,8851,L,73,93,-20
17702,237,8851,W,93,73,20
17703,733,8852,L,95,114,-19
17704,734,8852,W,114,95,19
17705,463,8853,L,87,88,-1
17706,464,8853,W,88,87,1
17707,755,8854,L,95,97,-2
17708,756,8854,W,97,95,2
17709,232,8855,W,90,83,7
17710,231,8855,L,83,90,-7
17711,767,8856,W,121,105,16
17712,768,8856,L,105,121,-16
17713,354,8857,L,86,103,-17
17714,353,8857,W,103,86,17
17715,702,8858,W,106,102,4
17716,701,8858,L,102,106,-4
17717,394,8859,W,109,91,18
17718,393,8859,L,91,109,-18
17719,828,8860,L,112,113,-1
17720,827,8860,W,113,112,1
17721,894,8861,L,76,92,-16
17722,893,8861,W,92,76,16
17723,470,8862,W,104,98,6
17724,469,8862,L,98,104,-6
17725,284,8863,L,106,120,-14
17726,283,8863,W,120,106,14
17727,457,8864,L,88,94,-6
17728,458,8864,W,94,88,6
17729,176,8865,W,100,92,8
17730,175,8865,L,92,100,-8
17731,447,8866,W,95,84,11
17732,448,8866,L,84,95,-11
17733,684,8867,L,84,113,-29
17734,683,8867,W,113,84,29
17735,901,8868,W,99,74,25
17736,902,8868,L,74,99,-25
17737,669,8869,W,99,79,20
17738,670,8869,L,79,99,-20
17739,697,8870,L,80,93,-13
17740,698,8870,W,93,80,13
17741,460,8871,W,117,110,7
17742,459,8871,L,110,117,-7
17743,652,8872,L,99,103,-4
17744,651,8872,W,103,99,4
17745,3,8873,L,94,105,-11
17746,4,8873,W,105,94,11
17747,286,8874,W,99,94,5
17748,285,8874,L,94,99,-5
17749,23,8875,W,100,93,7
17750,24,8875,L,93,100,-7
17751,427,8876,W,109,92,17
17752,428,8876,L,92,109,-17
17753,450,8877,W,102,101,1
17754,449,8877,L,101,102,-1
17755,142,8878,W,102,100,2
17756,141,8878,L,100,102,-2
17757,814,8879,L,111,116,-5
17758,813,8879,W,116,111,5
17759,201,8880,L,92,107,-15
17760,202,8880,W,107,92,15
17761,485,8881,L,94,113,-19
17762,486,8881,W,113,94,19
17763,720,8882,L,91,102,-11
17764,719,8882,W,102,91,11
17765,434,8883,W,93,86,7
17766,433,8883,L,86,93,-7
17767,56,8884,L,93,112,-19
17768,55,8884,W,112,93,19
17769,712,8885,L,83,89,-6
17770,711,8885,W,89,83,6
17771,267,8886,W,110,96,14
17772,268,8886,L,96,110,-14
17773,635,8887,L,84,98,-14
17774,636,8887,W,98,84,14
17775,880,8888,W,96,86,10
17776,879,8888,L,86,96,-10
17777,159,8889,L,86,100,-14
17778,160,8889,W,100,86,14
17779,762,8890,L,82,121,-39
17780,761,8890,W,121,82,39
17781,678,8891,W,104,96,8
17782,677,8891,L,96,104,-8
17783,51,8892,L,73,95,-22
17784,52,8892,W,95,73,22
17785,575,8893,W,109,97,12
17786,576,8893,L,97,109,-12
17787,524,8894,W,94,87,7
17788,523,8894,L,87,94,-7
17789,249,8895,L,98,106,-8
17790,250,8895,W,106,98,8
17791,287,8896,L,101,112,-11
17792,288,8896,W,112,101,11
17793,893,8897,W,96,72,24
17794,894,8897,L,72,96,-24
17795,268,8898,L,100,102,-2
17796,267,8898,W,102,100,2
17797,612,8899,W,113,101,12
17798,611,8899,L,101,113,-12
17799,116,8900,L,99,101,-2
17800,115,8900,W,101,99,2
17801,279,8901,L,89,98,-9
17802,280,8901,W,98,89,9
17803,302,8902,L,96,126,-30
17804,301,8902,W,126,96,30
17805,469,8903,L,102,103,-1
17806,470,8903,W,103,102,1
17807,184,8904,L,93,103,-10
17808,183,8904,W,103,93,10
17809,916,8905,W,98,91,7
17810,915,8905,L,91,98,-7
17811,466,8906,L,107,115,-8
17812,465,8906,W,115,107,8
17813,815,8907,L,95,98,-3
17814,816,8907,W,98,95,3
17815,109,8908,W,102,86,16
17816,110,8908,L,86,102,-16
17817,725,8909,L,81,111,-30
17818,726,8909,W,111,81,30
17819,637,8910,L,88,96,-8
17820,638,8910,W,96,88,8
17821,44,8911,W,96,89,7
17822,43,8911,L,89,96,-7
17823,419,8912,L,100,104,-4
17824,420,8912,W,104,100,4
17825,42,8913,W,97,82,15
17826,41,8913,L,82,97,-15
17827,422,8914,L,95,102,-7
17828,421,8914,W,102,95,7
17829,869,8915,L,87,97,-10
17830,870,8915,W,97,87,10
17831,148,8916,L,91,105,-14
17832,147,8916,W,105,91,14
17833,672,8917,W,91,82,9
17834,671,8917,L,82,91,-9
17835,472,8918,W,98,91,7
17836,471,8918,L,91,98,-7
17837,887,8919,L,91,95,-4
17838,888,8919,W,95,91,4
17839,108,8920,W,103,96,7
17840,107,8920,L,96,103,-7
17841,38,8921,W,102,98,4
17842,37,8921,L,98,102,-4
17843,664,8922,W,88,81,7
17844,663,8922,L,81,88,-7
17845,682,8923,L,93,104,-11
17846,681,8923,W,104,93,11
17847,43,8924,L,85,93,-8
17848,44,8924,W,93,85,8
17849,263,8925,L,98,105,-7
17850,264,8925,W,105,98,7
17851,54,8926,W,113,106,7
17852,53,8926,L,106,113,-7
17853,259,8927,L,120,123,-3
17854,260,8927,W,123,120,3
17855,115,8928,W,120,92,28
17856,116,8928,L,92,120,-28
17857,39,8929,W,108,98,10
17858,40,8929,L,98,108,-10
17859,296,8930,L,86,92,-6
17860,295,8930,W,92,86,6
17861,406,8931,L,85,109,-24
17862,405,8931,W,109,85,24
17863,53,8932,L,104,107,-3
17864,54,8932,W,107,104,3
17865,838,8933,L,100,104,-4
17866,837,8933,W,104,100,4
17867,480,8934,L,88,104,-16
17868,479,8934,W,104,88,16
17869,239,8935,L,113,115,-2
17870,240,8935,W,115,113,2
17871,163,8936,W,108,98,10
17872,164,8936,L,98,108,-10
17873,874,8937,L,81,86,-5
17874,873,8937,W,86,81,5
17875,667,8938,L,94,97,-3
17876,668,8938,W,97,94,3
17877,443,8939,W,106,102,4
17878,444,8939,L,102,106,-4
17879,608,8940,W,98,87,11
17880,607,8940,L,87,98,-11
17881,408,8941,W,97,86,11
17882,407,8941,L,86,97,-11
17883,701,8942,L,99,114,-15
17884,702,8942,W,114,99,15
17885,689,8943,W,118,110,8
17886,690,8943,L,110,118,-8
17887,75,8944,L,94,110,-16
17888,76,8944,W,110,94,16
17889,193,8945,L,103,110,-7
17890,194,8945,W,110,103,7
17891,473,8946,W,108,100,8
17892,474,8946,L,100,108,-8
17893,477,8947,L,88,106,-18
17894,478,8947,W,106,88,18
17895,871,8948,W,97,81,16
17896,872,8948,L,81,97,-16
17897,768,8949,L,98,135,-37
17898,767,8949,W,135,98,37
17899,471,8950,W,103,96,7
17900,472,8950,L,96,103,-7
17901,50,8951,L,111,122,-11
17902,49,8951,W,122,111,11
17903,272,8952,W,110,90,20
17904,271,8952,L,90,110,-20
17905,411,8953,W,92,79,13
17906,412,8953,L,79,92,-13
17907,607,8954,L,88,102,-14
17908,608,8954,W,102,88,14
17909,360,8955,L,77,104,-27
17910,359,8955,W,104,77,27
17911,389,8956,W,97,90,7
17912,390,8956,L,90,97,-7
17913,247,8957,W,109,96,13
17914,248,8957,L,96,109,-13
17915,552,8958,W,100,98,2
17916,551,8958,L,98,100,-2
17917,446,8959,L,103,113,-10
17918,445,8959,W,113,103,10
17919,883,8960,W,86,80,6
17920,884,8960,L,80,86,-6
17921,459,8961,L,113,117,-4
17922,460,8961,W,117,113,4
17923,404,8962,W,89,86,3
17924,403,8962,L,86,89,-3
17925,417,8963,L,104,110,-6
17926,418,8963,W,110,104,6
17927,559,8964,W,96,80,16
17928,560,8964,L,80,96,-16
17929,157,8965,W,91,82,9
17930,158,8965,L,82,91,-9
17931,371,8966,W,109,106,3
17932,372,8966,L,106,109,-3
17933,827,8967,L,115,116,-1
17934,828,8967,W,116,115,1
17935,283,8968,L,89,90,-1
17936,284,8968,W,90,89,1
17937,206,8969,L,86,107,-21
17938,205,8969,W,107,86,21
17939,700,8970,L,95,124,-29
17940,699,8970,W,124,95,29
17941,128,8971,L,99,111,-12
17942,127,8971,W,111,99,12
17943,264,8972,L,105,111,-6
17944,263,8972,W,111,105,6
17945,271,8973,W,95,91,4
17946,272,8973,L,91,95,-4
17947,879,8974,W,89,83,6
17948,880,8974,L,83,89,-6
17949,147,8975,L,103,111,-8
17950,148,8975,W,111,103,8
17951,152,8976,L,117,123,-6
17952,151,8976,W,123,117,6
17953,190,8977,W,103,87,16
17954,189,8977,L,87,103,-16
17955,836,8978,L,79,92,-13
17956,835,8978,W,92,79,13
17957,138,8979,L,91,94,-3
17958,137,8979,W,94,91,3
17959,526,8980,L,95,105,-10
17960,525,8980,W,105,95,10
17961,34,8981,L,95,113,-18
17962,33,8981,W,113,95,18
17963,384,8982,L,95,116,-21
17964,383,8982,W,116,95,21
17965,25,8983,L,95,118,-23
17966,26,8983,W,118,95,23
17967,195,8984,L,105,120,-15
17968,196,8984,W,120,105,15
17969,451,8985,L,103,109,-6
17970,452,8985,W,109,103,6
17971,136,8986,W,100,81,19
17972,135,8986,L,81,100,-19
17973,798,8987,L,104,110,-6
17974,797,8987,W,110,104,6
17975,235,8988,W,109,85,24
17976,236,8988,L,85,109,-24
17977,810,8989,L,79,95,-16
17978,809,8989,W,95,79,16
17979,273,8990,L,81,96,-15
17980,274,8990,W,96,81,15
17981,37,8991,L,107,109,-2
17982,38,8991,W,109,107,2
17983,876,8992,W,103,94,9
17984,875,8992,L,94,103,-9
17985,829,8993,W,120,89,31
17986,830,8993,L,89,120,-31
17987,27,8994,L,94,101,-7
17988,28,8994,W,101,94,7
17989,63,8995,W,113,90,23
17990,64,8995,L,90,113,-23
17991,187,8996,L,105,106,-1
17992,188,8996,W,106,105,1
17993,125,8997,W,111,110,1
17994,126,8997,L,110,111,-1
17995,502,8998,W,96,91,5
17996,501,8998,L,91,96,-5
17997,294,8999,L,91,115,-24
17998,293,8999,W,115,91,24
17999,316,9000,W,96,85,11
18000,315,9000,L,85,96,-11
18001,663,9001,L,90,108,-18
18002,664,9001,W,108,90,18
18003,69,9002,L,125,127,-2
18004,70,9002,W,127,125,2
18005,345,9003,W,107,94,13
18006,346,9003,L,94,107,-13
18007,427,9004,L,94,104,-10
18008,428,9004,W,104,94,10
18009,198,9005,W,91,83,8
18010,197,9005,L,83,91,-8
18011,519,9006,L,103,114,-11
18012,520,9006,W,114,103,11
18013,920,9007,W,101,91,10
18014,919,9007,L,91,101,-10
18015,244,9008,L,108,112,-4
18016,243,9008,W,112,108,4
18017,721,9009,L,74,76,-2
18018,722,9009,W,76,74,2
18019,711,9010,L,73,97,-24
18020,712,9010,W,97,73,24
18021,381,9011,L,108,116,-8
18022,382,9011,W,116,108,8
18023,355,9012,W,119,110,9
18024,356,9012,L,110,119,-9
18025,196,9013,W,91,89,2
18026,195,9013,L,89,91,-2
18027,454,9014,L,84,91,-7
18028,453,9014,W,91,84,7
18029,383,9015,L,85,96,-11
18030,384,9015,W,96,85,11
18031,315,9016,L,91,104,-13
18032,316,9016,W,104,91,13
18033,70,9017,L,79,94,-15
18034,69,9017,W,94,79,15
18035,542,9018,L,97,102,-5
18036,541,9018,W,102,97,5
18037,130,9019,W,99,98,1
18038,129,9019,L,98,99,-1
18039,694,9020,L,107,109,-2
18040,693,9020,W,109,107,2
18041,234,9021,W,99,84,15
18042,233,9021,L,84,99,-15
18043,589,9022,L,90,98,-8
18044,590,9022,W,98,90,8
18045,763,9023,L,104,109,-5
18046,764,9023,W,109,104,5
18047,581,9024,L,93,107,-14
18048,582,9024,W,107,93,14
18049,105,9025,W,116,102,14
18050,106,9025,L,102,116,-14
18051,923,9026,L,90,92,-2
18052,924,9026,W,92,90,2
18053,76,9027,L,80,97,-17
18054,75,9027,W,97,80,17
18055,601,9028,L,96,99,-3
18056,602,9028,W,99,96,3
18057,713,9029,W,106,93,13
18058,714,9029,L,93,106,-13
18059,335,9030,L,87,97,-10
18060,336,9030,W,97,87,10
18061,232,9031,W,104,95,9
18062,231,9031,L,95,104,-9
18063,220,9032,W,102,94,8
18064,219,9032,L,94,102,-8
18065,919,9033,W,102,97,5
18066,920,9033,L,97,102,-5
18067,94,9034,L,104,123,-19
18068,93,9034,W,123,104,19
18069,850,9035,W,105,100,5
18070,849,9035,L,100,105,-5
18071,73,9036,W,116,101,15
18072,74,9036,L,101,116,-15
18073,647,9037,L,88,104,-16
18074,648,9037,W,104,88,16
18075,28,9038,W,104,98,6
18076,27,9038,L,98,104,-6
18077,791,9039,W,99,91,8
18078,792,9039,L,91,99,-8
18079,699,9040,L,92,93,-1
18080,700,9040,W,93,92,1
18081,346,9041,L,118,137,-19
18082,345,9041,W,137,118,19
18083,24,9042,L,88,95,-7
18084,23,9042,W,95,88,7
18085,324,9043,W,110,90,20
18086,323,9043,L,90,110,-20
18087,308,9044,L,93,103,-10
18088,307,9044,W,103,93,10
18089,758,9045,L,103,105,-2
18090,757,9045,W,105,103,2
18091,868,9046,W,109,100,9
18092,867,9046,L,100,109,-9
18093,642,9047,L,77,87,-10
18094,641,9047,W,87,77,10
18095,179,9048,L,86,107,-21
18096,180,9048,W,107,86,21
18097,182,9049,L,96,103,-7
18098,181,9049,W,103,96,7
18099,908,9050,L,84,105,-21
18100,907,9050,W,105,84,21
18101,533,9051,L,105,115,-10
18102,534,9051,W,115,105,10
18103,333,9052,L,99,111,-12
18104,334,9052,W,111,99,12
18105,435,9053,L,87,98,-11
18106,436,9053,W,98,87,11
18107,185,9054,W,97,90,7
18108,186,9054,L,90,97,-7
18109,513,9055,L,104,107,-3
18110,514,9055,W,107,104,3
18111,11,9056,L,74,89,-15
18112,12,9056,W,89,74,15
18113,461,9057,W,104,93,11
18114,462,9057,L,93,104,-11
18115,549,9058,L,108,111,-3
18116,550,9058,W,111,108,3
18117,884,9059,L,84,90,-6
18118,883,9059,W,90,84,6
18119,106,9060,W,109,102,7
18120,105,9060,L,102,109,-7
18121,16,9061,W,91,85,6
18122,15,9061,L,85,91,-6
18123,260,9062,L,105,113,-8
18124,259,9062,W,113,105,8
18125,153,9063,L,90,110,-20
18126,154,9063,W,110,90,20
18127,580,9064,L,95,102,-7
18128,579,9064,W,102,95,7
18129,2,9065,L,84,87,-3
18130,1,9065,W,87,84,3
18131,99,9066,W,105,98,7
18132,100,9066,L,98,105,-7
18133,396,9067,L,100,101,-1
18134,395,9067,W,101,100,1
18135,470,9068,W,110,101,9
18136,469,9068,L,101,110,-9
18137,593,9069,L,81,100,-19
18138,594,9069,W,100,81,19
18139,209,9070,W,113,98,15
18140,210,9070,L,98,113,-15
18141,400,9071,L,81,82,-1
18142,399,9071,W,82,81,1
18143,276,9072,L,115,126,-11
18144,275,9072,W,126,115,11
18145,110,9073,L,94,101,-7
18146,109,9073,W,101,94,7
18147,52,9074,W,101,98,3
18148,51,9074,L,98,101,-3
18149,284,9075,L,91,104,-13
18150,283,9075,W,104,91,13
18151,31,9076,L,88,90,-2
18152,32,9076,W,90,88,2
18153,821,9077,L,94,98,-4
18154,822,9077,W,98,94,4
18155,67,9078,L,83,90,-7
18156,68,9078,W,90,83,7
18157,890,9079,L,83,96,-13
18158,889,9079,W,96,83,13
18159,618,9080,L,102,113,-11
18160,617,9080,W,113,102,11
18161,331,9081,L,115,120,-5
18162,332,9081,W,120,115,5
18163,522,9082,W,95,90,5
18164,521,9082,L,90,95,-5
18165,558,9083,L,110,114,-4
18166,557,9083,W,114,110,4
18167,421,9084,L,94,125,-31
18168,422,9084,W,125,94,31
18169,131,9085,L,87,93,-6
18170,132,9085,W,93,87,6
18171,464,9086,L,109,118,-9
18172,463,9086,W,118,109,9
18173,119,9087,L,103,116,-13
18174,120,9087,W,116,103,13
18175,787,9088,L,95,107,-12
18176,788,9088,W,107,95,12
18177,225,9089,L,87,97,-10
18178,226,9089,W,97,87,10
18179,620,9090,L,88,95,-7
18180,619,9090,W,95,88,7
18181,620,9091,L,100,103,-3
18182,619,9091,W,103,100,3
18183,619,9092,L,104,114,-10
18184,620,9092,W,114,104,10
18185,619,9093,W,109,93,16
18186,620,9093,L,93,109,-16
18187,619,9094,L,77,113,-36
18188,620,9094,W,113,77,36
18189,620,9095,L,84,103,-19
18190,619,9095,W,103,84,19
18191,620,9096,W,92,88,4
18192,619,9096,L,88,92,-4
18193,139,9097,L,76,99,-23
18194,140,9097,W,99,76,23
18195,140,9098,L,77,91,-14
18196,139,9098,W,91,77,14
18197,139,9099,L,79,90,-11
18198,140,9099,W,90,79,11
18199,140,9100,L,92,99,-7
18200,139,9100,W,99,92,7
18201,109,9101,W,93,86,7
18202,110,9101,L,86,93,-7
18203,140,9102,W,114,96,18
18204,139,9102,L,96,114,-18
18205,109,9103,W,104,93,11
18206,110,9103,L,93,104,-11
18207,139,9104,W,97,93,4
18208,140,9104,L,93,97,-4
18209,139,9105,L,102,103,-1
18210,140,9105,W,103,102,1
18211,110,9106,L,89,93,-4
18212,109,9106,W,93,89,4
18213,110,9107,L,83,105,-22
18214,109,9107,W,105,83,22
18215,107,9108,L,99,106,-7
18216,108,9108,W,106,99,7
18217,722,9109,W,94,82,12
18218,721,9109,L,82,94,-12
18219,108,9110,L,75,85,-10
18220,107,9110,W,85,75,10
18221,208,9111,W,88,84,4
18222,207,9111,L,84,88,-4
18223,787,9112,L,91,94,-3
18224,788,9112,W,94,91,3
18225,721,9113,L,91,109,-18
18226,722,9113,W,109,91,18
18227,107,9114,L,82,93,-11
18228,108,9114,W,93,82,11
18229,788,9115,W,88,65,23
18230,787,9115,L,65,88,-23
18231,207,9116,L,97,103,-6
18232,208,9116,W,103,97,6
18233,722,9117,L,87,97,-10
18234,721,9117,W,97,87,10
18235,207,9118,L,81,87,-6
18236,208,9118,W,87,81,6
18237,107,9119,L,71,82,-11
18238,108,9119,W,82,71,11
18239,788,9120,W,104,94,10
18240,787,9120,L,94,104,-10
18241,722,9121,W,102,92,10
18242,721,9121,L,92,102,-10
18243,787,9122,L,78,115,-37
18244,788,9122,W,115,78,37
18245,721,9123,W,100,91,9
18246,722,9123,L,91,100,-9
18247,108,9124,L,79,105,-26
18248,107,9124,W,105,79,26
18249,208,9125,W,99,93,6
18250,207,9125,L,93,99,-6
18251,787,9126,W,93,86,7
18252,788,9126,L,86,93,-7
18253,721,9127,L,127,129,-2
18254,722,9127,W,129,127,2
18255,208,9128,L,91,93,-2
18256,207,9128,W,93,91,2
18257,108,9129,W,102,95,7
18258,107,9129,L,95,102,-7
18259,297,9130,W,99,93,6
18260,298,9130,L,93,99,-6
18261,444,9131,L,105,118,-13
18262,443,9131,W,118,105,13
18263,707,9132,W,81,73,8
18264,708,9132,L,73,81,-8
18265,133,9133,W,103,94,9
18266,134,9133,L,94,103,-9
18267,812,9134,W,88,80,8
18268,811,9134,L,80,88,-8
18269,370,9135,L,88,92,-4
18270,369,9135,W,92,88,4
18271,298,9136,W,95,92,3
18272,297,9136,L,92,95,-3
18273,811,9137,W,92,86,6
18274,812,9137,L,86,92,-6
18275,134,9138,W,107,100,7
18276,133,9138,L,100,107,-7
18277,708,9139,L,83,106,-23
18278,707,9139,W,106,83,23
18279,443,9140,W,103,93,10
18280,444,9140,L,93,103,-10
18281,369,9141,L,100,107,-7
18282,370,9141,W,107,100,7
18283,297,9142,L,91,110,-19
18284,298,9142,W,110,91,19
18285,133,9143,L,103,105,-2
18286,134,9143,W,105,103,2
18287,707,9144,L,91,102,-11
18288,708,9144,W,102,91,11
18289,16,9145,W,103,82,21
18290,15,9145,L,82,103,-21
18291,812,9146,L,90,97,-7
18292,811,9146,W,97,90,7
18293,26,9147,W,88,77,11
18294,25,9147,L,77,88,-11
18295,370,9148,L,101,115,-14
18296,369,9148,W,115,101,14
18297,298,9149,L,134,142,-8
18298,297,9149,W,142,134,8
18299,133,9150,W,104,101,3
18300,134,9150,L,101,104,-3
18301,444,9151,L,83,104,-21
18302,443,9151,W,104,83,21
18303,707,9152,L,69,90,-21
18304,708,9152,W,90,69,21
18305,370,9153,L,108,110,-2
18306,369,9153,W,110,108,2
18307,812,9154,W,90,76,14
18308,811,9154,L,76,90,-14
18309,16,9155,W,120,89,31
18310,15,9155,L,89,120,-31
18311,444,9156,L,82,94,-12
18312,443,9156,W,94,82,12
18313,26,9157,W,104,91,13
18314,25,9157,L,91,104,-13
18315,298,9158,L,76,79,-3
18316,297,9158,W,79,76,3
18317,708,9159,L,98,113,-15
18318,707,9159,W,113,98,15
18319,134,9160,L,102,105,-3
18320,133,9160,W,105,102,3
18321,15,9161,L,91,102,-11
18322,16,9161,W,102,91,11
18323,369,9162,W,131,117,14
18324,370,9162,L,117,131,-14
18325,811,9163,L,71,87,-16
18326,812,9163,W,87,71,16
18327,25,9164,L,86,98,-12
18328,26,9164,W,98,86,12
18329,443,9165,L,91,93,-2
18330,444,9165,W,93,91,2
18331,297,9166,W,90,82,8
18332,298,9166,L,82,90,-8
18333,708,9167,L,90,107,-17
18334,707,9167,W,107,90,17
18335,15,9168,L,79,91,-12
18336,16,9168,W,91,79,12
18337,134,9169,L,91,120,-29
18338,133,9169,W,120,91,29
18339,25,9170,L,87,110,-23
18340,26,9170,W,110,87,23
18341,443,9171,L,91,112,-21
18342,444,9171,W,112,91,21
18343,369,9172,L,95,97,-2
18344,370,9172,W,97,95,2
18345,297,9173,L,89,106,-17
18346,298,9173,W,106,89,17
18347,811,9174,L,78,85,-7
18348,812,9174,W,85,78,7
18349,817,9175,W,108,95,13
18350,818,9175,L,95,108,-13
18351,611,9176,W,99,88,11
18352,612,9176,L,88,99,-11
18353,10,9177,L,92,95,-3
18354,9,9177,W,95,92,3
18355,520,9178,L,98,118,-20
18356,519,9178,W,118,98,20
18357,216,9179,L,70,86,-16
18358,215,9179,W,86,70,16
18359,470,9180,W,112,108,4
18360,469,9180,L,108,112,-4
18361,129,9181,L,95,99,-4
18362,130,9181,W,99,95,4
18363,884,9182,L,98,105,-7
18364,883,9182,W,105,98,7
18365,131,9183,L,90,114,-24
18366,132,9183,W,114,90,24
18367,575,9184,L,99,103,-4
18368,576,9184,W,103,99,4
18369,272,9185,L,92,98,-6
18370,271,9185,W,98,92,6
18371,249,9186,W,105,95,10
18372,250,9186,L,95,105,-10
18373,116,9187,L,93,105,-12
18374,115,9187,W,105,93,12
18375,412,9188,W,95,89,6
18376,411,9188,L,89,95,-6
18377,929,9189,L,87,99,-12
18378,930,9189,W,99,87,12
18379,17,9190,L,77,93,-16
18380,18,9190,W,93,77,16
18381,580,9191,W,113,96,17
18382,579,9191,L,96,113,-17
18383,737,9192,W,102,84,18
18384,738,9192,L,84,102,-18
18385,447,9193,W,96,95,1
18386,448,9193,L,95,96,-1
18387,722,9194,L,106,116,-10
18388,721,9194,W,116,106,10
18389,266,9195,L,101,109,-8
18390,265,9195,W,109,101,8
18391,920,9196,L,95,106,-11
18392,919,9196,W,106,95,11
18393,425,9197,L,95,104,-9
18394,426,9197,W,104,95,9
18395,529,9198,L,112,119,-7
18396,530,9198,W,119,112,7
18397,290,9199,W,112,111,1
18398,289,9199,L,111,112,-1
18399,80,9200,W,96,80,16
18400,79,9200,L,80,96,-16
18401,333,9201,W,103,97,6
18402,334,9201,L,97,103,-6
18403,243,9202,L,101,106,-5
18404,244,9202,W,106,101,5
18405,108,9203,L,80,90,-10
18406,107,9203,W,90,80,10
18407,787,9204,L,93,105,-12
18408,788,9204,W,105,93,12
18409,142,9205,L,87,93,-6
18410,141,9205,W,93,87,6
18411,209,9206,L,109,118,-9
18412,210,9206,W,118,109,9
18413,930,9207,W,107,89,18
18414,929,9207,L,89,107,-18
18415,16,9208,L,86,91,-5
18416,15,9208,W,91,86,5
18417,70,9209,L,77,91,-14
18418,69,9209,W,91,77,14
18419,7,9210,L,100,121,-21
18420,8,9210,W,121,100,21
18421,444,9211,W,91,87,4
18422,443,9211,L,87,91,-4
18423,894,9212,L,85,95,-10
18424,893,9212,W,95,85,10
18425,196,9213,W,120,88,32
18426,195,9213,L,88,120,-32
18427,780,9214,L,93,105,-12
18428,779,9214,W,105,93,12
18429,422,9215,L,116,118,-2
18430,421,9215,W,118,116,2
18431,125,9216,L,101,109,-8
18432,126,9216,W,109,101,8
18433,501,9217,W,117,109,8
18434,502,9217,L,109,117,-8
18435,433,9218,W,82,78,4
18436,434,9218,L,78,82,-4
18437,267,9219,L,105,108,-3
18438,268,9219,W,108,105,3
18439,79,9220,L,100,107,-7
18440,80,9220,W,107,100,7
18441,735,9221,L,104,109,-5
18442,736,9221,W,109,104,5
18443,931,9222,W,96,93,3
18444,932,9222,L,93,96,-3
18445,559,9223,L,88,97,-9
18446,560,9223,W,97,88,9
18447,106,9224,W,97,86,11
18448,105,9224,L,86,97,-11
18449,29,9225,W,101,91,10
18450,30,9225,L,91,101,-10
18451,910,9226,L,93,113,-20
18452,909,9226,W,113,93,20
18453,630,9227,W,106,90,16
18454,629,9227,L,90,106,-16
18455,261,9228,L,101,108,-7
18456,262,9228,W,108,101,7
18457,400,9229,L,111,118,-7
18458,399,9229,W,118,111,7
18459,827,9230,W,116,97,19
18460,828,9230,L,97,116,-19
18461,46,9231,W,113,106,7
18462,45,9231,L,106,113,-7
18463,220,9232,L,86,96,-10
18464,219,9232,W,96,86,10
18465,138,9233,L,103,113,-10
18466,137,9233,W,113,103,10
18467,72,9234,W,111,104,7
18468,71,9234,L,104,111,-7
18469,307,9235,W,103,98,5
18470,308,9235,L,98,103,-5
18471,118,9236,W,102,91,11
18472,117,9236,L,91,102,-11
18473,37,9237,L,95,111,-16
18474,38,9237,W,111,95,16
18475,933,9238,L,110,121,-11
18476,934,9238,W,121,110,11
18477,445,9239,W,124,101,23
18478,446,9239,L,101,124,-23
18479,91,9240,W,101,93,8
18480,92,9240,L,93,101,-8
18481,482,9241,L,83,104,-21
18482,481,9241,W,104,83,21
18483,530,9242,L,98,101,-3
18484,529,9242,W,101,98,3
18485,25,9243,L,83,94,-11
18486,26,9243,W,94,83,11
18487,714,9244,L,89,105,-16
18488,713,9244,W,105,89,16
18489,280,9245,L,99,120,-21
18490,279,9245,W,120,99,21
18491,52,9246,W,90,80,10
18492,51,9246,L,80,90,-10
18493,935,9247,L,96,104,-8
18494,936,9247,W,104,96,8
18495,560,9248,W,101,98,3
18496,559,9248,L,98,101,-3
18497,899,9249,L,75,94,-19
18498,900,9249,W,94,75,19
18499,11,9250,L,94,99,-5
18500,12,9250,W,99,94,5
18501,155,9251,L,96,107,-11
18502,156,9251,W,107,96,11
18503,795,9252,L,85,91,-6
18504,796,9252,W,91,85,6
18505,120,9253,L,95,109,-14
18506,119,9253,W,109,95,14
18507,174,9254,W,96,91,5
18508,173,9254,L,91,96,-5
18509,937,9255,W,95,92,3
18510,938,9255,L,92,95,-3
18511,330,9256,W,125,120,5
18512,329,9256,L,120,125,-5
18513,408,9257,W,89,87,2
18514,407,9257,L,87,89,-2
18515,669,9258,L,85,99,-14
18516,670,9258,W,99,85,14
18517,607,9259,W,97,90,7
18518,608,9259,L,90,97,-7
18519,237,9260,L,85,104,-19
18520,238,9260,W,104,85,19
18521,557,9261,L,87,106,-19
18522,558,9261,W,106,87,19
18523,49,9262,L,114,132,-18
18524,50,9262,W,132,114,18
18525,633,9263,L,97,99,-2
18526,634,9263,W,99,97,2
18527,888,9264,L,96,105,-9
18528,887,9264,W,105,96,9
18529,111,9265,L,101,107,-6
18530,112,9265,W,107,101,6
18531,185,9266,L,83,100,-17
18532,186,9266,W,100,83,17
18533,508,9267,W,95,93,2
18534,507,9267,L,93,95,-2
18535,939,9268,L,83,95,-12
18536,940,9268,W,95,83,12
18537,404,9269,L,84,86,-2
18538,403,9269,W,86,84,2
18539,446,9270,W,101,90,11
18540,445,9270,L,90,101,-11
18541,67,9271,L,83,101,-18
18542,68,9271,W,101,83,18
18543,802,9272,W,97,75,22
18544,801,9272,L,75,97,-22
18545,871,9273,W,89,79,10
18546,872,9273,L,79,89,-10
18547,73,9274,W,116,98,18
18548,74,9274,L,98,116,-18
18549,354,9275,W,97,91,6
18550,353,9275,L,91,97,-6
18551,221,9276,W,117,108,9
18552,222,9276,L,108,117,-9
18553,738,9277,L,86,87,-1
18554,737,9277,W,87,86,1
18555,401,9278,W,111,107,4
18556,402,9278,L,107,111,-4
18557,268,9279,L,94,95,-1
18558,267,9279,W,95,94,1
18559,297,9280,W,92,90,2
18560,298,9280,L,90,92,-2
18561,457,9281,L,88,100,-12
18562,458,9281,W,100,88,12
18563,393,9282,L,84,98,-14
18564,394,9282,W,98,84,14
18565,821,9283,W,113,95,18
18566,822,9283,L,95,113,-18
18567,941,9284,L,88,98,-10
18568,942,9284,W,98,88,10
18569,145,9285,W,94,76,18
18570,146,9285,L,76,94,-18
18571,8,9286,W,112,102,10
18572,7,9286,L,102,112,-10
18573,717,9287,W,107,98,9
18574,718,9287,L,98,107,-9
18575,637,9288,L,78,88,-10
18576,638,9288,W,88,78,10
18577,877,9289,L,83,88,-5
18578,878,9289,W,88,83,5
18579,271,9290,W,95,82,13
18580,272,9290,L,82,95,-13
18581,223,9291,L,101,126,-25
18582,224,9291,W,126,101,25
18583,136,9292,W,113,96,17
18584,135,9292,L,96,113,-17
18585,641,9293,L,93,98,-5
18586,642,9293,W,98,93,5
18587,93,9294,L,81,101,-20
18588,94,9294,W,101,81,20
18589,666,9295,W,102,90,12
18590,665,9295,L,90,102,-12
18591,9,9296,L,86,90,-4
18592,10,9296,W,90,86,4
18593,313,9297,L,103,111,-8
18594,314,9297,W,111,103,8
18595,109,9298,L,90,92,-2
18596,110,9298,W,92,90,2
18597,566,9299,W,108,98,10
18598,565,9299,L,98,108,-10
18599,494,9300,L,94,102,-8
18600,493,9300,W,102,94,8
18601,477,9301,L,100,110,-10
18602,478,9301,W,110,100,10
18603,893,9302,L,102,131,-29
18604,894,9302,W,131,102,29
18605,98,9303,L,102,112,-10
18606,97,9303,W,112,102,10
18607,782,9304,W,109,106,3
18608,781,9304,L,106,109,-3
18609,943,9305,L,92,112,-20
18610,944,9305,W,112,92,20
18611,619,9306,W,88,86,2
18612,620,9306,L,86,88,-2
18613,638,9307,L,92,109,-17
18614,637,9307,W,109,92,17
18615,811,9308,L,89,108,-19
18616,812,9308,W,108,89,19
18617,670,9309,L,94,95,-1
18618,669,9309,W,95,94,1
18619,345,9310,L,81,98,-17
18620,346,9310,W,98,81,17
18621,411,9311,W,109,99,10
18622,412,9311,L,99,109,-10
18623,427,9312,L,88,97,-9
18624,428,9312,W,97,88,9
18625,211,9313,W,112,104,8
18626,212,9313,L,104,112,-8
18627,612,9314,L,98,125,-27
18628,611,9314,W,125,98,27
18629,686,9315,W,99,86,13
18630,685,9315,L,86,99,-13
18631,878,9316,L,92,100,-8
18632,877,9316,W,100,92,8
18633,380,9317,L,98,100,-2
18634,379,9317,W,100,98,2
18635,160,9318,W,103,98,5
18636,159,9318,L,98,103,-5
18637,648,9319,L,107,116,-9
18638,647,9319,W,116,107,9
18639,565,9320,W,99,82,17
18640,566,9320,L,82,99,-17
18641,919,9321,L,102,111,-9
18642,920,9321,W,111,102,9
18643,58,9322,L,92,97,-5
18644,57,9322,W,97,92,5
18645,434,9323,L,94,103,-9
18646,433,9323,W,103,94,9
18647,786,9324,L,87,109,-22
18648,785,9324,W,109,87,22
18649,945,9325,W,108,89,19
18650,946,9325,L,89,108,-19
18651,593,9326,L,93,101,-8
18652,594,9326,W,101,93,8
18653,97,9327,W,105,95,10
18654,98,9327,L,95,105,-10
18655,523,9328,L,107,118,-11
18656,524,9328,W,118,107,11
18657,548,9329,L,102,104,-2
18658,547,9329,W,104,102,2
18659,69,9330,W,97,87,10
18660,70,9330,L,87,97,-10
18661,311,9331,W,103,78,25
18662,312,9331,L,78,103,-25
18663,338,9332,L,103,113,-10
18664,337,9332,W,113,103,10
18665,54,9333,W,117,103,14
18666,53,9333,L,103,117,-14
18667,64,9334,W,120,117,3
18668,63,9334,L,117,120,-3
18669,164,9335,W,111,93,18
18670,163,9335,L,93,111,-18
18671,788,9336,L,97,101,-4
18672,787,9336,W,101,97,4
18673,187,9337,L,80,103,-23
18674,188,9337,W,103,80,23
18675,219,9338,L,99,100,-1
18676,220,9338,W,100,99,1
18677,573,9339,L,101,108,-7
18678,574,9339,W,108,101,7
18679,931,9340,W,105,91,14
18680,932,9340,L,91,105,-14
18681,435,9341,W,105,98,7
18682,436,9341,L,98,105,-7
18683,466,9342,L,92,100,-8
18684,465,9342,W,100,92,8
18685,579,9343,W,107,88,19
18686,580,9343,L,88,107,-19
18687,165,9344,W,100,91,9
18688,166,9344,L,91,100,-9
18689,1,9345,L,88,103,-15
18690,2,9345,W,103,88,15
18691,885,9346,L,108,114,-6
18692,886,9346,W,114,108,6
18693,353,9347,W,93,92,1
18694,354,9347,L,92,93,-1
18695,112,9348,W,105,82,23
18696,111,9348,L,82,105,-23
18697,66,9349,L,102,109,-7
18698,65,9349,W,109,102,7
18699,812,9350,W,100,85,15
18700,811,9350,L,85,100,-15
18701,806,9351,L,91,107,-16
18702,805,9351,W,107,91,16
18703,515,9352,L,94,107,-13
18704,516,9352,W,107,94,13
18705,115,9353,W,108,94,14
18706,116,9353,L,94,108,-14
18707,421,9354,L,103,109,-6
18708,422,9354,W,109,103,6
18709,708,9355,L,94,100,-6
18710,707,9355,W,100,94,6
18711,947,9356,L,86,110,-24
18712,948,9356,W,110,86,24
18713,872,9357,L,77,109,-32
18714,871,9357,W,109,77,32
18715,629,9358,L,83,103,-20
18716,630,9358,W,103,83,20
18717,170,9359,L,95,96,-1
18718,169,9359,W,96,95,1
18719,341,9360,W,117,103,14
18720,342,9360,L,103,117,-14
18721,552,9361,W,102,100,2
18722,551,9361,L,100,102,-2
18723,736,9362,W,104,99,5
18724,735,9362,L,99,104,-5
18725,184,9363,L,108,113,-5
18726,183,9363,W,113,108,5
18727,349,9364,W,104,97,7
18728,350,9364,L,97,104,-7
18729,14,9365,L,84,110,-26
18730,13,9365,W,110,84,26
18731,75,9366,L,84,87,-3
18732,76,9366,W,87,84,3
18733,385,9367,L,92,101,-9
18734,386,9367,W,101,92,9
18735,193,9368,L,95,101,-6
18736,194,9368,W,101,95,6
18737,32,9369,L,95,101,-6
18738,31,9369,W,101,95,6
18739,24,9370,L,106,110,-4
18740,23,9370,W,110,106,4
18741,909,9371,W,92,91,1
18742,910,9371,L,91,92,-1
18743,158,9372,L,97,104,-7
18744,157,9372,W,104,97,7
18745,13,9373,W,99,94,5
18746,14,9373,L,94,99,-5
18747,745,9374,L,94,104,-10
18748,746,9374,W,104,94,10
18749,779,9375,W,117,86,31
18750,780,9375,L,86,117,-31
18751,813,9376,W,103,100,3
18752,814,9376,L,100,103,-3
18753,36,9377,W,97,89,8
18754,35,9377,L,89,97,-8
18755,360,9378,L,78,102,-24
18756,359,9378,W,102,78,24
18757,397,9379,W,104,93,11
18758,398,9379,L,93,104,-11
18759,949,9380,L,83,90,-7
18760,950,9380,W,90,83,7
18761,841,9381,L,89,103,-14
18762,842,9381,W,103,89,14
18763,774,9382,L,78,116,-38
18764,773,9382,W,116,78,38
18765,553,9383,L,98,101,-3
18766,554,9383,W,101,98,3
18767,778,9384,L,100,101,-1
18768,777,9384,W,101,100,1
18769,816,9385,W,99,89,10
18770,815,9385,L,89,99,-10
18771,207,9386,L,89,90,-1
18772,208,9386,W,90,89,1
18773,951,9387,L,86,87,-1
18774,952,9387,W,87,86,1
18775,535,9388,L,94,106,-12
18776,536,9388,W,106,94,12
18777,923,9389,L,101,107,-6
18778,924,9389,W,107,101,6
18779,735,9390,L,90,98,-8
18780,736,9390,W,98,90,8
18781,721,9391,L,93,104,-11
18782,722,9391,W,104,93,11
18783,258,9392,W,88,79,9
18784,257,9392,L,79,88,-9
18785,447,9393,W,98,95,3
18786,448,9393,L,95,98,-3
18787,462,9394,L,93,100,-7
18788,461,9394,W,100,93,7
18789,391,9395,L,72,101,-29
18790,392,9395,W,101,72,29
18791,709,9396,W,113,96,17
18792,710,9396,L,96,113,-17
18793,470,9397,L,101,116,-15
18794,469,9397,W,116,101,15
18795,239,9398,W,114,104,10
18796,240,9398,L,104,114,-10
18797,225,9399,L,73,95,-22
18798,226,9399,W,95,73,22
18799,672,9400,L,95,102,-7
18800,671,9400,W,102,95,7
18801,685,9401,L,77,92,-15
18802,686,9401,W,92,77,15
18803,463,9402,W,127,113,14
18804,464,9402,L,113,127,-14
18805,12,9403,W,111,90,21
18806,11,9403,L,90,111,-21
18807,942,9404,W,93,72,21
18808,941,9404,L,72,93,-21
18809,126,9405,W,105,103,2
18810,125,9405,L,103,105,-2
18811,348,9406,W,90,83,7
18812,347,9406,L,83,90,-7
18813,576,9407,W,119,82,37
18814,575,9407,L,82,119,-37
18815,882,9408,L,114,119,-5
18816,881,9408,W,119,114,5
18817,192,9409,L,100,101,-1
18818,191,9409,W,101,100,1
18819,870,9410,W,119,118,1
18820,869,9410,L,118,119,-1
18821,504,9411,L,76,99,-23
18822,503,9411,W,99,76,23
18823,159,9412,L,102,113,-11
18824,160,9412,W,113,102,11
18825,484,9413,W,108,78,30
18826,483,9413,L,78,108,-30
18827,21,9414,W,105,93,12
18828,22,9414,L,93,105,-12
18829,232,9415,W,108,91,17
18830,231,9415,L,91,108,-17
18831,582,9416,W,107,101,6
18832,581,9416,L,101,107,-6
18833,697,9417,L,80,93,-13
18834,698,9417,W,93,80,13
18835,953,9418,L,95,97,-2
18836,954,9418,W,97,95,2
18837,137,9419,L,109,115,-6
18838,138,9419,W,115,109,6
18839,257,9420,L,105,127,-22
18840,258,9420,W,127,105,22
18841,215,9421,L,84,90,-6
18842,216,9421,W,90,84,6
18843,250,9422,L,91,98,-7
18844,249,9422,W,98,91,7
18845,302,9423,L,113,119,-6
18846,301,9423,W,119,113,6
18847,451,9424,L,101,112,-11
18848,452,9424,W,112,101,11
18849,879,9425,L,88,105,-17
18850,880,9425,W,105,88,17
18851,287,9426,L,100,108,-8
18852,288,9426,W,108,100,8
18853,649,9427,L,94,107,-13
18854,650,9427,W,107,94,13
18855,35,9428,L,104,117,-13
18856,36,9428,W,117,104,13
18857,924,9429,L,78,92,-14
18858,923,9429,W,92,78,14
18859,955,9430,L,87,96,-9
18860,956,9430,W,96,87,9
18861,578,9431,L,80,87,-7
18862,577,9431,W,87,80,7
18863,833,9432,L,86,96,-10
18864,834,9432,W,96,86,10
18865,62,9433,W,113,95,18
18866,61,9433,L,95,113,-18
18867,199,9434,W,99,93,6
18868,200,9434,L,93,99,-6
18869,26,9435,W,107,94,13
18870,25,9435,L,94,107,-13
18871,277,9436,L,91,92,-1
18872,278,9436,W,92,91,1
18873,720,9437,L,90,105,-15
18874,719,9437,W,105,90,15
18875,755,9438,L,94,117,-23
18876,756,9438,W,117,94,23
18877,175,9439,L,93,106,-13
18878,176,9439,W,106,93,13
18879,443,9440,W,96,85,11
18880,444,9440,L,85,96,-11
18881,132,9441,L,88,112,-24
18882,131,9441,W,112,88,24
18883,635,9442,L,91,107,-16
18884,636,9442,W,107,91,16
18885,51,9443,L,87,110,-23
18886,52,9443,W,110,87,23
18887,34,9444,L,97,105,-8
18888,33,9444,W,105,97,8
18889,558,9445,W,98,94,4
18890,557,9445,L,94,98,-4
18891,530,9446,L,81,111,-30
18892,529,9446,W,111,81,30
18893,598,9447,L,79,121,-42
18894,597,9447,W,121,79,42
18895,757,9448,L,92,96,-4
18896,758,9448,W,96,92,4
18897,957,9449,L,98,108,-10
18898,958,9449,W,108,98,10
18899,198,9450,W,115,108,7
18900,197,9450,L,108,115,-7
18901,880,9451,L,74,100,-26
18902,879,9451,W,100,74,26
18903,145,9452,W,102,97,5
18904,146,9452,L,97,102,-5
18905,480,9453,L,81,98,-17
18906,479,9453,W,98,81,17
18907,646,9454,W,106,97,9
18908,645,9454,L,97,106,-9
18909,818,9455,L,83,107,-24
18910,817,9455,W,107,83,24
18911,472,9456,L,90,95,-5
18912,471,9456,W,95,90,5
18913,771,9457,L,63,92,-29
18914,772,9457,W,92,63,29
18915,322,9458,L,90,103,-13
18916,321,9458,W,103,90,13
18917,458,9459,L,93,105,-12
18918,457,9459,W,105,93,12
18919,519,9460,W,108,93,15
18920,520,9460,L,93,108,-15
18921,481,9461,L,97,106,-9
18922,482,9461,W,106,97,9
18923,139,9462,L,91,105,-14
18924,140,9462,W,105,91,14
18925,300,9463,L,79,91,-12
18926,299,9463,W,91,79,12
18927,381,9464,W,100,77,23
18928,382,9464,L,77,100,-23
18929,572,9465,L,96,100,-4
18930,571,9465,W,100,96,4
18931,715,9466,L,97,129,-32
18932,716,9466,W,129,97,32
18933,852,9467,L,81,90,-9
18934,851,9467,W,90,81,9
18935,3,9468,L,91,99,-8
18936,4,9468,W,99,91,8
18937,959,9469,L,96,98,-2
18938,960,9469,W,98,96,2
18939,510,9470,W,115,113,2
18940,509,9470,L,113,115,-2
18941,96,9471,W,103,93,10
18942,95,9471,L,93,103,-10
18943,881,9472,L,87,104,-17
18944,882,9472,W,104,87,17
18945,950,9473,L,85,96,-11
18946,949,9473,W,96,85,11
18947,347,9474,L,84,113,-29
18948,348,9474,W,113,84,29
18949,459,9475,L,88,111,-23
18950,460,9475,W,111,88,23
18951,529,9476,L,105,107,-2
18952,530,9476,W,107,105,2
18953,22,9477,W,93,80,13
18954,21,9477,L,80,93,-13
18955,226,9478,W,115,86,29
18956,225,9478,L,86,115,-29
18957,483,9479,W,94,88,6
18958,484,9479,L,88,94,-6
18959,632,9480,W,103,92,11
18960,631,9480,L,92,103,-11
18961,523,9481,L,102,107,-5
18962,524,9481,W,107,102,5
18963,252,9482,L,116,118,-2
18964,251,9482,W,118,116,2
18965,769,9483,W,102,99,3
18966,770,9483,L,99,102,-3
18967,534,9484,W,136,106,30
18968,533,9484,L,106,136,-30
18969,711,9485,L,88,89,-1
18970,712,9485,W,89,88,1
18971,904,9486,W,116,94,22
18972,903,9486,L,94,116,-22
18973,243,9487,L,78,95,-17
18974,244,9487,W,95,78,17
18975,53,9488,L,112,121,-9
18976,54,9488,W,121,112,9
18977,557,9489,L,93,102,-9
18978,558,9489,W,102,93,9
18979,329,9490,W,95,94,1
18980,330,9490,L,94,95,-1
18981,87,9491,L,92,107,-15
18982,88,9491,W,107,92,15
18983,146,9492,L,85,91,-6
18984,145,9492,W,91,85,6
18985,584,9493,L,83,101,-18
18986,583,9493,W,101,83,18
18987,259,9494,L,108,112,-4
18988,260,9494,W,112,108,4
18989,936,9495,W,108,102,6
18990,935,9495,L,102,108,-6
18991,887,9496,W,99,78,21
18992,888,9496,L,78,99,-21
18993,435,9497,L,83,87,-4
18994,436,9497,W,87,83,4
18995,837,9498,L,82,87,-5
18996,838,9498,W,87,82,5
18997,363,9499,W,98,71,27
18998,364,9499,L,71,98,-27
18999,116,9500,L,96,97,-1
19000,115,9500,W,97,96,1
19001,41,9501,W,83,81,2
19002,42,9501,L,81,83,-2
19003,375,9502,L,101,104,-3
19004,376,9502,W,104,101,3
19005,296,9503,W,87,77,10
19006,295,9503,L,77,87,-10
19007,790,9504,L,101,117,-16
19008,789,9504,W,117,101,16
19009,446,9505,L,96,107,-11
19010,445,9505,W,107,96,11
19011,218,9506,L,105,122,-17
19012,217,9506,W,122,105,17
19013,31,9507,W,120,113,7
19014,32,9507,L,113,120,-7
19015,143,9508,W,109,101,8
19016,144,9508,L,101,109,-8
19017,823,9509,L,108,109,-1
19018,824,9509,W,109,108,1
19019,343,9510,L,118,125,-7
19020,344,9510,W,125,118,7
19021,892,9511,L,105,122,-17
19022,891,9511,W,122,105,17
19023,29,9512,W,102,97,5
19024,30,9512,L,97,102,-5
19025,694,9513,L,88,104,-16
19026,693,9513,W,104,88,16
19027,961,9514,W,105,102,3
19028,962,9514,L,102,105,-3
19029,432,9515,W,97,81,16
19030,431,9515,L,81,97,-16
19031,147,9516,W,108,104,4
19032,148,9516,L,104,108,-4
19033,260,9517,L,103,136,-33
19034,259,9517,W,136,103,33
19035,76,9518,L,92,97,-5
19036,75,9518,W,97,92,5
19037,665,9519,W,99,93,6
19038,666,9519,L,93,99,-6
19039,106,9520,L,87,90,-3
19040,105,9520,W,90,87,3
19041,758,9521,L,98,99,-1
19042,757,9521,W,99,98,1
19043,731,9522,L,75,114,-39
19044,732,9522,W,114,75,39
19045,282,9523,W,108,82,26
19046,281,9523,L,82,108,-26
19047,925,9524,L,83,119,-36
19048,926,9524,W,119,83,36
19049,680,9525,L,94,109,-15
19050,679,9525,W,109,94,15
19051,185,9526,L,114,122,-8
19052,186,9526,W,122,114,8
19053,324,9527,L,97,104,-7
19054,323,9527,W,104,97,7
19055,298,9528,L,85,96,-11
19056,297,9528,W,96,85,11
19057,240,9529,L,103,105,-2
19058,239,9529,W,105,103,2
19059,710,9530,W,98,90,8
19060,709,9530,L,90,98,-8
19061,314,9531,W,118,110,8
19062,313,9531,L,110,118,-8
19063,927,9532,L,68,98,-30
19064,928,9532,W,98,68,30
19065,517,9533,W,105,89,16
19066,518,9533,L,89,105,-16
19067,261,9534,L,102,130,-28
19068,262,9534,W,130,102,28
19069,754,9535,L,91,98,-7
19070,753,9535,W,98,91,7
19071,453,9536,W,93,81,12
19072,454,9536,L,81,93,-12
19073,650,9537,L,87,92,-5
19074,649,9537,W,92,87,5
19075,567,9538,L,86,94,-8
19076,568,9538,W,94,86,8
19077,963,9539,L,95,100,-5
19078,964,9539,W,100,95,5
19079,279,9540,W,96,88,8
19080,280,9540,L,88,96,-8
19081,781,9541,W,99,91,8
19082,782,9541,L,91,99,-8
19083,63,9542,L,94,116,-22
19084,64,9542,W,116,94,22
19085,514,9543,L,82,93,-11
19086,513,9543,W,93,82,11
19087,245,9544,W,125,101,24
19088,246,9544,L,101,125,-24
19089,744,9545,W,102,91,11
19090,743,9545,L,91,102,-11
19091,601,9546,W,105,101,4
19092,602,9546,L,101,105,-4
19093,617,9547,W,96,95,1
19094,618,9547,L,95,96,-1
19095,965,9548,L,74,119,-45
19096,966,9548,W,119,74,45
19097,571,9549,L,92,103,-11
19098,572,9549,W,103,92,11
19099,210,9550,W,111,109,2
19100,209,9550,L,109,111,-2
19101,334,9551,L,84,90,-6
19102,333,9551,W,90,84,6
19103,772,9552,L,105,109,-4
19104,771,9552,W,109,105,4
19105,241,9553,W,110,107,3
19106,242,9553,L,107,110,-3
19107,596,9554,L,97,108,-11
19108,595,9554,W,108,97,11
19109,4,9555,W,98,84,14
19110,3,9555,L,84,98,-14
19111,922,9556,L,84,106,-22
19112,921,9556,W,106,84,22
19113,958,9557,W,101,97,4
19114,957,9557,L,97,101,-4
19115,273,9558,W,101,98,3
19116,274,9558,L,98,101,-3
19117,528,9559,L,129,141,-12
19118,527,9559,W,141,129,12
19119,197,9560,W,95,90,5
19120,198,9560,L,90,95,-5
19121,779,9561,L,83,84,-1
19122,780,9561,W,84,83,1
19123,336,9562,W,110,107,3
19124,335,9562,L,107,110,-3
19125,637,9563,W,90,84,6
19126,638,9563,L,84,90,-6
19127,128,9564,L,108,119,-11
19128,127,9564,W,119,108,11
19129,44,9565,W,114,103,11
19130,43,9565,L,103,114,-11
19131,934,9566,L,95,110,-15
19132,933,9566,W,110,95,15
19133,442,9567,L,72,102,-30
19134,441,9567,W,102,72,30
19135,248,9568,L,86,92,-6
19136,247,9568,W,92,86,6
19137,713,9569,W,100,99,1
19138,714,9569,L,99,100,-1
19139,83,9570,L,93,99,-6
19140,84,9570,W,99,93,6
19141,47,9571,W,76,72,4
19142,48,9571,L,72,76,-4
19143,602,9572,W,97,87,10
19144,601,9572,L,87,97,-10
19145,448,9573,L,105,109,-4
19146,447,9573,W,109,105,4
19147,94,9574,W,103,99,4
19148,93,9574,L,99,103,-4
19149,791,9575,W,90,72,18
19150,792,9575,L,72,90,-18
19151,558,9576,W,114,90,24
19152,557,9576,L,90,114,-24
19153,855,9577,L,103,105,-2
19154,856,9577,W,105,103,2
19155,736,9578,W,103,102,1
19156,735,9578,L,102,103,-1
19157,729,9579,L,94,107,-13
19158,730,9579,W,107,94,13
19159,796,9580,W,118,94,24
19160,795,9580,L,94,118,-24
19161,897,9581,W,113,99,14
19162,898,9581,L,99,113,-14
19163,930,9582,W,104,100,4
19164,929,9582,L,100,104,-4
19165,873,9583,W,105,75,30
19166,874,9583,L,75,105,-30
19167,705,9584,L,113,119,-6
19168,706,9584,W,119,113,6
19169,792,9585,L,82,114,-32
19170,791,9585,W,114,82,32
19171,722,9586,L,101,107,-6
19172,721,9586,W,107,101,6
19173,45,9587,L,107,111,-4
19174,46,9587,W,111,107,4
19175,281,9588,L,82,88,-6
19176,282,9588,W,88,82,6
19177,594,9589,L,111,127,-16
19178,593,9589,W,127,111,16
19179,13,9590,L,98,100,-2
19180,14,9590,W,100,98,2
19181,626,9591,W,113,88,25
19182,625,9591,L,88,113,-25
19183,734,9592,W,106,96,10
19184,733,9592,L,96,106,-10
19185,849,9593,L,108,122,-14
19186,850,9593,W,122,108,14
19187,788,9594,W,86,67,19
19188,787,9594,L,67,86,-19
19189,547,9595,W,116,90,26
19190,548,9595,L,90,116,-26
19191,189,9596,W,88,82,6
19192,190,9596,L,82,88,-6
19193,944,9597,L,100,105,-5
19194,943,9597,W,105,100,5
19195,479,9598,W,103,90,13
19196,480,9598,L,90,103,-13
19197,107,9599,L,91,125,-34
19198,108,9599,W,125,91,34
19199,455,9600,L,99,113,-14
19200,456,9600,W,113,99,14
19201,909,9601,W,105,99,6
19202,910,9601,L,99,105,-6
19203,133,9602,L,119,122,-3
19204,134,9602,W,122,119,3
19205,227,9603,W,97,94,3
19206,228,9603,L,94,97,-3
19207,402,9604,L,98,108,-10
19208,401,9604,W,108,98,10
19209,854,9605,L,87,94,-7
19210,853,9605,W,94,87,7
19211,474,9606,L,96,111,-15
19212,473,9606,W,111,96,15
19213,608,9607,L,101,115,-14
19214,607,9607,W,115,101,14
19215,886,9608,W,105,92,13
19216,885,9608,L,92,105,-13
19217,794,9609,L,90,97,-7
19218,793,9609,W,97,90,7
19219,638,9610,W,96,88,8
19220,637,9610,L,88,96,-8
19221,262,9611,W,108,102,6
19222,261,9611,L,102,108,-6
19223,283,9612,W,102,98,4
19224,284,9612,L,98,102,-4
19225,550,9613,W,105,91,14
19226,549,9613,L,91,105,-14
19227,228,9614,L,111,113,-2
19228,227,9614,W,113,111,2
19229,967,9615,W,96,87,9
19230,968,9615,L,87,96,-9
19231,167,9616,W,110,100,10
19232,168,9616,L,100,110,-10
19233,119,9617,W,125,101,24
19234,120,9617,L,101,125,-24
19235,428,9618,W,108,76,32
19236,427,9618,L,76,108,-32
19237,902,9619,L,77,101,-24
19238,901,9619,W,101,77,24
19239,465,9620,L,92,94,-2
19240,466,9620,W,94,92,2
19241,14,9621,W,92,88,4
19242,13,9621,L,88,92,-4
19243,80,9622,W,97,93,4
19244,79,9622,L,93,97,-4
19245,222,9623,L,100,123,-23
19246,221,9623,W,123,100,23
19247,301,9624,W,96,95,1
19248,302,9624,L,95,96,-1
19249,653,9625,L,69,71,-2
19250,654,9625,W,71,69,2
19251,346,9626,L,96,106,-10
19252,345,9626,W,106,96,10
19253,959,9627,L,63,99,-36
19254,960,9627,W,99,63,36
19255,785,9628,L,108,119,-11
19256,786,9628,W,119,108,11
19257,618,9629,L,85,96,-11
19258,617,9629,W,96,85,11
19259,512,9630,L,104,117,-13
19260,511,9630,W,117,104,13
19261,407,9631,L,101,108,-7
19262,408,9631,W,108,101,7
19263,149,9632,L,108,109,-1
19264,150,9632,W,109,108,1
19265,52,9633,L,94,109,-15
19266,51,9633,W,109,94,15
19267,483,9634,W,116,107,9
19268,484,9634,L,107,116,-9
19269,503,9635,L,85,91,-6
19270,504,9635,W,91,85,6
19271,501,9636,W,89,84,5
19272,502,9636,L,84,89,-5
19273,699,9637,W,100,92,8
19274,700,9637,L,92,100,-8
19275,464,9638,W,105,101,4
19276,463,9638,L,101,105,-4
19277,964,9639,W,105,86,19
19278,963,9639,L,86,105,-19
19279,583,9640,W,103,89,14
19280,584,9640,L,89,103,-14
19281,392,9641,W,107,90,17
19282,391,9641,L,90,107,-17
19283,880,9642,L,91,94,-3
19284,879,9642,W,94,91,3
19285,176,9643,W,102,90,12
19286,175,9643,L,90,102,-12
19287,8,9644,L,111,117,-6
19288,7,9644,W,117,111,6
19289,327,9645,W,111,86,25
19290,328,9645,L,86,111,-25
19291,793,9646,L,114,118,-4
19292,794,9646,W,118,114,4
19293,685,9647,L,88,105,-17
19294,686,9647,W,105,88,17
19295,698,9648,W,102,88,14
19296,697,9648,L,88,102,-14
19297,969,9649,L,89,102,-13
19298,970,9649,W,102,89,13
19299,373,9650,L,104,110,-6
19300,374,9650,W,110,104,6
19301,181,9651,W,97,69,28
19302,182,9651,L,69,97,-28
19303,123,9652,L,97,107,-10
19304,124,9652,W,107,97,10
19305,628,9653,L,109,120,-11
19306,627,9653,W,120,109,11
19307,319,9654,W,111,103,8
19308,320,9654,L,103,111,-8
19309,652,9655,L,91,116,-25
19310,651,9655,W,116,91,25
19311,486,9656,W,105,100,5
19312,485,9656,L,100,105,-5
19313,878,9657,L,76,87,-11
19314,877,9657,W,87,76,11
19315,732,9658,L,109,119,-10
19316,731,9658,W,119,109,10
19317,244,9659,L,74,89,-15
19318,243,9659,W,89,74,15
19319,918,9660,W,100,93,7
19320,917,9660,L,93,100,-7
19321,663,9661,L,93,99,-6
19322,664,9661,W,99,93,6
19323,867,9662,W,100,94,6
19324,868,9662,L,94,100,-6
19325,712,9663,W,93,89,4
19326,711,9663,L,89,93,-4
19327,542,9664,L,89,111,-22
19328,541,9664,W,111,89,22
19329,74,9665,L,103,118,-15
19330,73,9665,W,118,103,15
19331,971,9666,W,111,100,11
19332,972,9666,L,100,111,-11
19333,454,9667,W,100,98,2
19334,453,9667,L,98,100,-2
19335,182,9668,L,96,127,-31
19336,181,9668,W,127,96,31
19337,795,9669,L,108,119,-11
19338,796,9669,W,119,108,11
19339,869,9670,L,96,128,-32
19340,870,9670,W,128,96,32
19341,456,9671,L,95,116,-21
19342,455,9671,W,116,95,21
19343,883,9672,L,95,122,-27
19344,884,9672,W,122,95,27
19345,589,9673,W,86,76,10
19346,590,9673,L,76,86,-10
19347,250,9674,W,88,69,19
19348,249,9674,L,69,88,-19
19349,824,9675,L,86,100,-14
19350,823,9675,W,100,86,14
19351,828,9676,L,98,119,-21
19352,827,9676,W,119,98,21
19353,173,9677,L,99,105,-6
19354,174,9677,W,105,99,6
19355,820,9678,L,108,114,-6
19356,819,9678,W,114,108,6
19357,576,9679,W,93,90,3
19358,575,9679,L,90,93,-3
19359,131,9680,W,99,95,4
19360,132,9680,L,95,99,-4
19361,78,9681,L,92,103,-11
19362,77,9681,W,103,92,11
19363,279,9682,L,96,106,-10
19364,280,9682,W,106,96,10
19365,818,9683,W,104,94,10
19366,817,9683,L,94,104,-10
19367,938,9684,L,84,93,-9
19368,937,9684,W,93,84,9
19369,708,9685,L,103,114,-11
19370,707,9685,W,114,103,11
19371,585,9686,W,96,90,6
19372,586,9686,L,90,96,-6
19373,484,9687,L,109,140,-31
19374,483,9687,W,140,109,31
19375,289,9688,L,104,112,-8
19376,290,9688,W,112,104,8
19377,286,9689,W,92,83,9
19378,285,9689,L,83,92,-9
19379,872,9690,L,94,99,-5
19380,871,9690,W,99,94,5
19381,679,9691,W,100,98,2
19382,680,9691,L,98,100,-2
19383,581,9692,L,91,112,-21
19384,582,9692,W,112,91,21
19385,4,9693,L,61,78,-17
19386,3,9693,W,78,61,17
19387,627,9694,L,91,98,-7
19388,628,9694,W,98,91,7
19389,783,9695,L,90,98,-8
19390,784,9695,W,98,90,8
19391,295,9696,L,85,99,-14
19392,296,9696,W,99,85,14
19393,76,9697,L,101,111,-10
19394,75,9697,W,111,101,10
19395,702,9698,W,98,97,1
19396,701,9698,L,97,98,-1
19397,232,9699,W,100,85,15
19398,231,9699,L,85,100,-15
19399,489,9700,L,104,106,-2
19400,490,9700,W,106,104,2
19401,540,9701,L,110,115,-5
19402,539,9701,W,115,110,5
19403,102,9702,W,93,76,17
19404,101,9702,L,76,93,-17
19405,953,9703,L,86,115,-29
19406,954,9703,W,115,86,29
19407,766,9704,L,81,120,-39
19408,765,9704,W,120,81,39
19409,890,9705,L,95,109,-14
19410,889,9705,W,109,95,14
19411,97,9706,L,99,105,-6
19412,98,9706,W,105,99,6
19413,137,9707,L,98,107,-9
19414,138,9707,W,107,98,9
19415,836,9708,L,86,96,-10
19416,835,9708,W,96,86,10
19417,402,9709,L,93,113,-20
19418,401,9709,W,113,93,20
19419,117,9710,W,109,99,10
19420,118,9710,L,99,109,-10
19421,67,9711,L,86,96,-10
19422,68,9711,W,96,86,10
19423,775,9712,L,73,98,-25
19424,776,9712,W,98,73,25
19425,516,9713,L,76,85,-9
19426,515,9713,W,85,76,9
19427,64,9714,W,111,100,11
19428,63,9714,L,100,111,-11
19429,195,9715,L,84,97,-13
19430,196,9715,W,97,84,13
19431,71,9716,L,99,117,-18
19432,72,9716,W,117,99,18
19433,297,9717,L,89,93,-4
19434,298,9717,W,93,89,4
19435,342,9718,L,80,89,-9
19436,341,9718,W,89,80,9
19437,98,9719,L,77,86,-9
19438,97,9719,W,86,77,9
19439,140,9720,L,89,102,-13
19440,139,9720,W,102,89,13
19441,948,9721,L,98,113,-15
19442,947,9721,W,113,98,15
19443,208,9722,L,89,106,-17
19444,207,9722,W,106,89,17
19445,651,9723,L,97,100,-3
19446,652,9723,W,100,97,3
19447,49,9724,L,110,118,-8
19448,50,9724,W,118,110,8
19449,825,9725,L,81,99,-18
19450,826,9725,W,99,81,18
19451,504,9726,L,86,92,-6
19452,503,9726,W,92,86,6
19453,105,9727,L,84,92,-8
19454,106,9727,W,92,84,8
19455,535,9728,L,97,113,-16
19456,536,9728,W,113,97,16
19457,38,9729,W,96,90,6
19458,37,9729,L,90,96,-6
19459,792,9730,L,79,98,-19
19460,791,9730,W,98,79,19
19461,615,9731,W,104,88,16
19462,616,9731,L,88,104,-16
19463,939,9732,L,99,104,-5
19464,940,9732,W,104,99,5
19465,396,9733,W,105,85,20
19466,395,9733,L,85,105,-20
19467,905,9734,L,78,102,-24
19468,906,9734,W,102,78,24
19469,580,9735,L,92,93,-1
19470,579,9735,W,93,92,1
19471,174,9736,L,104,106,-2
19472,173,9736,W,106,104,2
19473,485,9737,W,117,90,27
19474,486,9737,L,90,117,-27
19475,935,9738,L,106,111,-5
19476,936,9738,W,111,106,5
19477,563,9739,W,108,95,13
19478,564,9739,L,95,108,-13
19479,621,9740,L,101,102,-1
19480,622,9740,W,102,101,1
19481,362,9741,W,96,94,2
19482,361,9741,L,94,96,-2
19483,531,9742,W,103,100,3
19484,532,9742,L,100,103,-3
19485,461,9743,W,125,80,45
19486,462,9743,L,80,125,-45
19487,874,9744,L,85,93,-8
19488,873,9744,W,93,85,8
19489,344,9745,W,114,102,12
19490,343,9745,L,102,114,-12
19491,180,9746,L,77,97,-20
19492,179,9746,W,97,77,20
19493,272,9747,L,104,106,-2
19494,271,9747,W,106,104,2
19495,950,9748,W,91,83,8
19496,949,9748,L,83,91,-8
19497,217,9749,L,96,105,-9
19498,218,9749,W,105,96,9
19499,491,9750,W,104,102,2
19500,492,9750,L,102,104,-2
19501,126,9751,L,98,100,-2
19502,125,9751,W,100,98,2
19503,17,9752,L,83,96,-13
19504,18,9752,W,96,83,13
19505,118,9753,L,95,110,-15
19506,117,9753,W,110,95,15
19507,9,9754,L,73,86,-13
19508,10,9754,W,86,73,13
19509,601,9755,L,99,108,-9
19510,602,9755,W,108,99,9
19511,18,9756,L,100,101,-1
19512,17,9756,W,101,100,1
19513,895,9757,L,101,102,-1
19514,896,9757,W,102,101,1
19515,84,9758,L,80,97,-17
19516,83,9758,W,97,80,17
19517,613,9759,L,110,114,-4
19518,614,9759,W,114,110,4
19519,733,9760,L,106,119,-13
19520,734,9760,W,119,106,13
19521,572,9761,W,99,98,1
19522,571,9761,L,98,99,-1
19523,95,9762,L,102,109,-7
19524,96,9762,W,109,102,7
19525,32,9763,L,93,121,-28
19526,31,9763,W,121,93,28
19527,973,9764,W,100,82,18
19528,974,9764,L,82,100,-18
19529,230,9765,L,84,102,-18
19530,229,9765,W,102,84,18
19531,278,9766,W,113,107,6
19532,277,9766,L,107,113,-6
19533,838,9767,L,101,114,-13
19534,837,9767,W,114,101,13
19535,841,9768,L,88,110,-22
19536,842,9768,W,110,88,22
19537,48,9769,L,77,101,-24
19538,47,9769,W,101,77,24
19539,524,9770,L,111,123,-12
19540,523,9770,W,123,111,12
19541,61,9771,L,87,103,-16
19542,62,9771,W,103,87,16
19543,764,9772,L,108,113,-5
19544,763,9772,W,113,108,5
19545,426,9773,W,105,95,10
19546,425,9773,L,95,105,-10
19547,213,9774,W,97,95,2
19548,214,9774,L,95,97,-2
19549,224,9775,L,88,93,-5
19550,223,9775,W,93,88,5
19551,812,9776,W,89,86,3
19552,811,9776,L,86,89,-3
19553,670,9777,L,82,85,-3
19554,669,9777,W,85,82,3
19555,53,9778,W,106,96,10
19556,54,9778,L,96,106,-10
19557,231,9779,L,116,123,-7
19558,232,9779,W,123,116,7
19559,403,9780,L,93,106,-13
19560,404,9780,W,106,93,13
19561,424,9781,L,80,100,-20
19562,423,9781,W,100,80,20
19563,975,9782,L,102,106,-4
19564,976,9782,W,106,102,4
19565,725,9783,W,91,83,8
19566,726,9783,L,83,91,-8
19567,876,9784,W,104,92,12
19568,875,9784,L,92,104,-12
19569,409,9785,L,88,92,-4
19570,410,9785,W,92,88,4
19571,827,9786,L,99,104,-5
19572,828,9786,W,104,99,5
19573,50,9787,W,105,95,10
19574,49,9787,L,95,105,-10
19575,465,9788,L,102,110,-8
19576,466,9788,W,110,102,8
19577,492,9789,L,90,105,-15
19578,491,9789,W,105,90,15
19579,147,9790,W,109,97,12
19580,148,9790,L,97,109,-12
19581,353,9791,L,90,95,-5
19582,354,9791,W,95,90,5
19583,851,9792,L,83,95,-12
19584,852,9792,W,95,83,12
19585,235,9793,W,90,85,5
19586,236,9793,L,85,90,-5
19587,591,9794,W,88,85,3
19588,592,9794,L,85,88,-3
19589,934,9795,L,105,114,-9
19590,933,9795,W,114,105,9
19591,809,9796,W,82,81,1
19592,810,9796,L,81,82,-1
19593,351,9797,W,98,95,3
19594,352,9797,L,95,98,-3
19595,275,9798,L,99,106,-7
19596,276,9798,W,106,99,7
19597,889,9799,W,100,94,6
19598,890,9799,L,94,100,-6
19599,544,9800,L,96,104,-8
19600,543,9800,W,104,96,8
19601,473,9801,W,111,105,6
19602,474,9801,L,105,111,-6
19603,240,9802,L,118,121,-3
19604,239,9802,W,121,118,3
19605,642,9803,L,88,103,-15
19606,641,9803,W,103,88,15
19607,251,9804,L,103,108,-5
19608,252,9804,W,108,103,5
19609,288,9805,L,79,92,-13
19610,287,9805,W,92,79,13
19611,799,9806,W,85,82,3
19612,800,9806,L,82,85,-3
19613,634,9807,W,98,93,5
19614,633,9807,L,93,98,-5
19615,942,9808,W,116,112,4
19616,941,9808,L,112,116,-4
19617,376,9809,L,98,109,-11
19618,375,9809,W,109,98,11
19619,671,9810,W,110,104,6
19620,672,9810,L,104,110,-6
19621,784,9811,L,87,94,-7
19622,783,9811,W,94,87,7
19623,926,9812,W,97,93,4
19624,925,9812,L,93,97,-4
19625,166,9813,L,95,105,-10
19626,165,9813,W,105,95,10
19627,582,9814,W,117,114,3
19628,581,9814,L,114,117,-3
19629,21,9815,L,89,94,-5
19630,22,9815,W,94,89,5
19631,653,9816,W,100,99,1
19632,654,9816,L,99,100,-1
19633,706,9817,W,112,108,4
19634,705,9817,L,108,112,-4
19635,886,9818,W,106,100,6
19636,885,9818,L,100,106,-6
19637,721,9819,L,88,95,-7
19638,722,9819,W,95,88,7
19639,39,9820,L,101,108,-7
19640,40,9820,W,108,101,7
19641,407,9821,L,69,85,-16
19642,408,9821,W,85,69,16
19643,309,9822,W,98,94,4
19644,310,9822,L,94,98,-4
19645,38,9823,W,90,77,13
19646,37,9823,L,77,90,-13
19647,296,9824,W,102,87,15
19648,295,9824,L,87,102,-15
19649,124,9825,W,99,90,9
19650,123,9825,L,90,99,-9
19651,559,9826,W,107,105,2
19652,560,9826,L,105,107,-2
19653,952,9827,W,90,78,12
19654,951,9827,L,78,90,-12
19655,239,9828,L,97,117,-20
19656,240,9828,W,117,97,20
19657,361,9829,L,94,95,-1
19658,362,9829,W,95,94,1
19659,110,9830,L,82,103,-21
19660,109,9830,W,103,82,21
19661,832,9831,W,93,88,5
19662,831,9831,L,88,93,-5
19663,259,9832,L,100,105,-5
19664,260,9832,W,105,100,5
19665,499,9833,W,92,75,17
19666,500,9833,L,75,92,-17
19667,22,9834,L,95,109,-14
19668,21,9834,W,109,95,14
19669,226,9835,L,86,97,-11
19670,225,9835,W,97,86,11
19671,901,9836,W,103,76,27
19672,902,9836,L,76,103,-27
19673,337,9837,L,88,104,-16
19674,338,9837,W,104,88,16
19675,209,9838,L,111,115,-4
19676,210,9838,W,115,111,4
19677,977,9839,W,111,99,12
19678,978,9839,L,99,111,-12
19679,345,9840,W,117,109,8
19680,346,9840,L,109,117,-8
19681,141,9841,L,106,113,-7
19682,142,9841,W,113,106,7
19683,497,9842,L,97,104,-7
19684,498,9842,W,104,97,7
19685,57,9843,L,91,120,-29
19686,58,9843,W,120,91,29
19687,181,9844,W,102,90,12
19688,182,9844,L,90,102,-12
19689,382,9845,L,98,113,-15
19690,381,9845,W,113,98,15
19691,879,9846,L,89,100,-11
19692,880,9846,W,100,89,11
19693,861,9847,L,118,124,-6
19694,862,9847,W,124,118,6
19695,444,9848,W,99,73,26
19696,443,9848,L,73,99,-26
19697,101,9849,L,58,97,-39
19698,102,9849,W,97,58,39
19699,186,9850,W,107,96,11
19700,185,9850,L,96,107,-11
19701,657,9851,L,93,113,-20
19702,658,9851,W,113,93,20
19703,502,9852,L,86,97,-11
19704,501,9852,W,97,86,11
19705,369,9853,L,105,116,-11
19706,370,9853,W,116,105,11
19707,979,9854,L,87,100,-13
19708,980,9854,W,100,87,13
19709,817,9855,L,88,106,-18
19710,818,9855,W,106,88,18
19711,630,9856,W,87,83,4
19712,629,9856,L,83,87,-4
19713,333,9857,L,83,104,-21
19714,334,9857,W,104,83,21
19715,590,9858,W,104,101,3
19716,589,9858,L,101,104,-3
19717,321,9859,W,90,87,3
19718,322,9859,L,87,90,-3
19719,325,9860,L,83,93,-10
19720,326,9860,W,93,83,10
19721,152,9861,L,100,107,-7
19722,151,9861,W,107,100,7
19723,527,9862,W,128,99,29
19724,528,9862,L,99,128,-29
19725,902,9863,L,88,96,-8
19726,901,9863,W,96,88,8
19727,467,9864,W,97,81,16
19728,468,9864,L,81,97,-16
19729,405,9865,L,91,103,-12
19730,406,9865,W,103,91,12
19731,954,9866,L,92,104,-12
19732,953,9866,W,104,92,12
19733,743,9867,L,95,103,-8
19734,744,9867,W,103,95,8
19735,924,9868,L,78,99,-21
19736,923,9868,W,99,78,21
19737,612,9869,L,97,103,-6
19738,611,9869,W,103,97,6
19739,486,9870,W,103,87,16
19740,485,9870,L,87,103,-16
19741,217,9871,W,116,101,15
19742,218,9871,L,101,116,-15
19743,399,9872,W,108,101,7
19744,400,9872,L,101,108,-7
19745,320,9873,L,91,98,-7
19746,319,9873,W,98,91,7
19747,109,9874,L,98,101,-3
19748,110,9874,W,101,98,3
19749,551,9875,L,79,99,-20
19750,552,9875,W,99,79,20
19751,221,9876,W,117,112,5
19752,222,9876,L,112,117,-5
19753,511,9877,L,90,92,-2
19754,512,9877,W,92,90,2
19755,107,9878,L,76,81,-5
19756,108,9878,W,81,76,5
19757,616,9879,W,104,96,8
19758,615,9879,L,96,104,-8
19759,40,9880,L,72,90,-18
19760,39,9880,W,90,72,18
19761,928,9881,W,112,102,10
19762,927,9881,L,102,112,-10
19763,973,9882,L,79,88,-9
19764,974,9882,W,88,79,9
19765,65,9883,L,93,99,-6
19766,66,9883,W,99,93,6
19767,625,9884,L,79,87,-8
19768,626,9884,W,87,79,8
19769,15,9885,L,105,108,-3
19770,16,9885,W,108,105,3
19771,594,9886,L,84,106,-22
19772,593,9886,W,106,84,22
19773,493,9887,L,83,99,-16
19774,494,9887,W,99,83,16
19775,747,9888,L,105,108,-3
19776,748,9888,W,108,105,3
19777,664,9889,W,94,87,7
19778,663,9889,L,87,94,-7
19779,481,9890,W,109,89,20
19780,482,9890,L,89,109,-20
19781,130,9891,L,112,125,-13
19782,129,9891,W,125,112,13
19783,310,9892,L,99,108,-9
19784,309,9892,W,108,99,9
19785,543,9893,L,103,108,-5
19786,544,9893,W,108,103,5
19787,140,9894,L,77,87,-10
19788,139,9894,W,87,77,10
19789,976,9895,L,88,95,-7
19790,975,9895,W,95,88,7
19791,273,9896,L,92,118,-26
19792,274,9896,W,118,92,26
19793,188,9897,L,99,101,-2
19794,187,9897,W,101,99,2
19795,811,9898,W,102,96,6
19796,812,9898,L,96,102,-6
19797,183,9899,L,94,100,-6
19798,184,9899,W,100,94,6
19799,408,9900,W,113,81,32
19800,407,9900,L,81,113,-32
19801,374,9901,L,119,125,-6
19802,373,9901,W,125,119,6
19803,586,9902,W,92,81,11
19804,585,9902,L,81,92,-11
19805,127,9903,W,112,105,7
19806,128,9903,L,105,112,-7
19807,910,9904,W,108,101,7
19808,909,9904,L,101,108,-7
19809,644,9905,W,104,92,12
19810,643,9905,L,92,104,-12
19811,308,9906,L,71,99,-28
19812,307,9906,W,99,71,28
19813,276,9907,L,89,115,-26
19814,275,9907,W,115,89,26
19815,236,9908,L,86,109,-23
19816,235,9908,W,109,86,23
19817,679,9909,W,102,97,5
19818,680,9909,L,97,102,-5
19819,536,9910,W,114,106,8
19820,535,9910,L,106,114,-8
19821,524,9911,W,89,81,8
19822,523,9911,L,81,89,-8
19823,773,9912,W,112,104,8
19824,774,9912,L,104,112,-8
19825,205,9913,L,93,113,-20
19826,206,9913,W,113,93,20
19827,135,9914,L,91,110,-19
19828,136,9914,W,110,91,19
19829,360,9915,L,80,95,-15
19830,359,9915,W,95,80,15
19831,929,9916,W,99,96,3
19832,930,9916,L,96,99,-3
19833,244,9917,W,115,113,2
19834,243,9917,L,113,115,-2
19835,42,9918,L,75,94,-19
19836,41,9918,W,94,75,19
19837,44,9919,L,84,85,-1
19838,43,9919,W,85,84,1
19839,242,9920,W,115,101,14
19840,241,9920,L,101,115,-14
19841,692,9921,L,85,109,-24
19842,691,9921,W,109,85,24
19843,2,9922,W,87,80,7
19844,1,9922,L,80,87,-7
19845,146,9923,W,86,84,2
19846,145,9923,L,84,86,-2
19847,884,9924,W,106,104,2
19848,883,9924,L,104,106,-2
19849,306,9925,W,105,96,9
19850,305,9925,L,96,105,-9
19851,120,9926,L,102,107,-5
19852,119,9926,W,107,102,5
19853,787,9927,W,96,89,7
19854,788,9927,L,89,96,-7
19855,829,9928,L,83,100,-17
19856,830,9928,W,100,83,17
19857,459,9929,W,101,97,4
19858,460,9929,L,97,101,-4
19859,275,9930,L,94,115,-21
19860,276,9930,W,115,94,21
19861,737,9931,W,96,94,2
19862,738,9931,L,94,96,-2
19863,238,9932,L,81,89,-8
19864,237,9932,W,89,81,8
19865,696,9933,W,117,110,7
19866,695,9933,L,110,117,-7
19867,172,9934,L,89,95,-6
19868,171,9934,W,95,89,6
19869,974,9935,L,92,104,-12
19870,973,9935,W,104,92,12
19871,79,9936,L,84,106,-22
19872,80,9936,W,106,84,22
19873,688,9937,W,110,93,17
19874,687,9937,L,93,110,-17
19875,417,9938,L,109,119,-10
19876,418,9938,W,119,109,10
19877,862,9939,W,97,94,3
19878,861,9939,L,94,97,-3
19879,23,9940,W,93,83,10
19880,24,9940,L,83,93,-10
19881,689,9941,L,79,102,-23
19882,690,9941,W,102,79,23
19883,972,9942,W,95,86,9
19884,971,9942,L,86,95,-9
19885,87,9943,L,78,92,-14
19886,88,9943,W,92,78,14
19887,719,9944,W,105,100,5
19888,720,9944,L,100,105,-5
19889,390,9945,L,97,103,-6
19890,389,9945,W,103,97,6
19891,367,9946,W,103,99,4
19892,368,9946,L,99,103,-4
19893,525,9947,W,103,94,9
19894,526,9947,L,94,103,-9
19895,182,9948,L,96,114,-18
19896,181,9948,W,114,96,18
19897,684,9949,L,104,123,-19
19898,683,9949,W,123,104,19
19899,328,9950,L,73,104,-31
19900,327,9950,W,104,73,31
19901,874,9951,W,91,81,10
19902,873,9951,L,81,91,-10
19903,810,9952,L,83,88,-5
19904,809,9952,W,88,83,5
19905,115,9953,W,112,110,2
19906,116,9953,L,110,112,-2
19907,826,9954,L,96,118,-22
19908,825,9954,W,118,96,22
19909,278,9955,W,111,86,25
19910,277,9955,L,86,111,-25
19911,485,9956,L,94,96,-2
19912,486,9956,W,96,94,2
19913,729,9957,L,96,107,-11
19914,730,9957,W,107,96,11
19915,191,9958,L,85,89,-4
19916,192,9958,W,89,85,4
19917,133,9959,W,124,94,30
19918,134,9959,L,94,124,-30
19919,780,9960,L,107,111,-4
19920,779,9960,W,111,107,4
19921,981,9961,W,98,95,3
19922,982,9961,L,95,98,-3
19923,213,9962,W,123,88,35
19924,214,9962,L,88,123,-35
19925,577,9963,L,72,81,-9
19926,578,9963,W,81,72,9
19927,26,9964,L,85,104,-19
19928,25,9964,W,104,85,19
19929,568,9965,L,83,101,-18
19930,567,9965,W,101,83,18
19931,10,9966,L,77,87,-10
19932,9,9966,W,87,77,10
19933,707,9967,L,100,109,-9
19934,708,9967,W,109,100,9
19935,822,9968,L,100,103,-3
19936,821,9968,W,103,100,3
19937,888,9969,L,81,97,-16
19938,887,9969,W,97,81,16
19939,267,9970,W,106,85,21
19940,268,9970,L,85,106,-21
19941,212,9971,L,91,97,-6
19942,211,9971,W,97,91,6
19943,169,9972,L,116,122,-6
19944,170,9972,W,122,116,6
19945,970,9973,W,104,97,7
19946,969,9973,L,97,104,-7
19947,45,9974,L,87,104,-17
19948,46,9974,W,104,87,17
19949,57,9975,L,97,105,-8
19950,58,9975,W,105,97,8
19951,765,9976,L,105,106,-1
19952,766,9976,W,106,105,1
19953,730,9977,W,116,114,2
19954,729,9977,L,114,116,-2
19955,493,9978,W,102,94,8
19956,494,9978,L,94,102,-8
19957,323,9979,L,89,96,-7
19958,324,9979,W,96,89,7
19959,842,9980,L,99,109,-10
19960,841,9980,W,109,99,10
19961,490,9981,L,77,106,-29
19962,489,9981,W,106,77,29
19963,581,9982,L,105,111,-6
19964,582,9982,W,111,105,6
19965,871,9983,W,105,92,13
19966,872,9983,L,92,105,-13
19967,315,9984,L,91,109,-18
19968,316,9984,W,109,91,18
19969,288,9985,W,87,84,3
19970,287,9985,L,84,87,-3
19971,81,9986,L,80,100,-20
19972,82,9986,W,100,80,20
19973,43,9987,L,119,126,-7
19974,44,9987,W,126,119,7
19975,962,9988,W,97,94,3
19976,961,9988,L,94,97,-3
19977,471,9989,W,87,84,3
19978,472,9989,L,84,87,-3
19979,640,9990,W,99,97,2
19980,639,9990,L,97,99,-2
19981,608,9991,W,94,83,11
19982,607,9991,L,83,94,-11
19983,128,9992,L,114,126,-12
19984,127,9992,W,126,114,12
19985,227,9993,L,93,108,-15
19986,228,9993,W,108,93,15
19987,532,9994,W,99,89,10
19988,531,9994,L,89,99,-10
19989,845,9995,W,120,97,23
19990,846,9995,L,97,120,-23
19991,92,9996,W,93,76,17
19992,91,9996,L,76,93,-17
19993,168,9997,L,97,103,-6
19994,167,9997,W,103,97,6
19995,610,9998,L,94,100,-6
19996,609,9998,W,100,94,6
19997,88,9999,L,100,112,-12
19998,87,9999,W,112,100,12
19999,482,10000,L,92,95,-3
20000,481,10000,W,95,92,3
20001,868,10001,L,91,94,-3
20002,867,10001,W,94,91,3
20003,277,10002,L,91,129,-38
20004,278,10002,W,129,91,38
20005,224,10003,W,103,77,26
20006,223,10003,L,77,103,-26
20007,703,10004,W,97,93,4
20008,704,10004,L,93,97,-4
20009,316,10005,L,96,108,-12
20010,315,10005,W,108,96,12
20011,433,10006,L,96,121,-25
20012,434,10006,W,121,96,25
20013,763,10007,W,94,82,12
20014,764,10007,L,82,94,-12
20015,898,10008,L,88,110,-22
20016,897,10008,W,110,88,22
20017,421,10009,W,118,115,3
20018,422,10009,L,115,118,-3
20019,983,10010,W,81,75,6
20020,984,10010,L,75,81,-6
20021,498,10011,L,89,105,-16
20022,497,10011,W,105,89,16
20023,102,10012,L,75,92,-17
20024,101,10012,W,92,75,17
20025,283,10013,L,93,96,-3
20026,284,10013,W,96,93,3
20027,617,10014,W,96,87,9
20028,618,10014,L,87,96,-9
20029,99,10015,W,99,94,5
20030,100,10015,L,94,99,-5
20031,618,10016,L,68,100,-32
20032,617,10016,W,100,68,32
20033,975,10017,L,94,99,-5
20034,976,10017,W,99,94,5
20035,334,10018,L,82,92,-10
20036,333,10018,W,92,82,10
20037,445,10019,L,80,99,-19
20038,446,10019,W,99,80,19
20039,913,10020,L,100,115,-15
20040,914,10020,W,115,100,15
20041,469,10021,L,85,97,-12
20042,470,10021,W,97,85,12
20043,12,10022,W,99,89,10
20044,11,10022,L,89,99,-10
20045,399,10023,W,110,106,4
20046,400,10023,L,106,110,-4
20047,214,10024,L,90,93,-3
20048,213,10024,W,93,90,3
20049,418,10025,W,110,95,15
20050,417,10025,L,95,110,-15
20051,210,10026,L,93,101,-8
20052,209,10026,W,101,93,8
20053,593,10027,L,93,99,-6
20054,594,10027,W,99,93,6
20055,932,10028,L,77,93,-16
20056,931,10028,W,93,77,16
20057,354,10029,L,91,103,-12
20058,353,10029,W,103,91,12
20059,58,10030,L,83,90,-7
20060,57,10030,W,90,83,7
20061,566,10031,L,91,97,-6
20062,565,10031,W,97,91,6
20063,591,10032,L,86,100,-14
20064,592,10032,W,100,86,14
20065,436,10033,L,127,131,-4
20066,435,10033,W,131,127,4
20067,614,10034,L,84,104,-20
20068,613,10034,W,104,84,20
20069,161,10035,L,80,90,-10
20070,162,10035,W,90,80,10
20071,151,10036,L,103,125,-22
20072,152,10036,W,125,103,22
20073,600,10037,W,100,92,8
20074,599,10037,L,92,100,-8
20075,915,10038,L,104,121,-17
20076,916,10038,W,121,104,17
20077,359,10039,L,93,98,-5
20078,360,10039,W,98,93,5
20079,220,10040,L,106,112,-6
20080,219,10040,W,112,106,6
20081,654,10041,L,89,100,-11
20082,653,10041,W,100,89,11
20083,917,10042,L,100,101,-1
20084,918,10042,W,101,100,1
20085,431,10043,L,92,103,-11
20086,432,10043,W,103,92,11
20087,941,10044,L,96,103,-7
20088,942,10044,W,103,96,7
20089,325,10045,W,100,95,5
20090,326,10045,L,95,100,-5
20091,667,10046,L,100,107,-7
20092,668,10046,W,107,100,7
20093,571,10047,W,113,99,14
20094,572,10047,L,99,113,-14
20095,647,10048,W,92,90,2
20096,648,10048,L,90,92,-2
20097,716,10049,W,88,76,12
20098,715,10049,L,76,88,-12
20099,800,10050,L,71,80,-9
20100,799,10050,W,80,71,9
20101,457,10051,L,93,107,-14
20102,458,10051,W,107,93,14
20103,332,10052,L,93,102,-9
20104,331,10052,W,102,93,9
20105,54,10053,L,90,101,-11
20106,53,10053,W,101,90,11
20107,371,10054,W,109,96,13
20108,372,10054,L,96,109,-13
20109,960,10055,L,94,95,-1
20110,959,10055,W,95,94,1
20111,31,10056,W,122,97,25
20112,32,10056,L,97,122,-25
20113,797,10057,L,96,103,-7
20114,798,10057,W,103,96,7
20115,368,10058,W,111,98,13
20116,367,10058,L,98,111,-13
20117,381,10059,L,106,114,-8
20118,382,10059,W,114,106,8
20119,215,10060,W,99,86,13
20120,216,10060,L,86,99,-13
20121,791,10061,W,88,77,11
20122,792,10061,L,77,88,-11
20123,807,10062,W,115,93,22
20124,808,10062,L,93,115,-22
20125,885,10063,W,107,98,9
20126,886,10063,L,98,107,-9
20127,789,10064,W,111,85,26
20128,790,10064,L,85,111,-26
20129,682,10065,L,88,103,-15
20130,681,10065,W,103,88,15
20131,308,10066,L,72,102,-30
20132,307,10066,W,102,72,30
20133,298,10067,L,82,83,-1
20134,297,10067,W,83,82,1
20135,30,10068,L,102,103,-1
20136,29,10068,W,103,102,1
20137,575,10069,L,105,107,-2
20138,576,10069,W,107,105,2
20139,425,10070,L,103,113,-10
20140,426,10070,W,113,103,10
20141,814,10071,W,102,96,6
20142,813,10071,L,96,102,-6
20143,578,10072,L,94,99,-5
20144,577,10072,W,99,94,5
20145,249,10073,L,85,95,-10
20146,250,10073,W,95,85,10
20147,624,10074,L,85,99,-14
20148,623,10074,W,99,85,14
20149,2,10075,L,84,99,-15
20150,1,10075,W,99,84,15
20151,739,10076,L,74,95,-21
20152,740,10076,W,95,74,21
20153,954,10077,W,113,102,11
20154,953,10077,L,102,113,-11
20155,406,10078,L,89,101,-12
20156,405,10078,W,101,89,12
20157,764,10079,W,90,86,4
20158,763,10079,L,86,90,-4
20159,875,10080,L,90,113,-23
20160,876,10080,W,113,90,23
20161,533,10081,L,90,98,-8
20162,534,10081,W,98,90,8
20163,609,10082,L,107,116,-9
20164,610,10082,W,116,107,9
20165,11,10083,L,81,96,-15
20166,12,10083,W,96,81,15
20167,428,10084,W,86,80,6
20168,427,10084,L,80,86,-6
20169,856,10085,L,93,99,-6
20170,855,10085,W,99,93,6
20171,586,10086,L,80,82,-2
20172,585,10086,W,82,80,2
20173,513,10087,W,96,89,7
20174,514,10087,L,89,96,-7
20175,921,10088,W,100,94,6
20176,922,10088,L,94,100,-6
20177,509,10089,L,85,98,-13
20178,510,10089,W,98,85,13
20179,157,10090,L,96,99,-3
20180,158,10090,W,99,96,3
20181,500,10091,W,97,95,2
20182,499,10091,L,95,97,-2
20183,142,10092,W,94,88,6
20184,141,10092,L,88,94,-6
20185,965,10093,L,88,92,-4
20186,966,10093,W,92,88,4
20187,460,10094,L,105,108,-3
20188,459,10094,W,108,105,3
20189,746,10095,L,115,117,-2
20190,745,10095,W,117,115,2
20191,440,10096,W,101,94,7
20192,439,10096,L,94,101,-7
20193,761,10097,W,94,89,5
20194,762,10097,L,89,94,-5
20195,658,10098,L,94,100,-6
20196,657,10098,W,100,94,6
20197,956,10099,W,77,70,7
20198,955,10099,L,70,77,-7
20199,592,10100,W,100,97,3
20200,591,10100,L,97,100,-3
20201,265,10101,L,97,104,-7
20202,266,10101,W,104,97,7
20203,690,10102,L,74,92,-18
20204,689,10102,W,92,74,18
20205,170,10103,W,134,126,8
20206,169,10103,L,126,134,-8
20207,480,10104,L,92,101,-9
20208,479,10104,W,101,92,9
20209,222,10105,L,96,119,-23
20210,221,10105,W,119,96,23
20211,914,10106,W,104,96,8
20212,913,10106,L,96,104,-8
20213,230,10107,W,117,110,7
20214,229,10107,L,110,117,-7
20215,228,10108,W,97,88,9
20216,227,10108,L,88,97,-9
20217,677,10109,W,98,90,8
20218,678,10109,L,90,98,-8
20219,776,10110,L,83,102,-19
20220,775,10110,W,102,83,19
20221,801,10111,L,93,104,-11
20222,802,10111,W,104,93,11
20223,756,10112,L,106,112,-6
20224,755,10112,W,112,106,6
20225,260,10113,W,116,109,7
20226,259,10113,L,109,116,-7
20227,72,10114,W,104,97,7
20228,71,10114,L,97,104,-7
20229,400,10115,L,85,93,-8
20230,399,10115,W,93,85,8
20231,386,10116,W,101,97,4
20232,385,10116,L,97,101,-4
20233,946,10117,L,90,106,-16
20234,945,10117,W,106,90,16
20235,315,10118,W,99,80,19
20236,316,10118,L,80,99,-19
20237,223,10119,L,99,117,-18
20238,224,10119,W,117,99,18
20239,144,10120,L,79,92,-13
20240,143,10120,W,92,79,13
20241,906,10121,W,132,102,30
20242,905,10121,L,102,132,-30
20243,77,10122,W,93,83,10
20244,78,10122,L,83,93,-10
20245,669,10123,W,108,104,4
20246,670,10123,L,104,108,-4
20247,143,10124,L,94,95,-1
20248,144,10124,W,95,94,1
20249,326,10125,L,95,104,-9
20250,325,10125,W,104,95,9
20251,246,10126,L,82,91,-9
20252,245,10126,W,91,82,9
20253,293,10127,L,99,131,-32
20254,294,10127,W,131,99,32
20255,700,10128,L,73,91,-18
20256,699,10128,W,91,73,18
20257,169,10129,L,92,114,-22
20258,170,10129,W,114,92,22
20259,218,10130,L,108,114,-6
20260,217,10130,W,114,108,6
20261,622,10131,W,92,89,3
20262,621,10131,L,89,92,-3
20263,121,10132,W,109,102,7
20264,122,10132,L,102,109,-7
20265,949,10133,W,96,89,7
20266,950,10133,L,89,96,-7
20267,893,10134,L,93,108,-15
20268,894,10134,W,108,93,15
20269,117,10135,W,97,94,3
20270,118,10135,L,94,97,-3
20271,666,10136,W,112,92,20
20272,665,10136,L,92,112,-20
20273,423,10137,L,92,99,-7
20274,424,10137,W,99,92,7
20275,695,10138,L,99,110,-11
20276,696,10138,W,110,99,11
20277,920,10139,W,100,98,2
20278,919,10139,L,98,100,-2
20279,936,10140,W,103,87,16
20280,935,10140,L,87,103,-16
20281,478,10141,L,94,104,-10
20282,477,10141,W,104,94,10
20283,305,10142,L,100,107,-7
20284,306,10142,W,107,100,7
20285,704,10143,L,81,87,-6
20286,703,10143,W,87,81,6
20287,33,10144,W,104,97,7
20288,34,10144,L,97,104,-7
20289,693,10145,L,104,108,-4
20290,694,10145,W,108,104,4
20291,274,10146,W,95,85,10
20292,273,10146,L,85,95,-10
20293,65,10147,L,90,112,-22
20294,66,10147,W,112,90,22
20295,130,10148,L,105,107,-2
20296,129,10148,W,107,105,2
20297,585,10149,L,98,108,-10
20298,586,10149,W,108,98,10
20299,75,10150,W,80,76,4
20300,76,10150,L,76,80,-4
20301,307,10151,L,101,105,-4
20302,308,10151,W,105,101,4
20303,853,10152,W,105,88,17
20304,854,10152,L,88,105,-17
20305,687,10153,W,117,111,6
20306,688,10153,L,111,117,-6
20307,150,10154,L,110,113,-3
20308,149,10154,W,113,110,3
20309,891,10155,W,118,112,6
20310,892,10155,L,112,118,-6
20311,985,10156,L,81,102,-21
20312,986,10156,W,102,81,21
20313,730,10157,W,105,104,1
20314,729,10157,L,104,105,-1
20315,623,10158,W,102,94,8
20316,624,10158,L,94,102,-8
20317,71,10159,L,79,89,-10
20318,72,10159,W,89,79,10
20319,639,10160,L,99,106,-7
20320,640,10160,W,106,99,7
20321,645,10161,W,113,103,10
20322,646,10161,L,103,113,-10
20323,831,10162,W,118,117,1
20324,832,10162,L,117,118,-1
20325,110,10163,L,95,99,-4
20326,109,10163,W,99,95,4
20327,966,10164,W,100,79,21
20328,965,10164,L,79,100,-21
20329,462,10165,L,116,124,-8
20330,461,10165,W,124,116,8
20331,595,10166,L,92,103,-11
20332,596,10166,W,103,92,11
20333,100,10167,L,88,91,-3
20334,99,10167,W,91,88,3
20335,770,10168,L,77,92,-15
20336,769,10168,W,92,77,15
20337,514,10169,L,88,93,-5
20338,513,10169,W,93,88,5
20339,395,10170,L,89,102,-13
20340,396,10170,W,102,89,13
20341,469,10171,L,81,116,-35
20342,470,10171,W,116,81,35
20343,364,10172,L,97,101,-4
20344,363,10172,W,101,97,4
20345,247,10173,L,78,96,-18
20346,248,10173,W,96,78,18
20347,280,10174,L,87,108,-21
20348,279,10174,W,108,87,21
20349,179,10175,W,98,86,12
20350,180,10175,L,86,98,-12
20351,718,10176,L,85,95,-10
20352,717,10176,W,95,85,10
20353,549,10177,L,78,90,-12
20354,550,10177,W,90,78,12
20355,494,10178,W,113,111,2
20356,493,10178,L,111,113,-2
20357,127,10179,L,103,122,-19
20358,128,10179,W,122,103,19
20359,877,10180,W,104,98,6
20360,878,10180,L,98,104,-6
20361,51,10181,L,94,106,-12
20362,52,10181,W,106,94,12
20363,742,10182,W,97,92,5
20364,741,10182,L,92,97,-5
20365,370,10183,L,105,106,-1
20366,369,10183,W,106,105,1
20367,620,10184,L,100,105,-5
20368,619,10184,W,105,100,5
20369,352,10185,L,82,84,-2
20370,351,10185,W,84,82,2
20371,37,10186,L,95,101,-6
20372,38,10186,W,101,95,6
20373,940,10187,W,96,84,12
20374,939,10187,L,84,96,-12
20375,68,10188,W,102,88,14
20376,67,10188,L,88,102,-14
20377,414,10189,L,77,117,-40
20378,413,10189,W,117,77,40
20379,91,10190,W,95,83,12
20380,92,10190,L,83,95,-12
20381,134,10191,L,98,120,-22
20382,133,10191,W,120,98,22
20383,394,10192,W,110,89,21
20384,393,10192,L,89,110,-21
20385,190,10193,L,82,103,-21
20386,189,10193,W,103,82,21
20387,379,10194,L,78,101,-23
20388,380,10194,W,101,78,23
20389,875,10195,L,91,94,-3
20390,876,10195,W,94,91,3
20391,668,10196,L,98,100,-2
20392,667,10196,W,100,98,2
20393,200,10197,W,79,77,2
20394,199,10197,L,77,79,-2
20395,553,10198,W,97,89,8
20396,554,10198,L,89,97,-8
20397,864,10199,W,91,78,13
20398,863,10199,L,78,91,-13
20399,798,10200,L,101,117,-16
20400,797,10200,W,117,101,16
20401,136,10201,L,103,105,-2
20402,135,10201,W,105,103,2
20403,903,10202,L,69,114,-45
20404,904,10202,W,114,69,45
20405,592,10203,L,89,96,-7
20406,591,10203,W,96,89,7
20407,932,10204,W,105,98,7
20408,931,10204,L,98,105,-7
20409,616,10205,W,93,92,1
20410,615,10205,L,92,93,-1
20411,631,10206,L,78,84,-6
20412,632,10206,W,84,78,6
20413,452,10207,L,101,108,-7
20414,451,10207,W,108,101,7
20415,835,10208,W,118,92,26
20416,836,10208,L,92,118,-26
20417,295,10209,L,100,121,-21
20418,296,10209,W,121,100,21
20419,163,10210,L,85,98,-13
20420,164,10210,W,98,85,13
20421,196,10211,W,116,110,6
20422,195,10211,L,110,116,-6
20423,948,10212,L,84,102,-18
20424,947,10212,W,102,84,18
20425,171,10213,L,101,104,-3
20426,172,10213,W,104,101,3
20427,82,10214,W,111,106,5
20428,81,10214,L,106,111,-5
20429,615,10215,W,93,86,7
20430,616,10215,L,86,93,-7
20431,628,10216,L,97,108,-11
20432,627,10216,W,108,97,11
20433,714,10217,L,85,96,-11
20434,713,10217,W,96,85,11
20435,691,10218,W,116,109,7
20436,692,10218,L,109,116,-7
20437,605,10219,L,93,104,-11
20438,606,10219,W,104,93,11
20439,94,10220,W,115,89,26
20440,93,10220,L,89,115,-26
20441,881,10221,W,108,106,2
20442,882,10221,L,106,108,-2
20443,448,10222,L,108,110,-2
20444,447,10222,W,110,108,2
20445,369,10223,L,91,102,-11
20446,370,10223,W,102,91,11
20447,937,10224,L,108,111,-3
20448,938,10224,W,111,108,3
20449,403,10225,L,98,106,-8
20450,404,10225,W,106,98,8
20451,299,10226,L,100,108,-8
20452,300,10226,W,108,100,8
20453,565,10227,L,90,91,-1
20454,566,10227,W,91,90,1
20455,378,10228,W,104,97,7
20456,377,10228,L,97,104,-7
20457,876,10229,W,101,91,10
20458,875,10229,L,91,101,-10
20459,194,10230,L,76,86,-10
20460,193,10230,W,86,76,10
20461,680,10231,L,95,103,-8
20462,679,10231,W,103,95,8
20463,627,10232,L,102,104,-2
20464,628,10232,W,104,102,2
20465,796,10233,L,104,108,-4
20466,795,10233,W,108,104,4
20467,372,10234,L,103,131,-28
20468,371,10234,W,131,103,28
20469,69,10235,L,83,92,-9
20470,70,10235,W,92,83,9
20471,984,10236,L,107,115,-8
20472,983,10236,W,115,107,8
20473,840,10237,L,111,114,-3
20474,839,10237,W,114,111,3
20475,160,10238,L,97,113,-16
20476,159,10238,W,113,97,16
20477,122,10239,L,93,102,-9
20478,121,10239,W,102,93,9
20479,491,10240,L,74,90,-16
20480,492,10240,W,90,74,16
20481,148,10241,L,111,117,-6
20482,147,10241,W,117,111,6
20483,923,10242,L,97,98,-1
20484,924,10242,W,98,97,1
20485,681,10243,W,112,100,12
20486,682,10243,L,100,112,-12
20487,846,10244,L,89,93,-4
20488,845,10244,W,93,89,4
20489,284,10245,L,87,114,-27
20490,283,10245,W,114,87,27
20491,460,10246,W,101,94,7
20492,459,10246,L,94,101,-7
20493,25,10247,L,106,113,-7
20494,26,10247,W,113,106,7
20495,326,10248,L,100,101,-1
20496,325,10248,W,101,100,1
20497,980,10249,W,102,80,22
20498,979,10249,L,80,102,-22
20499,39,10250,L,98,106,-8
20500,40,10250,W,106,98,8
20501,285,10251,L,90,95,-5
20502,286,10251,W,95,90,5
20503,548,10252,W,92,87,5
20504,547,10252,L,87,92,-5
20505,237,10253,W,96,89,7
20506,238,10253,L,89,96,-7
20507,461,10254,L,91,102,-11
20508,462,10254,W,102,91,11
20509,577,10255,W,97,92,5
20510,578,10255,L,92,97,-5
20511,894,10256,L,98,102,-4
20512,893,10256,W,102,98,4
20513,427,10257,L,72,81,-9
20514,428,10257,W,81,72,9
20515,652,10258,W,105,101,4
20516,651,10258,L,101,105,-4
20517,108,10259,L,76,88,-12
20518,107,10259,W,88,76,12
20519,815,10260,L,94,102,-8
20520,816,10260,W,102,94,8
20521,828,10261,L,109,119,-10
20522,827,10261,W,119,109,10
20523,206,10262,W,99,90,9
20524,205,10262,L,90,99,-9
20525,214,10263,L,86,97,-11
20526,213,10263,W,97,86,11
20527,70,10264,L,79,86,-7
20528,69,10264,W,86,79,7
20529,642,10265,L,83,103,-20
20530,641,10265,W,103,83,20
20531,129,10266,L,108,119,-11
20532,130,10266,W,119,108,11
20533,202,10267,W,97,88,9
20534,201,10267,L,88,97,-9
20535,132,10268,L,89,107,-18
20536,131,10268,W,107,89,18
20537,900,10269,W,94,87,7
20538,899,10269,L,87,94,-7
20539,762,10270,L,80,101,-21
20540,761,10270,W,101,80,21
20541,834,10271,W,103,95,8
20542,833,10271,L,95,103,-8
20543,219,10272,L,100,126,-26
20544,220,10272,W,126,100,26
20545,986,10273,L,113,117,-4
20546,985,10273,W,117,113,4
20547,410,10274,W,83,76,7
20548,409,10274,L,76,83,-7
20549,713,10275,W,106,98,8
20550,714,10275,L,98,106,-8
20551,73,10276,L,117,119,-2
20552,74,10276,W,119,117,2
20553,805,10277,L,93,99,-6
20554,806,10277,W,99,93,6
20555,850,10278,W,112,96,16
20556,849,10278,L,96,112,-16
20557,503,10279,L,102,114,-12
20558,504,10279,W,114,102,12
20559,966,10280,W,110,95,15
20560,965,10280,L,95,110,-15
20561,574,10281,L,95,105,-10
20562,573,10281,W,105,95,10
20563,312,10282,L,83,103,-20
20564,311,10282,W,103,83,20
20565,492,10283,W,110,106,4
20566,491,10283,L,106,110,-4
20567,255,10284,W,98,93,5
20568,256,10284,L,93,98,-5
20569,830,10285,W,104,100,4
20570,829,10285,L,100,104,-4
20571,92,10286,L,97,102,-5
20572,91,10286,W,102,97,5
20573,265,10287,W,94,76,18
20574,266,10287,L,76,94,-18
20575,335,10288,L,93,98,-5
20576,336,10288,W,98,93,5
20577,808,10289,L,88,92,-4
20578,807,10289,W,92,88,4
20579,974,10290,L,96,100,-4
20580,973,10290,W,100,96,4
20581,896,10291,W,89,87,2
20582,895,10291,L,87,89,-2
20583,359,10292,L,85,99,-14
20584,360,10292,W,99,85,14
20585,208,10293,W,107,97,10
20586,207,10293,L,97,107,-10
20587,468,10294,W,112,106,6
20588,467,10294,L,106,112,-6
20589,526,10295,L,101,107,-6
20590,525,10295,W,107,101,6
20591,541,10296,L,100,107,-7
20592,542,10296,W,107,100,7
20593,882,10297,L,76,92,-16
20594,881,10297,W,92,76,16
20595,16,10298,W,84,82,2
20596,15,10298,L,82,84,-2
20597,316,10299,W,103,86,17
20598,315,10299,L,86,103,-17
20599,536,10300,W,99,89,10
20600,535,10300,L,89,99,-10
20601,454,10301,W,74,72,2
20602,453,10301,L,72,74,-2
20603,822,10302,L,101,114,-13
20604,821,10302,W,114,101,13
20605,398,10303,W,95,87,8
20606,397,10303,L,87,95,-8
20607,382,10304,W,90,82,8
20608,381,10304,L,82,90,-8
20609,466,10305,W,105,96,9
20610,465,10305,L,96,105,-9
20611,819,10306,W,113,110,3
20612,820,10306,L,110,113,-3
20613,654,10307,W,101,95,6
20614,653,10307,L,95,101,-6
20615,294,10308,W,140,133,7
20616,293,10308,L,133,140,-7
20617,519,10309,L,100,110,-10
20618,520,10309,W,110,100,10
20619,355,10310,W,92,90,2
20620,356,10310,L,90,92,-2
20621,606,10311,L,76,89,-13
20622,605,10311,W,89,76,13
20623,180,10312,L,74,82,-8
20624,179,10312,W,82,74,8
20625,159,10313,L,90,103,-13
20626,160,10313,W,103,90,13
20627,753,10314,L,86,104,-18
20628,754,10314,W,104,86,18
20629,539,10315,L,91,106,-15
20630,540,10315,W,106,91,15
20631,759,10316,L,82,96,-14
20632,760,10316,W,96,82,14
20633,40,10317,W,93,83,10
20634,39,10317,L,83,93,-10
20635,350,10318,L,80,87,-7
20636,349,10318,W,87,80,7
20637,911,10319,L,97,101,-4
20638,912,10319,W,101,97,4
20639,1,10320,L,81,94,-13
20640,2,10320,W,94,81,13
20641,533,10321,W,112,109,3
20642,534,10321,L,109,112,-3
20643,100,10322,W,96,92,4
20644,99,10322,L,92,96,-4
20645,238,10323,L,85,89,-4
20646,237,10323,W,89,85,4
20647,370,10324,W,107,101,6
20648,369,10324,L,101,107,-6
20649,422,10325,L,77,101,-24
20650,421,10325,W,101,77,24
20651,434,10326,L,85,93,-8
20652,433,10326,W,93,85,8
20653,356,10327,L,94,105,-11
20654,355,10327,W,105,94,11
20655,135,10328,L,84,104,-20
20656,136,10328,W,104,84,20
20657,144,10329,W,106,100,6
20658,143,10329,L,100,106,-6
20659,863,10330,L,105,107,-2
20660,864,10330,W,107,105,2
20661,636,10331,L,94,96,-2
20662,635,10331,W,96,94,2
20663,982,10332,L,99,107,-8
20664,981,10332,W,107,99,8
20665,479,10333,W,95,89,6
20666,480,10333,L,89,95,-6
20667,175,10334,W,101,91,10
20668,176,10334,L,91,101,-10
20669,179,10335,W,107,68,39
20670,180,10335,L,68,107,-39
20671,262,10336,W,97,86,11
20672,261,10336,L,86,97,-11
20673,839,10337,L,94,104,-10
20674,840,10337,W,104,94,10
20675,441,10338,W,97,91,6
20676,442,10338,L,91,97,-6
20677,18,10339,W,103,90,13
20678,17,10339,L,90,103,-13
20679,740,10340,L,104,109,-5
20680,739,10340,W,109,104,5
20681,564,10341,L,96,106,-10
20682,563,10341,W,106,96,10
20683,389,10342,L,103,105,-2
20684,390,10342,W,105,103,2
20685,395,10343,L,73,103,-30
20686,396,10343,W,103,73,30
20687,916,10344,W,117,110,7
20688,915,10344,L,110,117,-7
20689,155,10345,L,94,100,-6
20690,156,10345,W,100,94,6
20691,162,10346,W,108,90,18
20692,161,10346,L,90,108,-18
20693,229,10347,L,86,95,-9
20694,230,10347,W,95,86,9
20695,50,10348,W,93,87,6
20696,49,10348,L,87,93,-6
20697,331,10349,L,75,90,-15
20698,332,10349,W,90,75,15
20699,707,10350,L,86,89,-3
20700,708,10350,W,89,86,3
20701,547,10351,L,84,106,-22
20702,548,10351,W,106,84,22
20703,978,10352,W,77,62,15
20704,977,10352,L,62,77,-15
20705,643,10353,L,88,108,-20
20706,644,10353,W,108,88,20
20707,439,10354,L,97,109,-12
20708,440,10354,W,109,97,12
20709,738,10355,L,93,99,-6
20710,737,10355,W,99,93,6
20711,518,10356,W,108,101,7
20712,517,10356,L,101,108,-7
20713,201,10357,L,99,124,-25
20714,202,10357,W,124,99,25
20715,726,10358,W,107,96,11
20716,725,10358,L,96,107,-11
20717,173,10359,L,91,114,-23
20718,174,10359,W,114,91,23
20719,377,10360,L,79,101,-22
20720,378,10360,W,101,79,22
20721,216,10361,L,94,103,-9
20722,215,10361,W,103,94,9
20723,436,10362,L,92,94,-2
20724,435,10362,W,94,92,2
20725,84,10363,W,110,88,22
20726,83,10363,L,88,110,-22
20727,678,10364,L,94,115,-21
20728,677,10364,W,115,94,21
20729,507,10365,L,86,105,-19
20730,508,10365,W,105,86,19
20731,83,10366,L,84,100,-16
20732,84,10366,W,100,84,16
20733,701,10367,L,79,108,-29
20734,702,10367,W,108,79,29
20735,599,10368,W,104,95,9
20736,600,10368,L,95,104,-9
20737,763,10369,L,102,105,-3
20738,764,10369,W,105,102,3
20739,741,10370,L,98,106,-8
20740,742,10370,W,106,98,8
20741,156,10371,W,89,86,3
20742,155,10371,L,86,89,-3
20743,968,10372,W,89,82,7
20744,967,10372,L,82,89,-7
20745,912,10373,L,99,126,-27
20746,911,10373,W,126,99,27
20747,74,10374,W,95,85,10
20748,73,10374,L,85,95,-10
20749,276,10375,W,114,110,4
20750,275,10375,L,110,114,-4
20751,141,10376,L,100,107,-7
20752,142,10376,W,107,100,7
20753,158,10377,L,100,110,-10
20754,157,10377,W,110,100,10
20755,256,10378,L,116,119,-3
20756,255,10378,W,119,116,3
20757,748,10379,L,89,102,-13
20758,747,10379,W,102,89,13
20759,274,10380,W,115,86,29
20760,273,10380,L,86,115,-29
20761,99,10381,W,99,88,11
20762,100,10381,L,88,99,-11
20763,901,10382,L,89,90,-1
20764,902,10382,W,90,89,1
20765,664,10383,W,104,94,10
20766,663,10383,L,94,104,-10
20767,629,10384,L,92,106,-14
20768,630,10384,W,106,92,14
20769,683,10385,W,109,102,7
20770,684,10385,L,102,109,-7
20771,554,10386,L,80,92,-12
20772,553,10386,W,92,80,12
20773,665,10387,L,84,104,-20
20774,666,10387,W,104,84,20
20775,413,10388,L,89,92,-3
20776,414,10388,W,92,89,3
20777,940,10389,L,86,88,-2
20778,939,10389,W,88,86,2
20779,119,10390,W,105,95,10
20780,120,10390,L,95,105,-10
20781,458,10391,L,84,86,-2
20782,457,10391,W,86,84,2
20783,183,10392,L,94,113,-19
20784,184,10392,W,113,94,19
20785,46,10393,L,106,116,-10
20786,45,10393,W,116,106,10
20787,597,10394,L,87,93,-6
20788,598,10394,W,93,87,6
20789,443,10395,L,92,101,-9
20790,444,10395,W,101,92,9
20791,401,10396,W,87,85,2
20792,402,10396,L,85,87,-2
20793,453,10397,W,90,88,2
20794,454,10397,L,88,90,-2
20795,760,10398,W,105,96,9
20796,759,10398,L,96,105,-9
20797,777,10399,L,75,84,-9
20798,778,10399,W,84,75,9
20799,976,10400,W,99,95,4
20800,975,10400,L,95,99,-4
20801,125,10401,L,107,120,-13
20802,126,10401,W,120,107,13
20803,472,10402,L,84,94,-10
20804,471,10402,W,94,84,10
20805,93,10403,W,99,91,8
20806,94,10403,L,91,99,-8
20807,168,10404,L,106,121,-15
20808,167,10404,W,121,106,15
20809,168,10405,L,98,104,-6
20810,167,10405,W,104,98,6
20811,168,10406,L,85,91,-6
20812,167,10406,W,91,85,6
20813,167,10407,W,100,96,4
20814,168,10407,L,96,100,-4
20815,167,10408,L,94,105,-11
20816,168,10408,W,105,94,11
20817,125,10409,L,88,101,-13
20818,126,10409,W,101,88,13
20819,126,10410,W,98,79,19
20820,125,10410,L,79,98,-19
20821,457,10411,L,99,107,-8
20822,458,10411,W,107,99,8
20823,125,10412,W,94,90,4
20824,126,10412,L,90,94,-4
20825,458,10413,W,108,103,5
20826,457,10413,L,103,108,-5
20827,126,10414,L,91,93,-2
20828,125,10414,W,93,91,2
20829,457,10415,L,103,109,-6
20830,458,10415,W,109,103,6
20831,126,10416,L,91,101,-10
20832,125,10416,W,101,91,10
20833,457,10417,L,82,102,-20
20834,458,10417,W,102,82,20
20835,125,10418,L,111,115,-4
20836,126,10418,W,115,111,4
20837,458,10419,L,111,120,-9
20838,457,10419,W,120,111,9
20839,125,10420,L,79,93,-14
20840,126,10420,W,93,79,14
20841,458,10421,L,98,101,-3
20842,457,10421,W,101,98,3
20843,144,10422,L,75,85,-10
20844,143,10422,W,85,75,10
20845,140,10423,W,105,93,12
20846,139,10423,L,93,105,-12
20847,143,10424,L,75,82,-7
20848,144,10424,W,82,75,7
20849,139,10425,L,83,115,-32
20850,140,10425,W,115,83,32
20851,144,10426,L,85,101,-16
20852,143,10426,W,101,85,16
20853,218,10427,L,90,106,-16
20854,217,10427,W,106,90,16
20855,140,10428,W,101,93,8
20856,139,10428,L,93,101,-8
20857,547,10429,W,102,99,3
20858,548,10429,L,99,102,-3
20859,217,10430,W,103,100,3
20860,218,10430,L,100,103,-3
20861,547,10431,W,96,86,10
20862,548,10431,L,86,96,-10
20863,143,10432,L,83,92,-9
20864,144,10432,W,92,83,9
20865,217,10433,L,96,99,-3
20866,218,10433,W,99,96,3
20867,140,10434,L,75,94,-19
20868,139,10434,W,94,75,19
20869,548,10435,L,88,105,-17
20870,547,10435,W,105,88,17
20871,218,10436,L,75,77,-2
20872,217,10436,W,77,75,2
20873,143,10437,W,107,91,16
20874,144,10437,L,91,107,-16
20875,548,10438,L,92,108,-16
20876,547,10438,W,108,92,16
20877,139,10439,W,78,75,3
20878,140,10439,L,75,78,-3
20879,144,10440,W,82,81,1
20880,143,10440,L,81,82,-1
20881,218,10441,L,90,119,-29
20882,217,10441,W,119,90,29
20883,444,10442,W,82,72,10
20884,443,10442,L,72,82,-10
20885,139,10443,L,86,95,-9
20886,140,10443,W,95,86,9
20887,127,10444,L,87,96,-9
20888,128,10444,W,96,87,9
20889,144,10445,L,91,92,-1
20890,143,10445,W,92,91,1
20891,443,10446,W,90,88,2
20892,444,10446,L,88,90,-2
20893,523,10447,L,80,83,-3
20894,524,10447,W,83,80,3
20895,513,10448,L,78,79,-1
20896,514,10448,W,79,78,1
20897,128,10449,L,96,113,-17
20898,127,10449,W,113,96,17
20899,444,10450,L,80,92,-12
20900,443,10450,W,92,80,12
20901,666,10451,L,94,106,-12
20902,665,10451,W,106,94,12
20903,524,10452,L,86,87,-1
20904,523,10452,W,87,86,1
20905,514,10453,L,69,77,-8
20906,513,10453,W,77,69,8
20907,225,10454,L,87,105,-18
20908,226,10454,W,105,87,18
20909,127,10455,W,102,99,3
20910,128,10455,L,99,102,-3
20911,157,10456,W,87,81,6
20912,158,10456,L,81,87,-6
20913,443,10457,L,97,101,-4
20914,444,10457,W,101,97,4
20915,128,10458,W,92,88,4
20916,127,10458,L,88,92,-4
20917,665,10459,L,87,89,-2
20918,666,10459,W,89,87,2
20919,523,10460,L,79,101,-22
20920,524,10460,W,101,79,22
20921,513,10461,L,82,89,-7
20922,514,10461,W,89,82,7
20923,157,10462,W,102,90,12
20924,158,10462,L,90,102,-12
20925,582,10463,W,103,97,6
20926,581,10463,L,97,103,-6
20927,226,10464,W,101,99,2
20928,225,10464,L,99,101,-2
20929,443,10465,L,86,87,-1
20930,444,10465,W,87,86,1
20931,513,10466,L,74,79,-5
20932,514,10466,W,79,74,5
20933,128,10467,L,84,99,-15
20934,127,10467,W,99,84,15
20935,523,10468,L,84,90,-6
20936,524,10468,W,90,84,6
20937,582,10469,W,95,79,16
20938,581,10469,L,79,95,-16
20939,665,10470,W,87,70,17
20940,666,10470,L,70,87,-17
20941,226,10471,W,97,74,23
20942,225,10471,L,74,97,-23
20943,444,10472,L,98,105,-7
20944,443,10472,W,105,98,7
20945,158,10473,L,83,114,-31
20946,157,10473,W,114,83,31
20947,514,10474,W,109,92,17
20948,513,10474,L,92,109,-17
20949,524,10475,W,87,80,7
20950,523,10475,L,80,87,-7
20951,127,10476,L,100,104,-4
20952,128,10476,W,104,100,4
20953,666,10477,L,94,104,-10
20954,665,10477,W,104,94,10
20955,225,10478,L,78,93,-15
20956,226,10478,W,93,78,15
20957,581,10479,L,99,102,-3
20958,582,10479,W,102,99,3
20959,158,10480,L,91,106,-15
20960,157,10480,W,106,91,15
20961,444,10481,W,99,98,1
20962,443,10481,L,98,99,-1
20963,524,10482,L,74,83,-9
20964,523,10482,W,83,74,9
20965,127,10483,L,88,103,-15
20966,128,10483,W,103,88,15
20967,225,10484,W,81,77,4
20968,226,10484,L,77,81,-4
20969,514,10485,L,91,103,-12
20970,513,10485,W,103,91,12
20971,581,10486,L,98,99,-1
20972,582,10486,W,99,98,1
20973,666,10487,L,67,100,-33
20974,665,10487,W,100,67,33
20975,266,10488,L,86,108,-22
20976,265,10488,W,108,86,22
20977,463,10489,L,89,106,-17
20978,464,10489,W,106,89,17
20979,722,10490,W,107,101,6
20980,721,10490,L,101,107,-6
20981,160,10491,L,96,113,-17
20982,159,10491,W,113,96,17
20983,460,10492,W,131,102,29
20984,459,10492,L,102,131,-29
20985,99,10493,L,74,87,-13
20986,100,10493,W,87,74,13
20987,920,10494,W,104,84,20
20988,919,10494,L,84,104,-20
20989,987,10495,L,67,98,-31
20990,988,10495,W,98,67,31
20991,307,10496,L,70,104,-34
20992,308,10496,W,104,70,34
20993,281,10497,L,76,88,-12
20994,282,10497,W,88,76,12
20995,974,10498,L,77,84,-7
20996,973,10498,W,84,77,7
20997,98,10499,L,94,96,-2
20998,97,10499,W,96,94,2
20999,273,10500,L,75,107,-32
21000,274,10500,W,107,75,32
21001,602,10501,W,110,106,4
21002,601,10501,L,106,110,-4
21003,886,10502,L,95,102,-7
21004,885,10502,W,102,95,7
21005,698,10503,L,93,99,-6
21006,697,10503,W,99,93,6
21007,76,10504,W,92,87,5
21008,75,10504,L,87,92,-5
21009,472,10505,W,96,85,11
21010,471,10505,L,85,96,-11
21011,239,10506,W,106,101,5
21012,240,10506,L,101,106,-5
21013,465,10507,W,90,85,5
21014,466,10507,L,85,90,-5
21015,941,10508,W,83,81,2
21016,942,10508,L,81,83,-2
21017,126,10509,L,66,78,-12
21018,125,10509,W,78,66,12
21019,425,10510,L,110,118,-8
21020,426,10510,W,118,110,8
21021,1,10511,L,88,100,-12
21022,2,10511,W,100,88,12
21023,605,10512,L,102,109,-7
21024,606,10512,W,109,102,7
21025,631,10513,L,101,109,-8
21026,632,10513,W,109,101,8
21027,185,10514,L,86,92,-6
21028,186,10514,W,92,86,6
21029,989,10515,W,105,87,18
21030,990,10515,L,87,105,-18
21031,534,10516,L,89,124,-35
21032,533,10516,W,124,89,35
21033,792,10517,L,97,103,-6
21034,791,10517,W,103,97,6
21035,881,10518,L,73,101,-28
21036,882,10518,W,101,73,28
21037,565,10519,L,73,76,-3
21038,566,10519,W,76,73,3
21039,217,10520,L,106,114,-8
21040,218,10520,W,114,106,8
21041,926,10521,W,114,88,26
21042,925,10521,L,88,114,-26
21043,932,10522,L,98,107,-9
21044,931,10522,W,107,98,9
21045,271,10523,W,113,112,1
21046,272,10523,L,112,113,-1
21047,713,10524,W,93,88,5
21048,714,10524,L,88,93,-5
21049,820,10525,L,88,97,-9
21050,819,10525,W,97,88,9
21051,747,10526,L,74,101,-27
21052,748,10526,W,101,74,27
21053,302,10527,L,98,114,-16
21054,301,10527,W,114,98,16
21055,146,10528,L,89,93,-4
21056,145,10528,W,93,89,4
21057,249,10529,W,109,106,3
21058,250,10529,L,106,109,-3
21059,704,10530,L,107,117,-10
21060,703,10530,W,117,107,10
21061,484,10531,L,96,99,-3
21062,483,10531,W,99,96,3
21063,379,10532,L,83,93,-10
21064,380,10532,W,93,83,10
21065,991,10533,L,95,106,-11
21066,992,10533,W,106,95,11
21067,308,10534,W,86,84,2
21068,307,10534,L,84,86,-2
21069,519,10535,W,118,107,11
21070,520,10535,L,107,118,-11
21071,652,10536,L,94,104,-10
21072,651,10536,W,104,94,10
21073,524,10537,L,92,97,-5
21074,523,10537,W,97,92,5
21075,29,10538,L,90,98,-8
21076,30,10538,W,98,90,8
21077,15,10539,L,97,121,-24
21078,16,10539,W,121,97,24
21079,900,10540,W,85,80,5
21080,899,10540,L,80,85,-5
21081,426,10541,W,103,92,11
21082,425,10541,L,92,103,-11
21083,787,10542,L,72,83,-11
21084,788,10542,W,83,72,11
21085,973,10543,L,99,105,-6
21086,974,10543,W,105,99,6
21087,112,10544,W,91,80,11
21088,111,10544,L,80,91,-11
21089,360,10545,L,109,118,-9
21090,359,10545,W,118,109,9
21091,224,10546,L,90,93,-3
21092,223,10546,W,93,90,3
21093,231,10547,L,72,96,-24
21094,232,10547,W,96,72,24
21095,69,10548,W,103,87,16
21096,70,10548,L,87,103,-16
21097,97,10549,W,112,91,21
21098,98,10549,L,91,112,-21
21099,181,10550,W,109,97,12
21100,182,10550,L,97,109,-12
21101,175,10551,L,112,121,-9
21102,176,10551,W,121,112,9
21103,950,10552,L,91,103,-12
21104,949,10552,W,103,91,12
21105,421,10553,W,99,87,12
21106,422,10553,L,87,99,-12
21107,259,10554,L,110,117,-7
21108,260,10554,W,117,110,7
21109,195,10555,L,98,102,-4
21110,196,10555,W,102,98,4
21111,87,10556,W,104,98,6
21112,88,10556,L,98,104,-6
21113,873,10557,W,100,68,32
21114,874,10557,L,68,100,-32
21115,262,10558,W,127,102,25
21116,261,10558,L,102,127,-25
21117,43,10559,L,84,116,-32
21118,44,10559,W,116,84,32
21119,993,10560,W,104,95,9
21120,994,10560,L,95,104,-9
21121,811,10561,L,110,118,-8
21122,812,10561,W,118,110,8
21123,16,10562,W,112,91,21
21124,15,10562,L,91,112,-21
21125,71,10563,L,77,116,-39
21126,72,10563,W,116,77,39
21127,686,10564,W,91,84,7
21128,685,10564,L,84,91,-7
21129,250,10565,W,102,97,5
21130,249,10565,L,97,102,-5
21131,635,10566,L,88,111,-23
21132,636,10566,W,111,88,23
21133,995,10567,W,101,98,3
21134,996,10567,L,98,101,-3
21135,10,10568,W,87,84,3
21136,9,10568,L,84,87,-3
21137,722,10569,W,120,99,21
21138,721,10569,L,99,120,-21
21139,147,10570,L,77,92,-15
21140,148,10570,W,92,77,15
21141,284,10571,L,107,125,-18
21142,283,10571,W,125,107,18
21143,183,10572,L,121,123,-2
21144,184,10572,W,123,121,2
21145,3,10573,L,100,113,-13
21146,4,10573,W,113,100,13
21147,50,10574,W,105,102,3
21148,49,10574,L,102,105,-3
21149,579,10575,W,109,87,22
21150,580,10575,L,87,109,-22
21151,981,10576,W,75,67,8
21152,982,10576,L,67,75,-8
21153,795,10577,W,100,84,16
21154,796,10577,L,84,100,-16
21155,669,10578,W,100,94,6
21156,670,10578,L,94,100,-6
21157,665,10579,W,93,85,8
21158,666,10579,L,85,93,-8
21159,93,10580,L,108,112,-4
21160,94,10580,W,112,108,4
21161,880,10581,W,94,82,12
21162,879,10581,L,82,94,-12
21163,580,10582,W,102,86,16
21164,579,10582,L,86,102,-16
21165,49,10583,L,86,101,-15
21166,50,10583,W,101,86,15
21167,949,10584,L,75,88,-13
21168,950,10584,W,88,75,13
21169,316,10585,L,103,104,-1
21170,315,10585,W,104,103,1
21171,471,10586,W,98,89,9
21172,472,10586,L,89,98,-9
21173,359,10587,W,105,99,6
21174,360,10587,L,99,105,-6
21175,276,10588,L,104,112,-8
21176,275,10588,W,112,104,8
21177,601,10589,L,91,105,-14
21178,602,10589,W,105,91,14
21179,593,10590,W,115,110,5
21180,594,10590,L,110,115,-5
21181,216,10591,L,98,103,-5
21182,215,10591,W,103,98,5
21183,997,10592,W,94,82,12
21184,998,10592,L,82,94,-12
21185,174,10593,W,97,94,3
21186,173,10593,L,94,97,-3
21187,425,10594,L,89,115,-26
21188,426,10594,W,115,89,26
21189,428,10595,W,109,81,28
21190,427,10595,L,81,109,-28
21191,530,10596,W,112,105,7
21192,529,10596,L,105,112,-7
21193,485,10597,W,113,97,16
21194,486,10597,L,97,113,-16
21195,131,10598,L,79,84,-5
21196,132,10598,W,84,79,5
21197,127,10599,L,97,103,-6
21198,128,10599,W,103,97,6
21199,872,10600,L,82,105,-23
21200,871,10600,W,105,82,23
21201,940,10601,L,85,96,-11
21202,939,10601,W,96,85,11
21203,990,10602,W,95,89,6
21204,989,10602,L,89,95,-6
21205,11,10603,L,83,102,-19
21206,12,10603,W,102,83,19
21207,280,10604,L,65,103,-38
21208,279,10604,W,103,65,38
21209,788,10605,L,86,96,-10
21210,787,10605,W,96,86,10
21211,38,10606,W,95,82,13
21212,37,10606,L,82,95,-13
21213,651,10607,W,112,103,9
21214,652,10607,L,103,112,-9
21215,110,10608,L,97,107,-10
21216,109,10608,W,107,97,10
21217,909,10609,W,109,85,24
21218,910,10609,L,85,109,-24
21219,15,10610,W,98,84,14
21220,16,10610,L,84,98,-14
21221,462,10611,W,103,91,12
21222,461,10611,L,91,103,-12
21223,611,10612,L,110,118,-8
21224,612,10612,W,118,110,8
21225,585,10613,L,93,104,-11
21226,586,10613,W,104,93,11
21227,523,10614,L,86,88,-2
21228,524,10614,W,88,86,2
21229,12,10615,W,104,98,6
21230,11,10615,L,98,104,-6
21231,68,10616,W,111,107,4
21232,67,10616,L,107,111,-4
21233,934,10617,L,96,105,-9
21234,933,10617,W,105,96,9
21235,40,10618,W,93,75,18
21236,39,10618,L,75,93,-18
21237,459,10619,L,107,113,-6
21238,460,10619,W,113,107,6
21239,148,10620,W,100,98,2
21240,147,10620,L,98,100,-2
21241,125,10621,W,115,107,8
21242,126,10621,L,107,115,-8
21243,400,10622,L,86,98,-12
21244,399,10622,W,98,86,12
21245,57,10623,L,85,93,-8
21246,58,10623,W,93,85,8
21247,989,10624,W,107,88,19
21248,990,10624,L,88,107,-19
21249,883,10625,L,90,103,-13
21250,884,10625,W,103,90,13
21251,222,10626,L,100,110,-10
21252,221,10626,W,110,100,10
21253,369,10627,L,84,123,-39
21254,370,10627,W,123,84,39
21255,454,10628,L,98,103,-5
21256,453,10628,W,103,98,5
21257,491,10629,L,89,119,-30
21258,492,10629,W,119,89,30
21259,73,10630,W,94,89,5
21260,74,10630,L,89,94,-5
21261,780,10631,W,114,90,24
21262,779,10631,L,90,114,-24
21263,157,10632,L,84,91,-7
21264,158,10632,W,91,84,7
21265,936,10633,W,93,91,2
21266,935,10633,L,91,93,-2
21267,882,10634,W,113,85,28
21268,881,10634,L,85,113,-28
21269,444,10635,L,85,94,-9
21270,443,10635,W,94,85,9
21271,411,10636,W,109,89,20
21272,412,10636,L,89,109,-20
21273,841,10637,L,75,98,-23
21274,842,10637,W,98,75,23
21275,999,10638,L,117,122,-5
21276,1000,10638,W,122,117,5
21277,399,10639,L,99,100,-1
21278,400,10639,W,100,99,1
21279,8,10640,W,104,87,17
21280,7,10640,L,87,104,-17
21281,144,10641,L,79,103,-24
21282,143,10641,W,103,79,24
21283,158,10642,L,104,114,-10
21284,157,10642,W,114,104,10
21285,643,10643,L,75,91,-16
21286,644,10643,W,91,75,16
21287,334,10644,L,89,94,-5
21288,333,10644,W,94,89,5
21289,469,10645,L,94,109,-15
21290,470,10645,W,109,94,15
21291,672,10646,L,94,116,-22
21292,671,10646,W,116,94,22
21293,954,10647,L,90,99,-9
21294,953,10647,W,99,90,9
21295,876,10648,W,116,96,20
21296,875,10648,L,96,116,-20
21297,41,10649,W,86,72,14
21298,42,10649,L,72,86,-14
21299,4,10650,W,88,82,6
21300,3,10650,L,82,88,-6
21301,504,10651,L,105,125,-20
21302,503,10651,W,125,105,20
21303,370,10652,L,97,112,-15
21304,369,10652,W,112,97,15
21305,129,10653,W,112,107,5
21306,130,10653,L,107,112,-5
21307,173,10654,W,99,97,2
21308,174,10654,L,97,99,-2
21309,572,10655,W,84,80,4
21310,571,10655,L,80,84,-4
21311,520,10656,L,99,105,-6
21312,519,10656,W,105,99,6
21313,1001,10657,L,98,110,-12
21314,1002,10657,W,110,98,12
21315,754,10658,W,97,82,15
21316,753,10658,L,82,97,-15
21317,975,10659,L,103,128,-25
21318,976,10659,W,128,103,25
21319,608,10660,L,98,104,-6
21320,607,10660,W,104,98,6
21321,893,10661,L,90,95,-5
21322,894,10661,W,95,90,5
21323,43,10662,L,96,101,-5
21324,44,10662,W,101,96,5
21325,802,10663,L,98,103,-5
21326,801,10663,W,103,98,5
21327,618,10664,L,94,99,-5
21328,617,10664,W,99,94,5
21329,536,10665,W,96,80,16
21330,535,10665,L,80,96,-16
21331,654,10666,L,86,93,-7
21332,653,10666,W,93,86,7
21333,470,10667,W,93,85,8
21334,469,10667,L,85,93,-8
21335,947,10668,L,92,94,-2
21336,948,10668,W,94,92,2
21337,39,10669,W,99,78,21
21338,40,10669,L,78,99,-21
21339,120,10670,W,113,108,5
21340,119,10670,L,108,113,-5
21341,713,10671,W,97,94,3
21342,714,10671,L,94,97,-3
21343,681,10672,W,87,86,1
21344,682,10672,L,86,87,-1
21345,1003,10673,L,88,101,-13
21346,1004,10673,W,101,88,13
21347,875,10674,L,93,120,-27
21348,876,10674,W,120,93,27
21349,1,10675,W,107,105,2
21350,2,10675,L,105,107,-2
21351,333,10676,L,85,95,-10
21352,334,10676,W,95,85,10
21353,237,10677,W,109,96,13
21354,238,10677,L,96,109,-13
21355,168,10678,L,93,98,-5
21356,167,10678,W,98,93,5
21357,763,10679,L,98,107,-9
21358,764,10679,W,107,98,9
21359,107,10680,L,104,112,-8
21360,108,10680,W,112,104,8
21361,301,10681,W,125,90,35
21362,302,10681,L,90,125,-35
21363,53,10682,W,109,100,9
21364,54,10682,L,100,109,-9
21365,1005,10683,L,87,91,-4
21366,1006,10683,W,91,87,4
21367,663,10684,L,94,98,-4
21368,664,10684,W,98,94,4
21369,492,10685,L,95,102,-7
21370,491,10685,W,102,95,7
21371,557,10686,L,93,99,-6
21372,558,10686,W,99,93,6
21373,924,10687,L,87,92,-5
21374,923,10687,W,92,87,5
21375,175,10688,W,112,98,14
21376,176,10688,L,98,112,-14
21377,553,10689,L,108,116,-8
21378,554,10689,W,116,108,8
21379,845,10690,W,99,93,6
21380,846,10690,L,93,99,-6
21381,208,10691,W,94,88,6
21382,207,10691,L,88,94,-6
21383,66,10692,W,94,75,19
21384,65,10692,L,75,94,-19
21385,97,10693,W,102,97,5
21386,98,10693,L,97,102,-5
21387,937,10694,L,75,92,-17
21388,938,10694,W,92,75,17
21389,748,10695,W,104,101,3
21390,747,10695,L,101,104,-3
21391,165,10696,W,104,102,2
21392,166,10696,L,102,104,-2
21393,126,10697,L,72,91,-19
21394,125,10697,W,91,72,19
21395,637,10698,L,92,99,-7
21396,638,10698,W,99,92,7
21397,422,10699,L,112,120,-8
21398,421,10699,W,120,112,8
21399,680,10700,L,106,119,-13
21400,679,10700,W,119,106,13
21401,442,10701,L,78,92,-14
21402,441,10701,W,92,78,14
21403,377,10702,L,103,112,-9
21404,378,10702,W,112,103,9
21405,935,10703,L,85,88,-3
21406,936,10703,W,88,85,3
21407,162,10704,W,99,95,4
21408,161,10704,L,95,99,-4
21409,729,10705,L,96,105,-9
21410,730,10705,W,105,96,9
21411,910,10706,L,107,110,-3
21412,909,10706,W,110,107,3
21413,1007,10707,W,111,99,12
21414,1008,10707,L,99,111,-12
21415,445,10708,L,90,95,-5
21416,446,10708,W,95,90,5
21417,30,10709,L,75,91,-16
21418,29,10709,W,91,75,16
21419,433,10710,L,89,98,-9
21420,434,10710,W,98,89,9
21421,473,10711,W,100,98,2
21422,474,10711,L,98,100,-2
21423,106,10712,L,76,97,-21
21424,105,10712,W,97,76,21
21425,477,10713,W,100,79,21
21426,478,10713,L,79,100,-21
21427,897,10714,W,99,88,11
21428,898,10714,L,88,99,-11
21429,17,10715,L,97,98,-1
21430,18,10715,W,98,97,1
21431,627,10716,W,104,103,1
21432,628,10716,L,103,104,-1
21433,1009,10717,W,102,100,2
21434,1010,10717,L,100,102,-2
21435,271,10718,L,90,100,-10
21436,272,10718,W,100,90,10
21437,764,10719,W,121,84,37
21438,763,10719,L,84,121,-37
21439,232,10720,W,113,101,12
21440,231,10720,L,101,113,-12
21441,670,10721,L,71,83,-12
21442,669,10721,W,83,71,12
21443,238,10722,L,89,93,-4
21444,237,10722,W,93,89,4
21445,217,10723,W,102,93,9
21446,218,10723,L,93,102,-9
21447,960,10724,L,93,99,-6
21448,959,10724,W,99,93,6
21449,417,10725,L,85,106,-21
21450,418,10725,W,106,85,21
21451,335,10726,L,82,94,-12
21452,336,10726,W,94,82,12
21453,102,10727,W,98,77,21
21454,101,10727,L,77,98,-21
21455,895,10728,W,88,83,5
21456,896,10728,L,83,88,-5
21457,535,10729,L,86,108,-22
21458,536,10729,W,108,86,22
21459,72,10730,W,87,75,12
21460,71,10730,L,75,87,-12
21461,223,10731,L,86,103,-17
21462,224,10731,W,103,86,17
21463,1011,10732,L,84,100,-16
21464,1012,10732,W,100,84,16
21465,262,10733,W,117,112,5
21466,261,10733,L,112,117,-5
21467,941,10734,W,102,87,15
21468,942,10734,L,87,102,-15
21469,149,10735,L,96,105,-9
21470,150,10735,W,105,96,9
21471,602,10736,W,107,100,7
21472,601,10736,L,100,107,-7
21473,259,10737,L,81,90,-9
21474,260,10737,W,90,81,9
21475,70,10738,L,85,103,-18
21476,69,10738,W,103,85,18
21477,685,10739,L,86,93,-7
21478,686,10739,W,93,86,7
21479,630,10740,W,109,95,14
21480,629,10740,L,95,109,-14
21481,736,10741,L,101,108,-7
21482,735,10741,W,108,101,7
21483,421,10742,W,104,101,3
21484,422,10742,L,101,104,-3
21485,140,10743,L,90,105,-15
21486,139,10743,W,105,90,15
21487,1013,10744,W,105,84,21
21488,1014,10744,L,84,105,-21
21489,67,10745,L,80,89,-9
21490,68,10745,W,89,80,9
21491,7,10746,L,106,113,-7
21492,8,10746,W,113,106,7
21493,880,10747,W,102,95,7
21494,879,10747,L,95,102,-7
21495,870,10748,W,108,91,17
21496,869,10748,L,91,108,-17
21497,617,10749,W,79,77,2
21498,618,10749,L,77,79,-2
21499,214,10750,W,117,101,16
21500,213,10750,L,101,117,-16
21501,932,10751,L,85,97,-12
21502,931,10751,W,97,85,12
21503,404,10752,W,102,96,6
21504,403,10752,L,96,102,-6
21505,864,10753,W,108,83,25
21506,863,10753,L,83,108,-25
21507,611,10754,L,87,90,-3
21508,612,10754,W,90,87,3
21509,155,10755,L,76,88,-12
21510,156,10755,W,88,76,12
21511,743,10756,L,133,139,-6
21512,744,10756,W,139,133,6
21513,167,10757,L,87,103,-16
21514,168,10757,W,103,87,16
21515,236,10758,L,76,93,-17
21516,235,10758,W,93,76,17
21517,460,10759,L,100,117,-17
21518,459,10759,W,117,100,17
21519,560,10760,L,101,102,-1
21520,559,10760,W,102,101,1
21521,1015,10761,L,89,102,-13
21522,1016,10761,W,102,89,13
21523,435,10762,L,108,111,-3
21524,436,10762,W,111,108,3
21525,260,10763,W,101,99,2
21526,259,10763,L,99,101,-2
21527,443,10764,L,85,101,-16
21528,444,10764,W,101,85,16
21529,295,10765,L,79,101,-22
21530,296,10765,W,101,79,22
21531,325,10766,W,95,92,3
21532,326,10766,L,92,95,-3
21533,976,10767,W,89,86,3
21534,975,10767,L,86,89,-3
21535,359,10768,W,125,104,21
21536,360,10768,L,104,125,-21
21537,894,10769,W,112,92,20
21538,893,10769,L,92,112,-20
21539,1017,10770,L,84,93,-9
21540,1018,10770,W,93,84,9
21541,842,10771,W,88,73,15
21542,841,10771,L,73,88,-15
21543,136,10772,L,102,121,-19
21544,135,10772,W,121,102,19
21545,45,10773,L,96,103,-7
21546,46,10773,W,103,96,7
21547,594,10774,L,140,149,-9
21548,593,10774,W,149,140,9
21549,277,10775,L,87,104,-17
21550,278,10775,W,104,87,17
21551,143,10776,L,86,99,-13
21552,144,10776,W,99,86,13
21553,13,10777,L,79,96,-17
21554,14,10777,W,96,79,17
21555,212,10778,W,113,111,2
21556,211,10778,L,111,113,-2
21557,796,10779,L,80,93,-13
21558,795,10779,W,93,80,13
21559,484,10780,L,83,109,-26
21560,483,10780,W,109,83,26
21561,931,10781,L,90,97,-7
21562,932,10781,W,97,90,7
21563,237,10782,W,85,83,2
21564,238,10782,L,83,85,-2
21565,100,10783,W,100,91,9
21566,99,10783,L,91,100,-9
21567,145,10784,L,93,97,-4
21568,146,10784,W,97,93,4
21569,628,10785,W,103,102,1
21570,627,10785,L,102,103,-1
21571,817,10786,L,100,116,-16
21572,818,10786,W,116,100,16
21573,942,10787,W,101,92,9
21574,941,10787,L,92,101,-9
21575,494,10788,L,102,103,-1
21576,493,10788,W,103,102,1
21577,84,10789,W,82,79,3
21578,83,10789,L,79,82,-3
21579,94,10790,W,109,93,16
21580,93,10790,L,93,109,-16
21581,559,10791,W,94,82,12
21582,560,10791,L,82,94,-12
21583,439,10792,L,115,116,-1
21584,440,10792,W,116,115,1
21585,678,10793,L,93,103,-10
21586,677,10793,W,103,93,10
21587,1001,10794,W,108,89,19
21588,1002,10794,L,89,108,-19
21589,148,10795,L,91,114,-23
21590,147,10795,W,114,91,23
21591,671,10796,W,116,87,29
21592,672,10796,L,87,116,-29
21593,52,10797,L,90,97,-7
21594,51,10797,W,97,90,7
21595,408,10798,L,110,119,-9
21596,407,10798,W,119,110,9
21597,14,10799,L,87,106,-19
21598,13,10799,W,106,87,19
21599,201,10800,L,95,99,-4
21600,202,10800,W,99,95,4
21601,781,10801,L,89,102,-13
21602,782,10801,W,102,89,13
21603,130,10802,L,104,107,-3
21604,129,10802,W,107,104,3
21605,737,10803,W,85,59,26
21606,738,10803,L,59,85,-26
21607,714,10804,W,97,93,4
21608,713,10804,L,93,97,-4
21609,268,10805,W,112,95,17
21610,267,10805,L,95,112,-17
21611,524,10806,W,79,76,3
21612,523,10806,L,76,79,-3
21613,877,10807,W,105,80,25
21614,878,10807,L,80,105,-25
21615,999,10808,W,105,100,5
21616,1000,10808,L,100,105,-5
21617,230,10809,W,103,99,4
21618,229,10809,L,99,103,-4
21619,516,10810,L,92,97,-5
21620,515,10810,W,97,92,5
21621,116,10811,L,81,91,-10
21622,115,10811,W,91,81,10
21623,629,10812,L,95,111,-16
21624,630,10812,W,111,95,16
21625,715,10813,L,83,87,-4
21626,716,10813,W,87,83,4
21627,529,10814,L,86,99,-13
21628,530,10814,W,99,86,13
21629,493,10815,W,103,87,16
21630,494,10815,L,87,103,-16
21631,553,10816,L,99,115,-16
21632,554,10816,W,115,99,16
21633,794,10817,L,91,98,-7
21634,793,10817,W,98,91,7
21635,514,10818,L,80,89,-9
21636,513,10818,W,89,80,9
21637,1019,10819,W,102,94,8
21638,1020,10819,L,94,102,-8
21639,107,10820,W,102,88,14
21640,108,10820,L,88,102,-14
21641,346,10821,L,91,95,-4
21642,345,10821,W,95,91,4
21643,278,10822,L,99,106,-7
21644,277,10822,W,106,99,7
21645,608,10823,L,92,99,-7
21646,607,10823,W,99,92,7
21647,923,10824,L,103,107,-4
21648,924,10824,W,107,103,4
21649,108,10825,L,100,115,-15
21650,107,10825,W,115,100,15
21651,413,10826,L,101,109,-8
21652,414,10826,W,109,101,8
21653,816,10827,W,100,89,11
21654,815,10827,L,89,100,-11
21655,558,10828,W,84,78,6
21656,557,10828,L,78,84,-6
21657,457,10829,W,114,105,9
21658,458,10829,L,105,114,-9
21659,1021,10830,L,70,86,-16
21660,1022,10830,W,86,70,16
21661,96,10831,W,120,98,22
21662,95,10831,L,98,120,-22
21663,190,10832,W,114,110,4
21664,189,10832,L,110,114,-4
21665,63,10833,L,92,97,-5
21666,64,10833,W,97,92,5
21667,326,10834,L,88,102,-14
21668,325,10834,W,102,88,14
21669,826,10835,L,95,120,-25
21670,825,10835,W,120,95,25
21671,240,10836,W,103,90,13
21672,239,10836,L,90,103,-13
21673,79,10837,L,105,111,-6
21674,80,10837,W,111,105,6
21675,912,10838,L,96,101,-5
21676,911,10838,W,101,96,5
21677,956,10839,W,99,89,10
21678,955,10839,L,89,99,-10
21679,223,10840,W,91,87,4
21680,224,10840,L,87,91,-4
21681,936,10841,W,107,101,6
21682,935,10841,L,101,107,-6
21683,389,10842,W,124,112,12
21684,390,10842,L,112,124,-12
21685,606,10843,L,82,96,-14
21686,605,10843,W,96,82,14
21687,890,10844,L,87,107,-20
21688,889,10844,W,107,87,20
21689,788,10845,L,102,106,-4
21690,787,10845,W,106,102,4
21691,2,10846,L,111,120,-9
21692,1,10846,W,120,111,9
21693,568,10847,W,105,103,2
21694,567,10847,L,103,105,-2
21695,988,10848,L,84,98,-14
21696,987,10848,W,98,84,14
21697,719,10849,L,79,121,-42
21698,720,10849,W,121,79,42
21699,393,10850,L,111,122,-11
21700,394,10850,W,122,111,11
21701,249,10851,L,94,111,-17
21702,250,10851,W,111,94,17
21703,763,10852,L,105,115,-10
21704,764,10852,W,115,105,10
21705,423,10853,L,75,92,-17
21706,424,10853,W,92,75,17
21707,134,10854,W,104,103,1
21708,133,10854,L,103,104,-1
21709,403,10855,W,116,111,5
21710,404,10855,L,111,116,-5
21711,694,10856,L,117,118,-1
21712,693,10856,W,118,117,1
21713,115,10857,L,98,104,-6
21714,116,10857,W,104,98,6
21715,526,10858,L,98,107,-9
21716,525,10858,W,107,98,9
21717,436,10859,W,115,89,26
21718,435,10859,L,89,115,-26
21719,571,10860,W,96,88,8
21720,572,10860,L,88,96,-8
21721,992,10861,W,105,99,6
21722,991,10861,L,99,105,-6
21723,490,10862,W,94,85,9
21724,489,10862,L,85,94,-9
21725,982,10863,W,73,71,2
21726,981,10863,L,71,73,-2
21727,836,10864,L,97,112,-15
21728,835,10864,W,112,97,15
21729,400,10865,L,99,104,-5
21730,399,10865,W,104,99,5
21731,779,10866,W,127,124,3
21732,780,10866,L,124,127,-3
21733,322,10867,L,90,105,-15
21734,321,10867,W,105,90,15
21735,773,10868,L,107,118,-11
21736,774,10868,W,118,107,11
21737,83,10869,W,106,94,12
21738,84,10869,L,94,106,-12
21739,578,10870,W,94,91,3
21740,577,10870,L,91,94,-3
21741,455,10871,L,94,97,-3
21742,456,10871,W,97,94,3
21743,850,10872,W,106,99,7
21744,849,10872,L,99,106,-7
21745,186,10873,W,105,99,6
21746,185,10873,L,99,105,-6
21747,226,10874,L,94,107,-13
21748,225,10874,W,107,94,13
21749,276,10875,W,97,93,4
21750,275,10875,L,93,97,-4
21751,565,10876,L,86,105,-19
21752,566,10876,W,105,86,19
21753,139,10877,L,91,93,-2
21754,140,10877,W,93,91,2
21755,1023,10878,W,112,106,6
21756,1024,10878,L,106,112,-6
21757,586,10879,L,91,98,-7
21758,585,10879,W,98,91,7
21759,352,10880,W,110,99,11
21760,351,10880,L,99,110,-11
21761,711,10881,L,97,111,-14
21762,712,10881,W,111,97,14
21763,903,10882,L,95,122,-27
21764,904,10882,W,122,95,27
21765,651,10883,L,87,111,-24
21766,652,10883,W,111,87,24
21767,953,10884,W,95,89,6
21768,954,10884,L,89,95,-6
21769,548,10885,W,120,108,12
21770,547,10885,L,108,120,-12
21771,539,10886,W,96,90,6
21772,540,10886,L,90,96,-6
21773,948,10887,L,97,110,-13
21774,947,10887,W,110,97,13
21775,247,10888,L,86,104,-18
21776,248,10888,W,104,86,18
21777,44,10889,L,85,86,-1
21778,43,10889,W,86,85,1
21779,64,10890,W,105,102,3
21780,63,10890,L,102,105,-3
21781,1016,10891,W,83,74,9
21782,1015,10891,L,74,83,-9
21783,805,10892,L,91,104,-13
21784,806,10892,W,104,91,13
21785,68,10893,L,114,119,-5
21786,67,10893,W,119,114,5
21787,221,10894,L,97,110,-13
21788,222,10894,W,110,97,13
21789,117,10895,L,94,96,-2
21790,118,10895,W,96,94,2
21791,738,10896,W,99,94,5
21792,737,10896,L,94,99,-5
21793,679,10897,L,94,106,-12
21794,680,10897,W,106,94,12
21795,615,10898,W,106,104,2
21796,616,10898,L,104,106,-2
21797,814,10899,L,101,106,-5
21798,813,10899,W,106,101,5
21799,320,10900,W,100,99,1
21800,319,10900,L,99,100,-1
21801,830,10901,L,105,118,-13
21802,829,10901,W,118,105,13
21803,182,10902,L,104,115,-11
21804,181,10902,W,115,104,11
21805,143,10903,L,71,103,-32
21806,144,10903,W,103,71,32
21807,797,10904,L,98,116,-18
21808,798,10904,W,116,98,18
21809,933,10905,L,98,99,-1
21810,934,10905,W,99,98,1
21811,480,10906,L,86,89,-3
21812,479,10906,W,89,86,3
21813,1025,10907,L,100,101,-1
21814,1026,10907,W,101,100,1
21815,928,10908,W,99,93,6
21816,927,10908,L,93,99,-6
21817,664,10909,W,110,92,18
21818,663,10909,L,92,110,-18
21819,996,10910,L,78,108,-30
21820,995,10910,W,108,78,30
21821,708,10911,W,101,96,5
21822,707,10911,L,96,101,-5
21823,885,10912,L,84,100,-16
21824,886,10912,W,100,84,16
21825,702,10913,L,85,88,-3
21826,701,10913,W,88,85,3
21827,405,10914,L,92,97,-5
21828,406,10914,W,97,92,5
21829,840,10915,L,85,95,-10
21830,839,10915,W,95,85,10
21831,386,10916,W,120,100,20
21832,385,10916,L,100,120,-20
21833,75,10917,L,72,92,-20
21834,76,10917,W,92,72,20
21835,375,10918,W,109,100,9
21836,376,10918,L,100,109,-9
21837,581,10919,L,91,95,-4
21838,582,10919,W,95,91,4
21839,32,10920,L,116,119,-3
21840,31,10920,W,119,116,3
21841,960,10921,L,74,86,-12
21842,959,10921,W,86,74,12
21843,465,10922,L,93,97,-4
21844,466,10922,W,97,93,4
21845,38,10923,L,94,95,-1
21846,37,10923,W,95,94,1
21847,214,10924,W,92,88,4
21848,213,10924,L,88,92,-4
21849,345,10925,W,105,103,2
21850,346,10925,L,103,105,-2
21851,54,10926,L,88,96,-8
21852,53,10926,W,96,88,8
21853,219,10927,W,99,94,5
21854,220,10927,L,94,99,-5
21855,812,10928,L,111,115,-4
21856,811,10928,W,115,111,4
21857,124,10929,L,83,93,-10
21858,123,10929,W,93,83,10
21859,344,10930,L,75,83,-8
21860,343,10930,W,83,75,8
21861,513,10931,W,96,91,5
21862,514,10931,L,91,96,-5
21863,1016,10932,W,104,101,3
21864,1015,10932,L,101,104,-3
21865,680,10933,W,122,110,12
21866,679,10933,L,110,122,-12
21867,549,10934,L,83,100,-17
21868,550,10934,W,100,83,17
21869,471,10935,L,98,101,-3
21870,472,10935,W,101,98,3
21871,184,10936,L,96,102,-6
21872,183,10936,W,102,96,6
21873,138,10937,L,98,114,-16
21874,137,10937,W,114,98,16
21875,600,10938,L,90,97,-7
21876,599,10938,W,97,90,7
21877,983,10939,W,102,84,18
21878,984,10939,L,84,102,-18
21879,735,10940,L,94,99,-5
21880,736,10940,W,99,94,5
21881,189,10941,W,102,99,3
21882,190,10941,L,99,102,-3
21883,930,10942,L,92,97,-5
21884,929,10942,W,97,92,5
21885,159,10943,L,107,115,-8
21886,160,10943,W,115,107,8
21887,50,10944,W,117,105,12
21888,49,10944,L,105,117,-12
21889,274,10945,W,112,91,21
21890,273,10945,L,91,112,-21
21891,497,10946,L,98,99,-1
21892,498,10946,W,99,98,1
21893,324,10947,L,83,105,-22
21894,323,10947,W,105,83,22
21895,998,10948,L,94,107,-13
21896,997,10948,W,107,94,13
21897,224,10949,L,78,81,-3
21898,223,10949,W,81,78,3
21899,905,10950,L,72,102,-30
21900,906,10950,W,102,72,30
21901,36,10951,W,105,102,3
21902,35,10951,L,102,105,-3
21903,470,10952,W,108,100,8
21904,469,10952,L,100,108,-8
21905,511,10953,W,107,93,14
21906,512,10953,L,93,107,-14
21907,779,10954,L,95,104,-9
21908,780,10954,W,104,95,9
21909,910,10955,L,94,109,-15
21910,909,10955,W,109,94,15
21911,63,10956,L,85,104,-19
21912,64,10956,W,104,85,19
21913,30,10957,L,103,120,-17
21914,29,10957,W,120,103,17
21915,970,10958,W,95,84,11
21916,969,10958,L,84,95,-11
21917,461,10959,L,83,104,-21
21918,462,10959,W,104,83,21
21919,691,10960,W,92,88,4
21920,692,10960,L,88,92,-4
21921,334,10961,L,85,96,-11
21922,333,10961,W,96,85,11
21923,807,10962,W,85,82,3
21924,808,10962,L,82,85,-3
21925,584,10963,W,96,89,7
21926,583,10963,L,89,96,-7
21927,99,10964,L,96,102,-6
21928,100,10964,W,102,96,6
21929,57,10965,W,102,95,7
21930,58,10965,L,95,102,-7
21931,209,10966,L,95,104,-9
21932,210,10966,W,104,95,9
21933,798,10967,L,85,88,-3
21934,797,10967,W,88,85,3
21935,353,10968,W,86,83,3
21936,354,10968,L,83,86,-3
21937,596,10969,L,78,102,-24
21938,595,10969,W,102,78,24
21939,968,10970,L,95,99,-4
21940,967,10970,W,99,95,4
21941,628,10971,L,96,103,-7
21942,627,10971,W,103,96,7
21943,1027,10972,W,93,92,1
21944,1028,10972,L,92,93,-1
21945,266,10973,W,97,68,29
21946,265,10973,L,68,97,-29
21947,176,10974,L,118,119,-1
21948,175,10974,W,119,118,1
21949,37,10975,W,109,97,12
21950,38,10975,L,97,109,-12
21951,220,10976,W,114,99,15
21952,219,10976,L,99,114,-15
21953,218,10977,L,85,100,-15
21954,217,10977,W,100,85,15
21955,427,10978,L,78,83,-5
21956,428,10978,W,83,78,5
21957,666,10979,L,88,102,-14
21958,665,10979,W,102,88,14
21959,944,10980,W,89,84,5
21960,943,10980,L,84,89,-5
21961,88,10981,L,95,103,-8
21962,87,10981,W,103,95,8
21963,80,10982,L,98,100,-2
21964,79,10982,W,100,98,2
21965,901,10983,W,102,88,14
21966,902,10983,L,88,102,-14
21967,151,10984,L,87,93,-6
21968,152,10984,W,93,87,6
21969,272,10985,L,82,99,-17
21970,271,10985,W,99,82,17
21971,300,10986,L,104,119,-15
21972,299,10986,W,119,104,15
21973,1022,10987,W,108,91,17
21974,1021,10987,L,91,108,-17
21975,566,10988,L,93,103,-10
21976,565,10988,W,103,93,10
21977,362,10989,W,115,107,8
21978,361,10989,L,107,115,-8
21979,401,10990,W,106,104,2
21980,402,10990,L,104,106,-2
21981,94,10991,W,96,91,5
21982,93,10991,L,91,96,-5
21983,616,10992,L,91,110,-19
21984,615,10992,W,110,91,19
21985,984,10993,L,108,117,-9
21986,983,10993,W,117,108,9
21987,72,10994,L,100,101,-1
21988,71,10994,W,101,100,1
21989,532,10995,L,76,89,-13
21990,531,10995,W,89,76,13
21991,528,10996,L,108,120,-12
21992,527,10996,W,120,108,12
21993,533,10997,L,97,137,-40
21994,534,10997,W,137,97,40
21995,459,10998,L,101,103,-2
21996,460,10998,W,103,101,2
21997,433,10999,L,93,97,-4
21998,434,10999,W,97,93,4
21999,258,11000,L,88,104,-16
22000,257,11000,W,104,88,16
22001,157,11001,W,106,102,4
22002,158,11001,L,102,106,-4
22003,137,11002,W,93,90,3
22004,138,11002,L,90,93,-3
22005,275,11003,L,97,104,-7
22006,276,11003,W,104,97,7
22007,45,11004,L,92,103,-11
22008,46,11004,W,103,92,11
22009,994,11005,W,100,92,8
22010,993,11005,L,92,100,-8
22011,101,11006,L,79,90,-11
22012,102,11006,W,90,79,11
22013,745,11007,L,73,89,-16
22014,746,11007,W,89,73,16
22015,965,11008,L,93,101,-8
22016,966,11008,W,101,93,8
22017,862,11009,L,92,93,-1
22018,861,11009,W,93,92,1
22019,642,11010,L,81,96,-15
22020,641,11010,W,96,81,15
22021,462,11011,L,85,101,-16
22022,461,11011,W,101,85,16
22023,239,11012,L,118,124,-6
22024,240,11012,W,124,118,6
22025,902,11013,L,73,108,-35
22026,901,11013,W,108,73,35
22027,504,11014,L,90,102,-12
22028,503,11014,W,102,90,12
22029,116,11015,L,78,90,-12
22030,115,11015,W,90,78,12
22031,854,11016,L,91,92,-1
22032,853,11016,W,92,91,1
22033,992,11017,W,92,85,7
22034,991,11017,L,85,92,-7
22035,839,11018,L,97,104,-7
22036,840,11018,W,104,97,7
22037,663,11019,L,103,104,-1
22038,664,11019,W,104,103,1
22039,547,11020,W,103,100,3
22040,548,11020,L,100,103,-3
22041,1029,11021,W,97,85,12
22042,1030,11021,L,85,97,-12
22043,398,11022,L,77,97,-20
22044,397,11022,W,97,77,20
22045,924,11023,W,98,91,7
22046,923,11023,L,91,98,-7
22047,390,11024,L,108,114,-6
22048,389,11024,W,114,108,6
22049,828,11025,L,87,110,-23
22050,827,11025,W,110,87,23
22051,503,11026,L,99,111,-12
22052,504,11026,W,111,99,12
22053,577,11027,L,102,103,-1
22054,578,11027,W,103,102,1
22055,979,11028,W,89,85,4
22056,980,11028,L,85,89,-4
22057,138,11029,L,85,94,-9
22058,137,11029,W,94,85,9
22059,409,11030,L,100,114,-14
22060,410,11030,W,114,100,14
22061,447,11031,W,111,87,24
22062,448,11031,L,87,111,-24
22063,668,11032,W,82,75,7
22064,667,11032,L,75,82,-7
22065,287,11033,W,111,98,13
22066,288,11033,L,98,111,-13
22067,1012,11034,L,88,93,-5
22068,1011,11034,W,93,88,5
22069,654,11035,L,80,89,-9
22070,653,11035,W,89,80,9
22071,18,11036,W,74,71,3
22072,17,11036,L,71,74,-3
22073,612,11037,W,93,91,2
22074,611,11037,L,91,93,-2
22075,133,11038,L,95,96,-1
22076,134,11038,W,96,95,1
22077,1031,11039,W,105,100,5
22078,1032,11039,L,100,105,-5
22079,267,11040,L,84,102,-18
22080,268,11040,W,102,84,18
22081,896,11041,L,90,102,-12
22082,895,11041,W,102,90,12
22083,82,11042,W,113,106,7
22084,81,11042,L,106,113,-7
22085,641,11043,W,98,88,10
22086,642,11043,L,88,98,-10
22087,12,11044,L,87,98,-11
22088,11,11044,W,98,87,11
22089,650,11045,W,101,99,2
22090,649,11045,L,99,101,-2
22091,766,11046,L,85,100,-15
22092,765,11046,W,100,85,15
22093,784,11047,L,84,102,-18
22094,783,11047,W,102,84,18
22095,986,11048,W,92,89,3
22096,985,11048,L,89,92,-3
22097,3,11049,L,87,103,-16
22098,4,11049,W,103,87,16
22099,51,11050,L,85,111,-26
22100,52,11050,W,111,85,26
22101,351,11051,W,124,109,15
22102,352,11051,L,109,124,-15
22103,13,11052,W,90,87,3
22104,14,11052,L,87,90,-3
22105,758,11053,L,78,86,-8
22106,757,11053,W,86,78,8
22107,732,11054,W,99,95,4
22108,731,11054,L,95,99,-4
22109,597,11055,L,115,121,-6
22110,598,11055,W,121,115,6
22111,520,11056,L,92,109,-17
22112,519,11056,W,109,92,17
22113,140,11057,W,105,90,15
22114,139,11057,L,90,105,-15
22115,434,11058,L,83,93,-10
22116,433,11058,W,93,83,10
22117,877,11059,W,98,89,9
22118,878,11059,L,89,98,-9
22119,940,11060,L,80,86,-6
22120,939,11060,W,86,80,6
22121,26,11061,W,114,96,18
22122,25,11061,L,96,114,-18
22123,332,11062,L,89,102,-13
22124,331,11062,W,102,89,13
22125,66,11063,L,92,96,-4
22126,65,11063,W,96,92,4
22127,402,11064,L,96,102,-6
22128,401,11064,W,102,96,6
22129,216,11065,W,98,88,10
22130,215,11065,L,88,98,-10
22131,483,11066,L,97,106,-9
22132,484,11066,W,106,97,9
22133,251,11067,W,94,92,2
22134,252,11067,L,92,94,-2
22135,618,11068,W,98,77,21
22136,617,11068,L,77,98,-21
22137,479,11069,W,107,87,20
22138,480,11069,L,87,107,-20
22139,653,11070,L,91,95,-4
22140,654,11070,W,95,91,4
22141,1033,11071,W,103,89,14
22142,1034,11071,L,89,103,-14
22143,921,11072,W,111,86,25
22144,922,11072,L,86,111,-25
22145,53,11073,W,98,84,14
22146,54,11073,L,84,98,-14
22147,137,11074,W,99,94,5
22148,138,11074,L,94,99,-5
22149,69,11075,W,99,84,15
22150,70,11075,L,84,99,-15
22151,622,11076,W,113,109,4
22152,621,11076,L,109,113,-4
22153,173,11077,L,94,97,-3
22154,174,11077,W,97,94,3
22155,867,11078,W,100,98,2
22156,868,11078,L,98,100,-2
22157,428,11079,W,89,87,2
22158,427,11079,L,87,89,-2
22159,131,11080,L,74,86,-12
22160,132,11080,W,86,74,12
22161,392,11081,W,78,77,1
22162,391,11081,L,77,78,-1
22163,809,11082,L,92,98,-6
22164,810,11082,W,98,92,6
22165,873,11083,W,95,64,31
22166,874,11083,L,64,95,-31
22167,1035,11084,L,92,109,-17
22168,1036,11084,W,109,92,17
22169,307,11085,W,106,89,17
22170,308,11085,L,89,106,-17
22171,609,11086,L,85,92,-7
22172,610,11086,W,92,85,7
22173,959,11087,W,94,86,8
22174,960,11087,L,86,94,-8
22175,52,11088,W,101,87,14
22176,51,11088,L,87,101,-14
22177,764,11089,W,113,112,1
22178,763,11089,L,112,113,-1
22179,381,11090,W,104,97,7
22180,382,11090,L,97,104,-7
22181,426,11091,L,101,106,-5
22182,425,11091,W,106,101,5
22183,529,11092,W,96,89,7
22184,530,11092,L,89,96,-7
22185,456,11093,W,88,87,1
22186,455,11093,L,87,88,-1
22187,369,11094,W,109,101,8
22188,370,11094,L,101,109,-8
22189,73,11095,W,103,96,7
22190,74,11095,L,96,103,-7
22191,517,11096,L,92,99,-7
22192,518,11096,W,99,92,7
22193,967,11097,W,90,67,23
22194,968,11097,L,67,90,-23
22195,279,11098,W,107,93,14
22196,280,11098,L,93,107,-14
22197,235,11099,W,100,90,10
22198,236,11099,L,90,100,-10
22199,685,11100,L,80,85,-5
22200,686,11100,W,85,80,5
22201,186,11101,W,105,99,6
22202,185,11101,L,99,105,-6
22203,268,11102,W,105,95,10
22204,267,11102,L,95,105,-10
22205,115,11103,L,89,102,-13
22206,116,11103,W,102,89,13
22207,1036,11104,W,99,92,7
22208,1035,11104,L,92,99,-7
22209,707,11105,L,87,97,-10
22210,708,11105,W,97,87,10
22211,879,11106,L,84,94,-10
22212,880,11106,W,94,84,10
22213,554,11107,L,84,86,-2
22214,553,11107,W,86,84,2
22215,614,11108,L,99,104,-5
22216,613,11108,W,104,99,5
22217,310,11109,W,107,105,2
22218,309,11109,L,105,107,-2
22219,448,11110,L,91,107,-16
22220,447,11110,W,107,91,16
22221,827,11111,W,119,116,3
22222,828,11111,L,116,119,-3
22223,1030,11112,W,108,87,21
22224,1029,11112,L,87,108,-21
22225,649,11113,W,99,90,9
22226,650,11113,L,90,99,-9
22227,630,11114,W,111,107,4
22228,629,11114,L,107,111,-4
22229,347,11115,L,88,99,-11
22230,348,11115,W,99,88,11
22231,589,11116,W,107,102,5
22232,590,11116,L,102,107,-5
22233,638,11117,L,108,111,-3
22234,637,11117,W,111,108,3
22235,368,11118,L,90,95,-5
22236,367,11118,W,95,90,5
22237,49,11119,W,99,90,9
22238,50,11119,L,90,99,-9
22239,934,11120,W,100,92,8
22240,933,11120,L,92,100,-8
22241,109,11121,W,89,84,5
22242,110,11121,L,84,89,-5
22243,23,11122,L,80,98,-18
22244,24,11122,W,98,80,18
22245,231,11123,L,89,95,-6
22246,232,11123,W,95,89,6
22247,834,11124,L,88,91,-3
22248,833,11124,W,91,88,3
22249,458,11125,L,96,107,-11
22250,457,11125,W,107,96,11
22251,446,11126,W,98,87,11
22252,445,11126,L,87,98,-11
22253,994,11127,L,92,99,-7
22254,993,11127,W,99,92,7
22255,229,11128,L,87,96,-9
22256,230,11128,W,96,87,9
22257,288,11129,L,91,100,-9
22258,287,11129,W,100,91,9
22259,436,11130,L,106,114,-8
22260,435,11130,W,114,106,8
22261,615,11131,W,113,90,23
22262,616,11131,L,90,113,-23
22263,210,11132,L,97,117,-20
22264,209,11132,W,117,97,20
22265,783,11133,W,107,81,26
22266,784,11133,L,81,107,-26
22267,964,11134,L,87,89,-2
22268,963,11134,W,89,87,2
22269,225,11135,W,85,81,4
22270,226,11135,L,81,85,-4
22271,915,11136,L,89,95,-6
22272,916,11136,W,95,89,6
22273,208,11137,L,94,101,-7
22274,207,11137,W,101,94,7
22275,1037,11138,W,108,105,3
22276,1038,11138,L,105,108,-3
22277,311,11139,W,98,87,11
22278,312,11139,L,87,98,-11
22279,637,11140,L,89,106,-17
22280,638,11140,W,106,89,17
22281,558,11141,W,99,79,20
22282,557,11141,L,79,99,-20
22283,812,11142,L,89,91,-2
22284,811,11142,W,91,89,2
22285,530,11143,L,81,99,-18
22286,529,11143,W,99,81,18
22287,128,11144,W,93,89,4
22288,127,11144,L,89,93,-4
22289,796,11145,L,94,102,-8
22290,795,11145,W,102,94,8
22291,485,11146,L,80,88,-8
22292,486,11146,W,88,80,8
22293,607,11147,L,101,119,-18
22294,608,11147,W,119,101,18
22295,88,11148,W,112,91,21
22296,87,11148,L,91,112,-21
22297,399,11149,W,105,102,3
22298,400,11149,L,102,105,-3
22299,316,11150,L,92,95,-3
22300,315,11150,W,95,92,3
22301,78,11151,W,96,77,19
22302,77,11151,L,77,96,-19
22303,975,11152,L,81,93,-12
22304,976,11152,W,93,81,12
22305,1036,11153,L,96,99,-3
22306,1035,11153,W,99,96,3
22307,513,11154,L,82,98,-16
22308,514,11154,W,98,82,16
22309,58,11155,L,103,109,-6
22310,57,11155,W,109,103,6
22311,730,11156,W,107,105,2
22312,729,11156,L,105,107,-2
22313,582,11157,W,95,86,9
22314,581,11157,L,86,95,-9
22315,892,11158,L,68,112,-44
22316,891,11158,W,112,68,44
22317,132,11159,L,64,100,-36
22318,131,11159,W,100,64,36
22319,26,11160,L,97,105,-8
22320,25,11160,W,105,97,8
22321,169,11161,L,91,99,-8
22322,170,11161,W,99,91,8
22323,938,11162,W,120,103,17
22324,937,11162,L,103,120,-17
22325,636,11163,W,109,99,10
22326,635,11163,L,99,109,-10
22327,353,11164,W,93,90,3
22328,354,11164,L,90,93,-3
22329,579,11165,W,100,77,23
22330,580,11165,L,77,100,-23
22331,917,11166,L,73,106,-33
22332,918,11166,W,106,73,33
22333,1012,11167,L,99,106,-7
22334,1011,11167,W,106,99,7
22335,435,11168,L,90,93,-3
22336,436,11168,W,93,90,3
22337,295,11169,L,86,113,-27
22338,296,11169,W,113,86,27
22339,577,11170,L,97,100,-3
22340,578,11170,W,100,97,3
22341,4,11171,L,69,74,-5
22342,3,11171,W,74,69,5
22343,946,11172,L,95,109,-14
22344,945,11172,W,109,95,14
22345,147,11173,L,100,112,-12
22346,148,11173,W,112,100,12
22347,109,11174,W,83,73,10
22348,110,11174,L,73,83,-10
22349,9,11175,W,98,88,10
22350,10,11175,L,88,98,-10
22351,287,11176,W,120,108,12
22352,288,11176,L,108,120,-12
22353,98,11177,L,89,93,-4
22354,97,11177,W,93,89,4
22355,117,11178,W,122,99,23
22356,118,11178,L,99,122,-23
22357,486,11179,L,82,103,-21
22358,485,11179,W,103,82,21
22359,354,11180,W,88,87,1
22360,353,11180,L,87,88,-1
22361,278,11181,L,100,101,-1
22362,277,11181,W,101,100,1
22363,787,11182,L,93,97,-4
22364,788,11182,W,97,93,4
22365,226,11183,W,106,85,21
22366,225,11183,L,85,106,-21
22367,87,11184,W,109,105,4
22368,88,11184,L,105,109,-4
22369,64,11185,W,106,101,5
22370,63,11185,L,101,106,-5
22371,972,11186,W,94,72,22
22372,971,11186,L,72,94,-22
22373,988,11187,W,94,73,21
22374,987,11187,L,73,94,-21
22375,372,11188,L,84,97,-13
22376,371,11188,W,97,84,13
22377,586,11189,L,84,86,-2
22378,585,11189,W,86,84,2
22379,627,11190,L,93,96,-3
22380,628,11190,W,96,93,3
22381,882,11191,W,102,99,3
22382,881,11191,L,99,102,-3
22383,338,11192,L,89,100,-11
22384,337,11192,W,100,89,11
22385,265,11193,L,74,95,-21
22386,266,11193,W,95,74,21
22387,666,11194,L,89,99,-10
22388,665,11194,W,99,89,10
22389,1000,11195,W,99,96,3
22390,999,11195,L,96,99,-3
22391,818,11196,L,79,87,-8
22392,817,11196,W,87,79,8
22393,856,11197,L,76,103,-27
22394,855,11197,W,103,76,27
22395,150,11198,L,81,96,-15
22396,149,11198,W,96,81,15
22397,44,11199,W,107,101,6
22398,43,11199,L,101,107,-6
22399,878,11200,L,72,89,-17
22400,877,11200,W,89,72,17
22401,283,11201,L,71,109,-38
22402,284,11201,W,109,71,38
22403,184,11202,L,101,116,-15
22404,183,11202,W,116,101,15
22405,42,11203,L,87,94,-7
22406,41,11203,W,94,87,7
22407,961,11204,L,67,93,-26
22408,962,11204,W,93,67,26
22409,827,11205,W,120,109,11
22410,828,11205,L,109,120,-11
22411,616,11206,L,100,107,-7
22412,615,11206,W,107,100,7
22413,196,11207,W,91,83,8
22414,195,11207,L,83,91,-8
22415,443,11208,L,91,98,-7
22416,444,11208,W,98,91,7
22417,29,11209,L,81,91,-10
22418,30,11209,W,91,81,10
22419,293,11210,W,111,106,5
22420,294,11210,L,106,111,-5
22421,241,11211,W,105,99,6
22422,242,11211,L,99,105,-6
22423,119,11212,L,91,96,-5
22424,120,11212,W,96,91,5
22425,382,11213,W,105,90,15
22426,381,11213,L,90,105,-15
22427,965,11214,L,91,101,-10
22428,966,11214,W,101,91,10
22429,990,11215,W,97,90,7
22430,989,11215,L,90,97,-7
22431,31,11216,W,122,93,29
22432,32,11216,L,93,122,-29
22433,881,11217,L,75,92,-17
22434,882,11217,W,92,75,17
22435,612,11218,L,93,101,-8
22436,611,11218,W,101,93,8
22437,75,11219,W,95,90,5
22438,76,11219,L,90,95,-5
22439,842,11220,W,101,98,3
22440,841,11220,L,98,101,-3
22441,633,11221,L,83,105,-22
22442,634,11221,W,105,83,22
22443,363,11222,W,99,96,3
22444,364,11222,L,96,99,-3
22445,920,11223,W,111,78,33
22446,919,11223,L,78,111,-33
22447,145,11224,L,84,97,-13
22448,146,11224,W,97,84,13
22449,448,11225,L,85,92,-7
22450,447,11225,W,92,85,7
22451,225,11226,W,102,83,19
22452,226,11226,L,83,102,-19
22453,195,11227,L,56,87,-31
22454,196,11227,W,87,56,31
22455,664,11228,W,91,90,1
22456,663,11228,L,90,91,-1
22457,356,11229,L,79,99,-20
22458,355,11229,W,99,79,20
22459,118,11230,L,87,93,-6
22460,117,11230,W,93,87,6
22461,1029,11231,L,95,110,-15
22462,1030,11231,W,110,95,15
22463,288,11232,W,107,92,15
22464,287,11232,L,92,107,-15
22465,976,11233,W,104,102,2
22466,975,11233,L,102,104,-2
22467,315,11234,L,89,101,-12
22468,316,11234,W,101,89,12
22469,736,11235,W,97,92,5
22470,735,11235,L,92,97,-5
22471,105,11236,L,83,103,-20
22472,106,11236,W,103,83,20
22473,25,11237,W,91,82,9
22474,26,11237,L,82,91,-9
22475,200,11238,W,98,96,2
22476,199,11238,L,96,98,-2
22477,776,11239,L,91,103,-12
22478,775,11239,W,103,91,12
22479,156,11240,W,100,94,6
22480,155,11240,L,94,100,-6
22481,1015,11241,L,87,97,-10
22482,1016,11241,W,97,87,10
22483,170,11242,L,102,105,-3
22484,169,11242,W,105,102,3
22485,452,11243,L,91,94,-3
22486,451,11243,W,94,91,3
22487,1039,11244,W,84,74,10
22488,1040,11244,L,74,84,-10
22489,79,11245,L,98,108,-10
22490,80,11245,W,108,98,10
22491,874,11246,L,89,95,-6
22492,873,11246,W,95,89,6
22493,494,11247,L,94,121,-27
22494,493,11247,W,121,94,27
22495,407,11248,L,95,128,-33
22496,408,11248,W,128,95,33
22497,557,11249,L,92,113,-21
22498,558,11249,W,113,92,21
22499,930,11250,W,83,81,2
22500,929,11250,L,81,83,-2
22501,756,11251,W,119,114,5
22502,755,11251,L,114,119,-5
22503,67,11252,W,100,86,14
22504,68,11252,L,86,100,-14
22505,274,11253,W,114,75,39
22506,273,11253,L,75,114,-39
22507,445,11254,L,76,90,-14
22508,446,11254,W,90,76,14
22509,689,11255,W,94,84,10
22510,690,11255,L,84,94,-10
22511,595,11256,W,94,91,3
22512,596,11256,L,91,94,-3
22513,37,11257,W,101,98,3
22514,38,11257,L,98,101,-3
22515,646,11258,L,80,92,-12
22516,645,11258,W,92,80,12
22517,625,11259,W,79,71,8
22518,626,11259,L,71,79,-8
22519,705,11260,W,108,104,4
22520,706,11260,L,104,108,-4
22521,261,11261,W,88,86,2
22522,262,11261,L,86,88,-2
22523,550,11262,W,98,81,17
22524,549,11262,L,81,98,-17
22525,183,11263,W,94,91,3
22526,184,11263,L,91,94,-3
22527,123,11264,L,87,98,-11
22528,124,11264,W,98,87,11
22529,974,11265,L,88,90,-2
22530,973,11265,W,90,88,2
22531,188,11266,L,102,105,-3
22532,187,11266,W,105,102,3
22533,65,11267,L,89,91,-2
22534,66,11267,W,91,89,2
22535,111,11268,L,85,93,-8
22536,112,11268,W,93,85,8
22537,777,11269,W,108,104,4
22538,778,11269,L,104,108,-4
22539,742,11270,L,88,92,-4
22540,741,11270,W,92,88,4
22541,394,11271,W,85,83,2
22542,393,11271,L,83,85,-2
22543,397,11272,L,89,92,-3
22544,398,11272,W,92,89,3
22545,132,11273,L,73,96,-23
22546,131,11273,W,96,73,23
22547,1010,11274,L,100,107,-7
22548,1009,11274,W,107,100,7
22549,639,11275,W,91,88,3
22550,640,11275,L,88,91,-3
22551,949,11276,W,93,87,6
22552,950,11276,L,87,93,-6
22553,620,11277,L,98,120,-22
22554,619,11277,W,120,98,22
22555,759,11278,L,80,97,-17
22556,760,11278,W,97,80,17
22557,563,11279,W,105,95,10
22558,564,11279,L,95,105,-10
22559,290,11280,W,105,95,10
22560,289,11280,L,95,105,-10
22561,730,11281,L,79,108,-29
22562,729,11281,W,108,79,29
22563,886,11282,L,89,96,-7
22564,885,11282,W,96,89,7
22565,467,11283,L,97,118,-21
22566,468,11283,W,118,97,21
22567,466,11284,L,82,94,-12
22568,465,11284,W,94,82,12
22569,535,11285,W,102,93,9
22570,536,11285,L,93,102,-9
22571,580,11286,L,84,93,-9
22572,579,11286,W,93,84,9
22573,554,11287,L,86,99,-13
22574,553,11287,W,99,86,13
22575,855,11288,W,114,106,8
22576,856,11288,L,106,114,-8
22577,93,11289,L,70,73,-3
22578,94,11289,W,73,70,3
22579,884,11290,W,102,94,8
22580,883,11290,L,94,102,-8
22581,1026,11291,L,91,101,-10
22582,1025,11291,W,101,91,10
22583,299,11292,W,97,88,9
22584,300,11292,L,88,97,-9
22585,800,11293,L,86,102,-16
22586,799,11293,W,102,86,16
22587,959,11294,W,84,77,7
22588,960,11294,L,77,84,-7
22589,601,11295,L,91,102,-11
22590,602,11295,W,102,91,11
22591,135,11296,W,106,96,10
22592,136,11296,L,96,106,-10
22593,33,11297,W,99,91,8
22594,34,11297,L,91,99,-8
22595,106,11298,W,103,90,13
22596,105,11298,L,90,103,-13
22597,222,11299,L,60,99,-39
22598,221,11299,W,99,60,39
22599,914,11300,L,100,112,-12
22600,913,11300,W,112,100,12
22601,950,11301,L,99,108,-9
22602,949,11301,W,108,99,9
22603,1014,11302,L,94,107,-13
22604,1013,11302,W,107,94,13
22605,41,11303,L,83,97,-14
22606,42,11303,W,97,83,14
22607,544,11304,L,91,93,-2
22608,543,11304,W,93,91,2
22609,330,11305,L,92,104,-12
22610,329,11305,W,104,92,12
22611,120,11306,L,94,102,-8
22612,119,11306,W,102,94,8
22613,74,11307,L,105,107,-2
22614,73,11307,W,107,105,2
22615,560,11308,L,64,77,-13
22616,559,11308,W,77,64,13
22617,197,11309,L,76,102,-26
22618,198,11309,W,102,76,26
22619,909,11310,W,98,81,17
22620,910,11310,L,81,98,-17
22621,7,11311,L,89,103,-14
22622,8,11311,W,103,89,14
22623,653,11312,W,88,79,9
22624,654,11312,L,79,88,-9
22625,105,11313,L,89,120,-31
22626,106,11313,W,120,89,31
22627,534,11314,L,83,99,-16
22628,533,11314,W,99,83,16
22629,1041,11315,W,110,103,7
22630,1042,11315,L,103,110,-7
22631,453,11316,W,95,90,5
22632,454,11316,L,90,95,-5
22633,255,11317,L,104,117,-13
22634,256,11317,W,117,104,13
22635,954,11318,W,87,80,7
22636,953,11318,L,80,87,-7
22637,657,11319,L,92,97,-5
22638,658,11319,W,97,92,5
22639,574,11320,L,83,94,-11
22640,573,11320,W,94,83,11
22641,863,11321,W,101,90,11
22642,864,11321,L,90,101,-11
22643,623,11322,W,117,109,8
22644,624,11322,L,109,117,-8
22645,875,11323,L,81,111,-30
22646,876,11323,W,111,81,30
22647,486,11324,L,93,102,-9
22648,485,11324,W,102,93,9
22649,83,11325,L,79,85,-6
22650,84,11325,W,85,79,6
22651,541,11326,L,89,95,-6
22652,542,11326,W,95,89,6
22653,10,11327,L,64,78,-14
22654,9,11327,W,78,64,14
22655,229,11328,W,90,87,3
22656,230,11328,L,87,90,-3
22657,1043,11329,L,115,123,-8
22658,1044,11329,W,123,115,8
22659,374,11330,W,107,104,3
22660,373,11330,L,104,107,-3
22661,746,11331,W,90,85,5
22662,745,11331,L,85,90,-5
22663,708,11332,L,84,96,-12
22664,707,11332,W,96,84,12
22665,169,11333,L,95,101,-6
22666,170,11333,W,101,95,6
22667,306,11334,W,98,91,7
22668,305,11334,L,91,98,-7
22669,966,11335,W,95,85,10
22670,965,11335,L,85,95,-10
22671,18,11336,L,97,105,-8
22672,17,11336,W,105,97,8
22673,342,11337,L,85,112,-27
22674,341,11337,W,112,85,27
22675,769,11338,W,100,86,14
22676,770,11338,L,86,100,-14
22677,376,11339,L,105,113,-8
22678,375,11339,W,113,105,8
22679,696,11340,L,103,106,-3
22680,695,11340,W,106,103,3
22681,638,11341,L,78,93,-15
22682,637,11341,W,93,78,15
22683,503,11342,L,83,99,-16
22684,504,11342,W,99,83,16
22685,499,11343,L,106,111,-5
22686,500,11343,W,111,106,5
22687,349,11344,W,111,100,11
22688,350,11344,L,100,111,-11
22689,889,11345,W,82,70,12
22690,890,11345,L,70,82,-12
22691,207,11346,W,100,95,5
22692,208,11346,L,95,100,-5
22693,670,11347,L,68,92,-24
22694,669,11347,W,92,68,24
22695,919,11348,L,87,91,-4
22696,920,11348,W,91,87,4
22697,1018,11349,W,106,101,5
22698,1017,11349,L,101,106,-5
22699,250,11350,L,86,96,-10
22700,249,11350,W,96,86,10
22701,507,11351,L,87,97,-10
22702,508,11351,W,97,87,10
22703,948,11352,W,94,81,13
22704,947,11352,L,81,94,-13
22705,309,11353,L,93,109,-16
22706,310,11353,W,109,93,16
22707,832,11354,L,78,98,-20
22708,831,11354,W,98,78,20
22709,404,11355,L,82,90,-8
22710,403,11355,W,90,82,8
22711,457,11356,L,96,108,-12
22712,458,11356,W,108,96,12
22713,246,11357,W,104,97,7
22714,245,11357,L,97,104,-7
22715,838,11358,W,93,72,21
22716,837,11358,L,72,93,-21
22717,133,11359,W,98,95,3
22718,134,11359,L,95,98,-3
22719,995,11360,W,101,90,11
22720,996,11360,L,90,101,-11
22721,790,11361,L,86,92,-6
22722,789,11361,W,92,86,6
22723,39,11362,L,62,97,-35
22724,40,11362,W,97,62,35
22725,929,11363,L,81,96,-15
22726,930,11363,W,96,81,15
22727,296,11364,W,103,80,23
22728,295,11364,L,80,103,-23
22729,902,11365,L,77,99,-22
22730,901,11365,W,99,77,22
22731,219,11366,L,117,121,-4
22732,220,11366,W,121,117,4
22733,607,11367,W,88,87,1
22734,608,11367,L,87,88,-1
22735,102,11368,L,94,109,-15
22736,101,11368,W,109,94,15
22737,737,11369,W,97,83,14
22738,738,11369,L,83,97,-14
22739,700,11370,W,98,87,11
22740,699,11370,L,87,98,-11
22741,134,11371,L,94,109,-15
22742,133,11371,W,109,94,15
22743,876,11372,W,102,96,6
22744,875,11372,L,96,102,-6
22745,42,11373,W,87,74,13
22746,41,11373,L,74,87,-13
22747,422,11374,L,90,97,-7
22748,421,11374,W,97,90,7
22749,947,11375,W,96,88,8
22750,948,11375,L,88,96,-8
22751,215,11376,L,85,94,-9
22752,216,11376,W,94,85,9
22753,279,11377,W,99,96,3
22754,280,11377,L,96,99,-3
22755,284,11378,L,77,102,-25
22756,283,11378,W,102,77,25
22757,265,11379,L,73,96,-23
22758,266,11379,W,96,73,23
22759,987,11380,W,97,85,12
22760,988,11380,L,85,97,-12
22761,46,11381,L,96,107,-11
22762,45,11381,W,107,96,11
22763,510,11382,L,100,103,-3
22764,509,11382,W,103,100,3
22765,277,11383,L,71,93,-22
22766,278,11383,W,93,71,22
22767,479,11384,W,116,109,7
22768,480,11384,L,109,116,-7
22769,998,11385,L,70,89,-19
22770,997,11385,W,89,70,19
22771,32,11386,L,83,110,-27
22772,31,11386,W,110,83,27
22773,721,11387,L,95,101,-6
22774,722,11387,W,101,95,6
22775,58,11388,L,85,103,-18
22776,57,11388,W,103,85,18
22777,669,11389,W,99,83,16
22778,670,11389,L,83,99,-16
22779,686,11390,W,90,86,4
22780,685,11390,L,86,90,-4
22781,919,11391,W,118,110,8
22782,920,11391,L,110,118,-8
22783,346,11392,L,89,117,-28
22784,345,11392,W,117,89,28
22785,118,11393,L,89,98,-9
22786,117,11393,W,98,89,9
22787,572,11394,L,77,92,-15
22788,571,11394,W,92,77,15
22789,139,11395,L,83,118,-35
22790,140,11395,W,118,83,35
22791,978,11396,W,101,93,8
22792,977,11396,L,93,101,-8
22793,629,11397,W,103,93,10
22794,630,11397,L,93,103,-10
22795,883,11398,L,101,115,-14
22796,884,11398,W,115,101,14
22797,129,11399,L,99,108,-9
22798,130,11399,W,108,99,9
22799,824,11400,L,73,85,-12
22800,823,11400,W,85,73,12
22801,407,11401,L,96,113,-17
22802,408,11401,W,113,96,17
22803,101,11402,L,74,76,-2
22804,102,11402,W,76,74,2
22805,401,11403,L,91,102,-11
22806,402,11403,W,102,91,11
22807,582,11404,L,87,100,-13
22808,581,11404,W,100,87,13
22809,818,11405,L,96,106,-10
22810,817,11405,W,106,96,10
22811,1011,11406,W,108,94,14
22812,1012,11406,L,94,108,-14
22813,480,11407,W,100,92,8
22814,479,11407,L,92,100,-8
22815,492,11408,L,78,89,-11
22816,491,11408,W,89,78,11
22817,155,11409,L,92,100,-8
22818,156,11409,W,100,92,8
22819,14,11410,W,90,85,5
22820,13,11410,L,85,90,-5
22821,939,11411,L,90,94,-4
22822,940,11411,W,94,90,4
22823,289,11412,L,86,91,-5
22824,290,11412,W,91,86,5
22825,1000,11413,L,82,98,-16
22826,999,11413,W,98,82,16
22827,381,11414,L,82,99,-17
22828,382,11414,W,99,82,17
22829,799,11415,L,64,104,-40
22830,800,11415,W,104,64,40
22831,17,11416,L,88,93,-5
22832,18,11416,W,93,88,5
22833,872,11417,L,90,129,-39
22834,871,11417,W,129,90,39
22835,213,11418,L,96,102,-6
22836,214,11418,W,102,96,6
22837,128,11419,L,90,99,-9
22838,127,11419,W,99,90,9
22839,933,11420,L,80,96,-16
22840,934,11420,W,96,80,16
22841,156,11421,W,94,86,8
22842,155,11421,L,86,94,-8
22843,684,11422,L,84,95,-11
22844,683,11422,W,95,84,11
22845,765,11423,W,114,92,22
22846,766,11423,L,92,114,-22
22847,791,11424,L,88,96,-8
22848,792,11424,W,96,88,8
22849,323,11425,W,107,79,28
22850,324,11425,L,79,107,-28
22851,182,11426,L,97,107,-10
22852,181,11426,W,107,97,10
22853,127,11427,L,89,92,-3
22854,128,11427,W,92,89,3
22855,158,11428,L,89,104,-15
22856,157,11428,W,104,89,15
22857,1017,11429,L,98,105,-7
22858,1018,11429,W,105,98,7
22859,806,11430,L,99,102,-3
22860,805,11430,W,102,99,3
22861,938,11431,W,93,78,15
22862,937,11431,L,78,93,-15
22863,740,11432,L,86,99,-13
22864,739,11432,W,99,86,13
22865,434,11433,L,93,113,-20
22866,433,11433,W,113,93,20
22867,641,11434,L,85,96,-11
22868,642,11434,W,96,85,11
22869,176,11435,L,81,102,-21
22870,175,11435,W,102,81,21
22871,762,11436,W,114,101,13
22872,761,11436,L,101,114,-13
22873,11,11437,L,91,98,-7
22874,12,11437,W,98,91,7
22875,432,11438,W,103,101,2
22876,431,11438,L,101,103,-2
22877,885,11439,W,100,79,21
22878,886,11439,L,79,100,-21
22879,610,11440,L,82,99,-17
22880,609,11440,W,99,82,17
22881,1021,11441,L,78,94,-16
22882,1022,11441,W,94,78,16
22883,170,11442,L,85,105,-20
22884,169,11442,W,105,85,20
22885,598,11443,W,108,98,10
22886,597,11443,L,98,108,-10
22887,581,11444,L,102,104,-2
22888,582,11444,W,104,102,2
22889,210,11445,L,102,111,-9
22890,209,11445,W,111,102,9
22891,771,11446,L,78,92,-14
22892,772,11446,W,92,78,14
22893,172,11447,W,103,83,20
22894,171,11447,L,83,103,-20
22895,871,11448,W,96,95,1
22896,872,11448,L,95,96,-1
22897,135,11449,L,100,117,-17
22898,136,11449,W,117,100,17
22899,453,11450,W,90,85,5
22900,454,11450,L,85,90,-5
22901,207,11451,W,98,95,3
22902,208,11451,L,95,98,-3
22903,71,11452,W,105,89,16
22904,72,11452,L,89,105,-16
22905,548,11453,L,90,115,-25
22906,547,11453,W,115,90,25
22907,326,11454,L,83,101,-18
22908,325,11454,W,101,83,18
22909,951,11455,L,78,97,-19
22910,952,11455,W,97,78,19
22911,717,11456,L,95,98,-3
22912,718,11456,W,98,95,3
22913,1018,11457,W,106,70,36
22914,1017,11457,L,70,106,-36
22915,315,11458,L,79,101,-22
22916,316,11458,W,101,79,22
22917,230,11459,L,71,96,-25
22918,229,11459,W,96,71,25
22919,125,11460,L,107,115,-8
22920,126,11460,W,115,107,8
22921,792,11461,L,79,91,-12
22922,791,11461,W,91,79,12
22923,937,11462,W,85,84,1
22924,938,11462,L,84,85,-1
22925,593,11463,W,104,100,4
22926,594,11463,L,100,104,-4
22927,267,11464,W,115,93,22
22928,268,11464,L,93,115,-22
22929,62,11465,L,91,99,-8
22930,61,11465,W,99,91,8
22931,160,11466,L,91,100,-9
22932,159,11466,W,100,91,9
22933,191,11467,L,103,107,-4
22934,192,11467,W,107,103,4
22935,314,11468,L,95,104,-9
22936,313,11468,W,104,95,9
22937,894,11469,L,95,96,-1
22938,893,11469,W,96,95,1
22939,1002,11470,W,90,84,6
22940,1001,11470,L,84,90,-6
22941,571,11471,W,104,96,8
22942,572,11471,L,96,104,-8
22943,110,11472,L,82,95,-13
22944,109,11472,W,95,82,13
22945,418,11473,W,105,94,11
22946,417,11473,L,94,105,-11
22947,35,11474,L,89,97,-8
22948,36,11474,W,97,89,8
22949,811,11475,L,104,106,-2
22950,812,11475,W,106,104,2
22951,852,11476,W,88,87,1
22952,851,11476,L,87,88,-1
22953,275,11477,W,105,86,19
22954,276,11477,L,86,105,-19
22955,417,11478,W,105,95,10
22956,418,11478,L,95,105,-10
22957,418,11479,L,103,112,-9
22958,417,11479,W,112,103,9
22959,418,11480,L,83,86,-3
22960,417,11480,W,86,83,3
22961,418,11481,W,88,86,2
22962,417,11481,L,86,88,-2
22963,417,11482,W,95,93,2
22964,418,11482,L,93,95,-2
22965,417,11483,L,84,92,-8
22966,418,11483,W,92,84,8
22967,788,11484,W,83,80,3
22968,787,11484,L,80,83,-3
22969,582,11485,L,96,100,-4
22970,581,11485,W,100,96,4
22971,787,11486,L,93,101,-8
22972,788,11486,W,101,93,8
22973,581,11487,W,112,105,7
22974,582,11487,L,105,112,-7
22975,787,11488,L,85,96,-11
22976,788,11488,W,96,85,11
22977,581,11489,W,93,87,6
22978,582,11489,L,87,93,-6
22979,582,11490,W,106,100,6
22980,581,11490,L,100,106,-6
22981,788,11491,W,85,75,10
22982,787,11491,L,75,85,-10
22983,582,11492,L,112,121,-9
22984,581,11492,W,121,112,9
22985,208,11493,L,90,105,-15
22986,207,11493,W,105,90,15
22987,788,11494,L,82,103,-21
22988,787,11494,W,103,82,21
22989,207,11495,L,83,95,-12
22990,208,11495,W,95,83,12
22991,102,11496,W,93,73,20
22992,101,11496,L,73,93,-20
22993,208,11497,L,72,99,-27
22994,207,11497,W,99,72,27
22995,125,11498,L,87,97,-10
22996,126,11498,W,97,87,10
22997,101,11499,L,83,95,-12
22998,102,11499,W,95,83,12
22999,207,11500,W,133,123,10
23000,208,11500,L,123,133,-10
23001,126,11501,W,98,90,8
23002,125,11501,L,90,98,-8
23003,102,11502,L,88,100,-12
23004,101,11502,W,100,88,12
23005,94,11503,L,86,122,-36
23006,93,11503,W,122,86,36
23007,207,11504,L,93,101,-8
23008,208,11504,W,101,93,8
23009,126,11505,L,81,97,-16
23010,125,11505,W,97,81,16
23011,102,11506,W,99,82,17
23012,101,11506,L,82,99,-17
23013,94,11507,L,92,98,-6
23014,93,11507,W,98,92,6
23015,101,11508,L,73,86,-13
23016,102,11508,W,86,73,13
23017,93,11509,W,93,81,12
23018,94,11509,L,81,93,-12
23019,208,11510,L,102,111,-9
23020,207,11510,W,111,102,9
23021,125,11511,L,91,102,-11
23022,126,11511,W,102,91,11
23023,101,11512,W,103,95,8
23024,102,11512,L,95,103,-8
23025,93,11513,W,96,94,2
23026,94,11513,L,94,96,-2
23027,208,11514,W,114,101,13
23028,207,11514,L,101,114,-13
23029,125,11515,L,90,99,-9
23030,126,11515,W,99,90,9
23031,109,11516,L,91,99,-8
23032,110,11516,W,99,91,8
23033,936,11517,W,98,80,18
23034,935,11517,L,80,98,-18
23035,174,11518,W,103,96,7
23036,173,11518,L,96,103,-7
23037,427,11519,L,81,84,-3
23038,428,11519,W,84,81,3
23039,110,11520,L,103,110,-7
23040,109,11520,W,110,103,7
23041,557,11521,L,91,97,-6
23042,558,11521,W,97,91,6
23043,239,11522,L,97,100,-3
23044,240,11522,W,100,97,3
23045,935,11523,L,90,106,-16
23046,936,11523,W,106,90,16
23047,75,11524,L,89,116,-27
23048,76,11524,W,116,89,27
23049,428,11525,L,76,101,-25
23050,427,11525,W,101,76,25
23051,109,11526,L,86,104,-18
23052,110,11526,W,104,86,18
23053,240,11527,L,101,104,-3
23054,239,11527,W,104,101,3
23055,173,11528,L,82,93,-11
23056,174,11528,W,93,82,11
23057,811,11529,W,101,89,12
23058,812,11529,L,89,101,-12
23059,558,11530,L,82,86,-4
23060,557,11530,W,86,82,4
23061,936,11531,L,88,93,-5
23062,935,11531,W,93,88,5
23063,427,11532,L,85,88,-3
23064,428,11532,W,88,85,3
23065,76,11533,L,84,89,-5
23066,75,11533,W,89,84,5
23067,109,11534,L,88,91,-3
23068,110,11534,W,91,88,3
23069,240,11535,W,97,94,3
23070,239,11535,L,94,97,-3
23071,174,11536,L,82,84,-2
23072,173,11536,W,84,82,2
23073,936,11537,W,100,86,14
23074,935,11537,L,86,100,-14
23075,811,11538,W,113,96,17
23076,812,11538,L,96,113,-17
23077,427,11539,L,84,88,-4
23078,428,11539,W,88,84,4
23079,558,11540,W,100,94,6
23080,557,11540,L,94,100,-6
23081,174,11541,L,92,97,-5
23082,173,11541,W,97,92,5
23083,76,11542,W,88,84,4
23084,75,11542,L,84,88,-4
23085,110,11543,L,87,93,-6
23086,109,11543,W,93,87,6
23087,239,11544,L,89,106,-17
23088,240,11544,W,106,89,17
23089,935,11545,L,78,87,-9
23090,936,11545,W,87,78,9
23091,428,11546,L,82,88,-6
23092,427,11546,W,88,82,6
23093,173,11547,L,89,101,-12
23094,174,11547,W,101,89,12
23095,812,11548,L,93,96,-3
23096,811,11548,W,96,93,3
23097,75,11549,L,90,96,-6
23098,76,11549,W,96,90,6
23099,557,11550,L,73,94,-21
23100,558,11550,W,94,73,21
23101,812,11551,L,85,87,-2
23102,811,11551,W,87,85,2
23103,110,11552,W,101,98,3
23104,109,11552,L,98,101,-3
23105,239,11553,L,103,107,-4
23106,240,11553,W,107,103,4
23107,935,11554,W,109,100,9
23108,936,11554,L,100,109,-9
23109,557,11555,L,89,97,-8
23110,558,11555,W,97,89,8
23111,428,11556,W,103,93,10
23112,427,11556,L,93,103,-10
23113,75,11557,L,99,104,-5
23114,76,11557,W,104,99,5
23115,173,11558,L,81,89,-8
23116,174,11558,W,89,81,8
23117,929,11559,L,89,121,-32
23118,930,11559,W,121,89,32
23119,1029,11560,L,92,97,-5
23120,1030,11560,W,97,92,5
23121,443,11561,L,103,110,-7
23122,444,11561,W,110,103,7
23123,232,11562,W,97,79,18
23124,231,11562,L,79,97,-18
23125,602,11563,L,103,106,-3
23126,601,11563,W,106,103,3
23127,226,11564,L,74,92,-18
23128,225,11564,W,92,74,18
23129,812,11565,L,102,112,-10
23130,811,11565,W,112,102,10
23131,265,11566,W,104,100,4
23132,266,11566,L,100,104,-4
23133,160,11567,W,116,108,8
23134,159,11567,L,108,116,-8
23135,136,11568,L,103,107,-4
23136,135,11568,W,107,103,4
23137,876,11569,L,85,96,-11
23138,875,11569,W,96,85,11
23139,288,11570,W,121,102,19
23140,287,11570,L,102,121,-19
23141,612,11571,L,86,110,-24
23142,611,11571,W,110,86,24
23143,412,11572,W,110,106,4
23144,411,11572,L,106,110,-4
23145,472,11573,L,93,100,-7
23146,471,11573,W,100,93,7
23147,16,11574,L,93,102,-9
23148,15,11574,W,102,93,9
23149,399,11575,W,103,90,13
23150,400,11575,L,90,103,-13
23151,145,11576,L,89,102,-13
23152,146,11576,W,102,89,13
23153,940,11577,W,90,78,12
23154,939,11577,L,78,90,-12
23155,369,11578,L,111,134,-23
23156,370,11578,W,134,111,23
23157,260,11579,W,98,91,7
23158,259,11579,L,91,98,-7
23159,426,11580,W,120,112,8
23160,425,11580,L,112,120,-8
23161,1015,11581,W,105,103,2
23162,1016,11581,L,103,105,-2
23163,479,11582,W,98,90,8
23164,480,11582,L,90,98,-8
23165,4,11583,W,95,85,10
23166,3,11583,L,85,95,-10
23167,779,11584,L,127,135,-8
23168,780,11584,W,135,127,8
23169,185,11585,L,86,93,-7
23170,186,11585,W,93,86,7
23171,71,11586,W,110,101,9
23172,72,11586,L,101,110,-9
23173,156,11587,L,94,95,-1
23174,155,11587,W,95,94,1
23175,737,11588,W,102,99,3
23176,738,11588,L,99,102,-3
23177,107,11589,W,110,109,1
23178,108,11589,L,109,110,-1
23179,435,11590,W,104,103,1
23180,436,11590,L,103,104,-1
23181,909,11591,W,112,101,11
23182,910,11591,L,101,112,-11
23183,118,11592,L,90,115,-25
23184,117,11592,W,115,90,25
23185,987,11593,L,92,99,-7
23186,988,11593,W,99,92,7
23187,125,11594,L,77,100,-23
23188,126,11594,W,100,77,23
23189,950,11595,L,89,111,-22
23190,949,11595,W,111,89,22
23191,217,11596,W,120,106,14
23192,218,11596,L,106,120,-14
23193,345,11597,L,78,99,-21
23194,346,11597,W,99,78,21
23195,763,11598,L,101,108,-7
23196,764,11598,W,108,101,7
23197,325,11599,L,83,115,-32
23198,326,11599,W,115,83,32
23199,459,11600,L,106,130,-24
23200,460,11600,W,130,106,24
23201,158,11601,L,102,111,-9
23202,157,11601,W,111,102,9
23203,708,11602,L,102,114,-12
23204,707,11602,W,114,102,12
23205,155,11603,L,88,104,-16
23206,156,11603,W,104,88,16
23207,407,11604,L,96,101,-5
23208,408,11604,W,101,96,5
23209,938,11605,L,97,109,-12
23210,937,11605,W,109,97,12
23211,46,11606,L,86,93,-7
23212,45,11606,W,93,86,7
23213,274,11607,W,93,82,11
23214,273,11607,L,82,93,-11
23215,993,11608,W,116,93,23
23216,994,11608,L,93,116,-23
23217,485,11609,L,100,110,-10
23218,486,11609,W,110,100,10
23219,39,11610,L,93,98,-5
23220,40,11610,W,98,93,5
23221,872,11611,L,103,112,-9
23222,871,11611,W,112,103,9
23223,66,11612,L,96,107,-11
23224,65,11612,W,107,96,11
23225,239,11613,L,89,104,-15
23226,240,11613,W,104,89,15
23227,654,11614,L,81,97,-16
23228,653,11614,W,97,81,16
23229,98,11615,W,98,87,11
23230,97,11615,L,87,98,-11
23231,238,11616,L,112,136,-24
23232,237,11616,W,136,112,24
23233,885,11617,W,111,102,9
23234,886,11617,L,102,111,-9
23235,780,11618,W,108,98,10
23236,779,11618,L,98,108,-10
23237,267,11619,W,104,96,8
23238,268,11619,L,96,104,-8
23239,148,11620,L,108,112,-4
23240,147,11620,W,112,108,4
23241,25,11621,W,90,85,5
23242,26,11621,L,85,90,-5
23243,973,11622,L,93,101,-8
23244,974,11622,W,101,93,8
23245,84,11623,W,97,92,5
23246,83,11623,L,92,97,-5
23247,572,11624,W,104,96,8
23248,571,11624,L,96,104,-8
23249,1035,11625,L,109,116,-7
23250,1036,11625,W,116,109,7
23251,421,11626,L,87,95,-8
23252,422,11626,W,95,87,8
23253,261,11627,L,92,124,-32
23254,262,11627,W,124,92,32
23255,467,11628,L,94,97,-3
23256,468,11628,W,97,94,3
23257,883,11629,L,89,99,-10
23258,884,11629,W,99,89,10
23259,7,11630,W,104,101,3
23260,8,11630,L,101,104,-3
23261,444,11631,W,82,81,1
23262,443,11631,L,81,82,-1
23263,144,11632,L,82,99,-17
23264,143,11632,W,99,82,17
23265,611,11633,W,108,87,21
23266,612,11633,L,87,108,-21
23267,138,11634,L,72,78,-6
23268,137,11634,W,78,72,6
23269,14,11635,L,118,131,-13
23270,13,11635,W,131,118,13
23271,634,11636,W,97,90,7
23272,633,11636,L,90,97,-7
23273,617,11637,L,105,107,-2
23274,618,11637,W,107,105,2
23275,1037,11638,L,105,107,-2
23276,1038,11638,W,107,105,2
23277,240,11639,W,101,94,7
23278,239,11639,L,94,101,-7
23279,230,11640,W,86,85,1
23280,229,11640,L,85,86,-1
23281,995,11641,W,108,94,14
23282,996,11641,L,94,108,-14
23283,30,11642,L,107,123,-16
23284,29,11642,W,123,107,16
23285,601,11643,L,97,114,-17
23286,602,11643,W,114,97,17
23287,983,11644,L,96,108,-12
23288,984,11644,W,108,96,12
23289,684,11645,L,109,114,-5
23290,683,11645,W,114,109,5
23291,174,11646,L,96,104,-8
23292,173,11646,W,104,96,8
23293,214,11647,L,98,102,-4
23294,213,11647,W,102,98,4
23295,127,11648,W,95,90,5
23296,128,11648,L,90,95,-5
23297,882,11649,W,97,91,6
23298,881,11649,L,91,97,-6
23299,628,11650,L,97,106,-9
23300,627,11650,W,106,97,9
23301,641,11651,L,90,101,-11
23302,642,11651,W,101,90,11
23303,465,11652,L,87,93,-6
23304,466,11652,W,93,87,6
23305,651,11653,L,92,99,-7
23306,652,11653,W,99,92,7
23307,560,11654,L,106,113,-7
23308,559,11654,W,113,106,7
23309,685,11655,L,89,106,-17
23310,686,11655,W,106,89,17
23311,147,11656,L,92,98,-6
23312,148,11656,W,98,92,6
23313,669,11657,W,101,96,5
23314,670,11657,L,96,101,-5
23315,360,11658,L,88,89,-1
23316,359,11658,W,89,88,1
23317,990,11659,L,90,115,-25
23318,989,11659,W,115,90,25
23319,229,11660,W,96,85,11
23320,230,11660,L,85,96,-11
23321,471,11661,L,107,115,-8
23322,472,11661,W,115,107,8
23323,630,11662,L,91,98,-7
23324,629,11662,W,98,91,7
23325,224,11663,L,98,111,-13
23326,223,11663,W,111,98,13
23327,949,11664,W,93,81,12
23328,950,11664,L,81,93,-12
23329,432,11665,W,111,92,19
23330,431,11665,L,92,111,-19
23331,170,11666,L,114,119,-5
23332,169,11666,W,119,114,5
23333,886,11667,L,77,89,-12
23334,885,11667,W,89,77,12
23335,524,11668,L,83,88,-5
23336,523,11668,W,88,83,5
23337,31,11669,W,99,90,9
23338,32,11669,L,90,99,-9
23339,93,11670,L,82,110,-28
23340,94,11670,W,110,82,28
23341,682,11671,W,107,97,10
23342,681,11671,L,97,107,-10
23343,792,11672,L,101,111,-10
23344,791,11672,W,111,101,10
23345,181,11673,W,116,98,18
23346,182,11673,L,98,116,-18
23347,307,11674,W,123,107,16
23348,308,11674,L,107,123,-16
23349,349,11675,W,108,91,17
23350,350,11675,L,91,108,-17
23351,186,11676,W,104,98,6
23352,185,11676,L,98,104,-6
23353,32,11677,L,90,104,-14
23354,31,11677,W,104,90,14
23355,994,11678,L,116,120,-4
23356,993,11678,W,120,116,4
23357,884,11679,L,97,98,-1
23358,883,11679,W,98,97,1
23359,152,11680,L,97,108,-11
23360,151,11680,W,108,97,11
23361,663,11681,L,91,110,-19
23362,664,11681,W,110,91,19
23363,959,11682,L,91,95,-4
23364,960,11682,W,95,91,4
23365,65,11683,W,106,100,6
23366,66,11683,L,100,106,-6
23367,427,11684,L,82,85,-3
23368,428,11684,W,85,82,3
23369,828,11685,L,114,115,-1
23370,827,11685,W,115,114,1
23371,53,11686,L,113,116,-3
23372,54,11686,W,116,113,3
23373,447,11687,L,90,102,-12
23374,448,11687,W,102,90,12
23375,1023,11688,W,112,87,25
23376,1024,11688,L,87,112,-25
23377,894,11689,L,86,87,-1
23378,893,11689,W,87,86,1
23379,514,11690,W,97,85,12
23380,513,11690,L,85,97,-12
23381,409,11691,W,100,95,5
23382,410,11691,L,95,100,-5
23383,535,11692,L,106,113,-7
23384,536,11692,W,113,106,7
23385,41,11693,L,100,107,-7
23386,42,11693,W,107,100,7
23387,534,11694,W,100,92,8
23388,533,11694,L,92,100,-8
23389,935,11695,L,84,102,-18
23390,936,11695,W,102,84,18
23391,493,11696,W,99,83,16
23392,494,11696,L,83,99,-16
23393,109,11697,L,104,111,-7
23394,110,11697,W,111,104,7
23395,117,11698,W,91,83,8
23396,118,11698,L,83,91,-8
23397,820,11699,L,119,125,-6
23398,819,11699,W,125,119,6
23399,477,11700,W,85,82,3
23400,478,11700,L,82,85,-3
23401,342,11701,W,114,111,3
23402,341,11701,L,111,114,-3
23403,385,11702,L,104,114,-10
23404,386,11702,W,114,104,10
23405,629,11703,L,90,99,-9
23406,630,11703,W,99,90,9
23407,791,11704,L,88,100,-12
23408,792,11704,W,100,88,12
23409,1017,11705,L,87,98,-11
23410,1018,11705,W,98,87,11
23411,776,11706,L,90,94,-4
23412,775,11706,W,94,90,4
23413,183,11707,W,94,77,17
23414,184,11707,L,77,94,-17
23415,920,11708,L,106,114,-8
23416,919,11708,W,114,106,8
23417,615,11709,W,95,87,8
23418,616,11709,L,87,95,-8
23419,799,11710,L,96,99,-3
23420,800,11710,W,99,96,3
23421,343,11711,L,100,138,-38
23422,344,11711,W,138,100,38
23423,594,11712,L,103,111,-8
23424,593,11712,W,111,103,8
23425,937,11713,W,106,100,6
23426,938,11713,L,100,106,-6
23427,557,11714,L,99,111,-12
23428,558,11714,W,111,99,12
23429,741,11715,W,110,93,17
23430,742,11715,L,93,110,-17
23431,533,11716,L,96,98,-2
23432,534,11716,W,98,96,2
23433,72,11717,L,91,97,-6
23434,71,11717,W,97,91,6
23435,67,11718,W,102,96,6
23436,68,11718,L,96,102,-6
23437,119,11719,L,104,112,-8
23438,120,11719,W,112,104,8
23439,879,11720,W,83,81,2
23440,880,11720,L,81,83,-2
23441,1021,11721,L,85,95,-10
23442,1022,11721,W,95,85,10
23443,706,11722,L,94,114,-20
23444,705,11722,W,114,94,20
23445,382,11723,L,96,104,-8
23446,381,11723,W,104,96,8
23447,939,11724,W,121,117,4
23448,940,11724,L,117,121,-4
23449,842,11725,W,100,94,6
23450,841,11725,L,94,100,-6
23451,1000,11726,W,98,94,4
23452,999,11726,L,94,98,-4
23453,535,11727,W,111,99,12
23454,536,11727,L,99,111,-12
23455,484,11728,L,112,131,-19
23456,483,11728,W,131,112,19
23457,509,11729,W,97,90,7
23458,510,11729,L,90,97,-7
23459,784,11730,L,119,127,-8
23460,783,11730,W,127,119,8
23461,51,11731,L,94,106,-12
23462,52,11731,W,106,94,12
23463,220,11732,L,112,115,-3
23464,219,11732,W,115,112,3
23465,23,11733,W,90,87,3
23466,24,11733,L,87,90,-3
23467,445,11734,L,100,105,-5
23468,446,11734,W,105,100,5
23469,901,11735,W,111,88,23
23470,902,11735,L,88,111,-23
23471,363,11736,L,106,114,-8
23472,364,11736,W,114,106,8
23473,102,11737,W,114,81,33
23474,101,11737,L,81,114,-33
23475,503,11738,L,137,139,-2
23476,504,11738,W,139,137,2
23477,351,11739,L,76,111,-35
23478,352,11739,W,111,76,35
23479,597,11740,L,92,132,-40
23480,598,11740,W,132,92,40
23481,216,11741,L,85,103,-18
23482,215,11741,W,103,85,18
23483,811,11742,W,96,86,10
23484,812,11742,L,86,96,-10
23485,721,11743,L,96,111,-15
23486,722,11743,W,111,96,15
23487,1011,11744,W,102,98,4
23488,1012,11744,L,98,102,-4
23489,795,11745,W,97,86,11
23490,796,11745,L,86,97,-11
23491,150,11746,L,90,123,-33
23492,149,11746,W,123,90,33
23493,1002,11747,L,92,98,-6
23494,1001,11747,W,98,92,6
23495,223,11748,W,108,99,9
23496,224,11748,L,99,108,-9
23497,652,11749,L,73,101,-28
23498,651,11749,W,101,73,28
23499,462,11750,L,108,110,-2
23500,461,11750,W,110,108,2
23501,643,11751,W,95,93,2
23502,644,11751,L,93,95,-2
23503,45,11752,L,80,84,-4
23504,46,11752,W,84,80,4
23505,554,11753,W,127,95,32
23506,553,11753,L,95,127,-32
23507,43,11754,L,96,104,-8
23508,44,11754,W,104,96,8
23509,68,11755,L,95,100,-5
23510,67,11755,W,100,95,5
23511,809,11756,L,78,99,-21
23512,810,11756,W,99,78,21
23513,951,11757,W,89,85,4
23514,952,11757,L,85,89,-4
23515,518,11758,L,92,100,-8
23516,517,11758,W,100,92,8
23517,191,11759,L,101,110,-9
23518,192,11759,W,110,101,9
23519,256,11760,L,98,103,-5
23520,255,11760,W,103,98,5
23521,905,11761,L,98,109,-11
23522,906,11761,W,109,98,11
23523,76,11762,L,108,115,-7
23524,75,11762,W,115,108,7
23525,63,11763,L,98,106,-8
23526,64,11763,W,106,98,8
23527,341,11764,W,102,80,22
23528,342,11764,L,80,102,-22
23529,406,11765,L,77,93,-16
23530,405,11765,W,93,77,16
23531,278,11766,W,97,91,6
23532,277,11766,L,91,97,-6
23533,637,11767,L,107,116,-9
23534,638,11767,W,116,107,9
23535,479,11768,W,106,85,21
23536,480,11768,L,85,106,-21
23537,748,11769,L,82,85,-3
23538,747,11769,W,85,82,3
23539,296,11770,L,95,99,-4
23540,295,11770,W,99,95,4
23541,401,11771,L,97,108,-11
23542,402,11771,W,108,97,11
23543,903,11772,L,82,99,-17
23544,904,11772,W,99,82,17
23545,991,11773,L,95,110,-15
23546,992,11773,W,110,95,15
23547,1030,11774,W,84,73,11
23548,1029,11774,L,73,84,-11
23549,832,11775,L,70,111,-41
23550,831,11775,W,111,70,41
23551,573,11776,L,99,120,-21
23552,574,11776,W,120,99,21
23553,565,11777,L,93,107,-14
23554,566,11777,W,107,93,14
23555,42,11778,L,80,92,-12
23556,41,11778,W,92,80,12
23557,651,11779,W,112,106,6
23558,652,11779,L,106,112,-6
23559,693,11780,W,102,87,15
23560,694,11780,L,87,102,-15
23561,391,11781,W,104,94,10
23562,392,11781,L,94,104,-10
23563,938,11782,L,95,100,-5
23564,937,11782,W,100,95,5
23565,137,11783,W,93,89,4
23566,138,11783,L,89,93,-4
23567,168,11784,W,96,85,11
23568,167,11784,L,85,96,-11
23569,861,11785,W,97,93,4
23570,862,11785,L,93,97,-4
23571,890,11786,L,78,94,-16
23572,889,11786,W,94,78,16
23573,79,11787,L,104,119,-15
23574,80,11787,W,119,104,15
23575,10,11788,L,79,98,-19
23576,9,11788,W,98,79,19
23577,107,11789,L,117,119,-2
23578,108,11789,W,119,117,2
23579,174,11790,L,101,104,-3
23580,173,11790,W,104,101,3
23581,735,11791,L,85,110,-25
23582,736,11791,W,110,85,25
23583,530,11792,L,93,95,-2
23584,529,11792,W,95,93,2
23585,806,11793,L,107,112,-5
23586,805,11793,W,112,107,5
23587,947,11794,W,114,103,11
23588,948,11794,L,103,114,-11
23589,444,11795,L,82,105,-23
23590,443,11795,W,105,82,23
23591,436,11796,L,119,129,-10
23592,435,11796,W,129,119,10
23593,620,11797,L,80,110,-30
23594,619,11797,W,110,80,30
23595,997,11798,L,79,88,-9
23596,998,11798,W,88,79,9
23597,188,11799,W,116,89,27
23598,187,11799,L,89,116,-27
23599,645,11800,L,84,97,-13
23600,646,11800,W,97,84,13
23601,924,11801,W,95,90,5
23602,923,11801,L,90,95,-5
23603,540,11802,W,95,75,20
23604,539,11802,L,75,95,-20
23605,108,11803,W,106,93,13
23606,107,11803,L,93,106,-13
23607,99,11804,L,56,87,-31
23608,100,11804,W,87,56,31
23609,677,11805,W,111,88,23
23610,678,11805,L,88,111,-23
23611,714,11806,L,77,100,-23
23612,713,11806,W,100,77,23
23613,439,11807,L,101,131,-30
23614,440,11807,W,131,101,30
23615,397,11808,L,82,91,-9
23616,398,11808,W,91,82,9
23617,711,11809,L,100,118,-18
23618,712,11809,W,118,100,18
23619,170,11810,W,115,107,8
23620,169,11810,L,107,115,-8
23621,94,11811,W,96,91,5
23622,93,11811,L,91,96,-5
23623,465,11812,L,74,102,-28
23624,466,11812,W,102,74,28
23625,783,11813,W,122,101,21
23626,784,11813,L,101,122,-21
23627,934,11814,L,103,115,-12
23628,933,11814,W,115,103,12
23629,754,11815,L,85,118,-33
23630,753,11815,W,118,85,33
23631,623,11816,L,120,123,-3
23632,624,11816,W,123,120,3
23633,80,11817,L,101,122,-21
23634,79,11817,W,122,101,21
23635,101,11818,L,76,94,-18
23636,102,11818,W,94,76,18
23637,891,11819,L,92,97,-5
23638,892,11819,W,97,92,5
23639,1025,11820,L,98,102,-4
23640,1026,11820,W,102,98,4
23641,261,11821,L,103,108,-5
23642,262,11821,W,108,103,5
23643,453,11822,L,98,108,-10
23644,454,11822,W,108,98,10
23645,143,11823,L,86,89,-3
23646,144,11823,W,89,86,3
23647,356,11824,L,94,104,-10
23648,355,11824,W,104,94,10
23649,840,11825,L,109,127,-18
23650,839,11825,W,127,109,18
23651,123,11826,L,88,94,-6
23652,124,11826,W,94,88,6
23653,519,11827,W,116,97,19
23654,520,11827,L,97,116,-19
23655,930,11828,L,92,93,-1
23656,929,11828,W,93,92,1
23657,246,11829,W,106,102,4
23658,245,11829,L,102,106,-4
23659,731,11830,L,104,111,-7
23660,732,11830,W,111,104,7
23661,1010,11831,L,90,94,-4
23662,1009,11831,W,94,90,4
23663,763,11832,L,90,110,-20
23664,764,11832,W,110,90,20
23665,574,11833,W,110,108,2
23666,573,11833,L,108,110,-2
23667,636,11834,L,75,101,-26
23668,635,11834,W,101,75,26
23669,294,11835,W,96,94,2
23670,293,11835,L,94,96,-2
23671,873,11836,W,101,84,17
23672,874,11836,L,84,101,-17
23673,691,11837,W,110,105,5
23674,692,11837,L,105,110,-5
23675,489,11838,W,108,103,5
23676,490,11838,L,103,108,-5
23677,529,11839,L,110,113,-3
23678,530,11839,W,113,110,3
23679,757,11840,W,101,87,14
23680,758,11840,L,87,101,-14
23681,512,11841,W,105,96,9
23682,511,11841,L,96,105,-9
23683,249,11842,W,110,100,10
23684,250,11842,L,100,110,-10
23685,563,11843,W,95,85,10
23686,564,11843,L,85,95,-10
23687,175,11844,W,95,76,19
23688,176,11844,L,76,95,-19
23689,381,11845,W,108,105,3
23690,382,11845,L,105,108,-3
23691,8,11846,W,123,101,22
23692,7,11846,L,101,123,-22
23693,347,11847,L,109,131,-22
23694,348,11847,W,131,109,22
23695,373,11848,W,89,85,4
23696,374,11848,L,85,89,-4
23697,207,11849,L,101,107,-6
23698,208,11849,W,107,101,6
23699,921,11850,W,92,87,5
23700,922,11850,L,87,92,-5
23701,968,11851,L,77,85,-8
23702,967,11851,W,85,77,8
23703,100,11852,W,89,83,6
23704,99,11852,L,83,89,-6
23705,787,11853,W,87,86,1
23706,788,11853,L,86,87,-1
23707,944,11854,W,96,81,15
23708,943,11854,L,81,96,-15
23709,15,11855,W,99,83,16
23710,16,11855,L,83,99,-16
23711,324,11856,L,117,125,-8
23712,323,11856,W,125,117,8
23713,618,11857,L,102,113,-11
23714,617,11857,W,113,102,11
23715,182,11858,L,118,122,-4
23716,181,11858,W,122,118,4
23717,271,11859,W,92,79,13
23718,272,11859,L,79,92,-13
23719,333,11860,W,104,103,1
23720,334,11860,L,103,104,-1
23721,892,11861,L,69,93,-24
23722,891,11861,W,93,69,24
23723,88,11862,L,94,100,-6
23724,87,11862,W,100,94,6
23725,838,11863,L,96,103,-7
23726,837,11863,W,103,96,7
23727,165,11864,L,95,112,-17
23728,166,11864,W,112,95,17
23729,988,11865,L,136,137,-1
23730,987,11865,W,137,136,1
23731,627,11866,L,102,109,-7
23732,628,11866,W,109,102,7
23733,311,11867,L,108,116,-8
23734,312,11867,W,116,108,8
23735,737,11868,W,89,81,8
23736,738,11868,L,81,89,-8
23737,853,11869,L,100,111,-11
23738,854,11869,W,111,100,11
23739,310,11870,W,102,88,14
23740,309,11870,L,88,102,-14
23741,600,11871,W,111,104,7
23742,599,11871,L,104,111,-7
23743,567,11872,L,103,107,-4
23744,568,11872,W,107,103,4
23745,30,11873,W,119,115,4
23746,29,11873,L,115,119,-4
23747,988,11874,L,103,116,-13
23748,987,11874,W,116,103,13
23749,619,11875,L,95,125,-30
23750,620,11875,W,125,95,30
23751,950,11876,W,98,91,7
23752,949,11876,L,91,98,-7
23753,917,11877,L,84,92,-8
23754,918,11877,W,92,84,8
23755,136,11878,W,103,101,2
23756,135,11878,L,101,103,-2
23757,116,11879,W,99,96,3
23758,115,11879,L,96,99,-3
23759,346,11880,L,103,106,-3
23760,345,11880,W,106,103,3
23761,898,11881,L,80,120,-40
23762,897,11881,W,120,80,40
23763,112,11882,W,116,105,11
23764,111,11882,L,105,116,-11
23765,625,11883,L,103,115,-12
23766,626,11883,W,115,103,12
23767,102,11884,L,80,83,-3
23768,101,11884,W,83,80,3
23769,386,11885,W,106,102,4
23770,385,11885,L,102,106,-4
23771,316,11886,W,107,102,5
23772,315,11886,L,102,107,-5
23773,301,11887,W,109,99,10
23774,302,11887,L,99,109,-10
23775,801,11888,L,89,113,-24
23776,802,11888,W,113,89,24
23777,979,11889,L,88,107,-19
23778,980,11889,W,107,88,19
23779,668,11890,W,101,93,8
23780,667,11890,L,93,101,-8
23781,64,11891,W,90,79,11
23782,63,11891,L,79,90,-11
23783,596,11892,L,100,109,-9
23784,595,11892,W,109,100,9
23785,73,11893,W,103,87,16
23786,74,11893,L,87,103,-16
23787,969,11894,L,90,96,-6
23788,970,11894,W,96,90,6
23789,536,11895,L,110,116,-6
23790,535,11895,W,116,110,6
23791,109,11896,L,93,109,-16
23792,110,11896,W,109,93,16
23793,486,11897,L,90,92,-2
23794,485,11897,W,92,90,2
23795,470,11898,L,99,105,-6
23796,469,11898,W,105,99,6
23797,1042,11899,W,104,103,1
23798,1041,11899,L,103,104,-1
23799,694,11900,L,90,100,-10
23800,693,11900,W,100,90,10
23801,336,11901,W,107,102,5
23802,335,11901,L,102,107,-5
23803,9,11902,W,105,77,28
23804,10,11902,L,77,105,-28
23805,398,11903,W,90,83,7
23806,397,11903,L,83,90,-7
23807,886,11904,L,86,100,-14
23808,885,11904,W,100,86,14
23809,212,11905,W,110,108,2
23810,211,11905,L,108,110,-2
23811,713,11906,L,123,126,-3
23812,714,11906,W,126,123,3
23813,110,11907,L,88,95,-7
23814,109,11907,W,95,88,7
23815,69,11908,W,95,91,4
23816,70,11908,L,91,95,-4
23817,973,11909,W,91,89,2
23818,974,11909,L,89,91,-2
23819,218,11910,W,90,87,3
23820,217,11910,L,87,90,-3
23821,739,11911,W,114,96,18
23822,740,11911,L,96,114,-18
23823,666,11912,W,91,86,5
23824,665,11912,L,86,91,-5
23825,321,11913,L,116,120,-4
23826,322,11913,W,120,116,4
23827,1024,11914,L,108,123,-15
23828,1023,11914,W,123,108,15
23829,490,11915,W,99,92,7
23830,489,11915,L,92,99,-7
23831,407,11916,L,92,120,-28
23832,408,11916,W,120,92,28
23833,525,11917,W,105,99,6
23834,526,11917,L,99,105,-6
23835,615,11918,W,83,75,8
23836,616,11918,L,75,83,-8
23837,953,11919,W,95,81,14
23838,954,11919,L,81,95,-14
23839,119,11920,L,95,108,-13
23840,120,11920,W,108,95,13
23841,36,11921,L,88,111,-23
23842,35,11921,W,111,88,23
23843,614,11922,W,95,84,11
23844,613,11922,L,84,95,-11
23845,926,11923,L,98,110,-12
23846,925,11923,W,110,98,12
23847,308,11924,L,113,121,-8
23848,307,11924,W,121,113,8
23849,808,11925,W,95,79,16
23850,807,11925,L,79,95,-16
23851,265,11926,L,94,110,-16
23852,266,11926,W,110,94,16
23853,1034,11927,L,96,106,-10
23854,1033,11927,W,106,96,10
23855,210,11928,L,106,107,-1
23856,209,11928,W,107,106,1
23857,364,11929,W,110,92,18
23858,363,11929,L,92,110,-18
23859,29,11930,L,109,115,-6
23860,30,11930,W,115,109,6
23861,788,11931,L,89,93,-4
23862,787,11931,W,93,89,4
23863,794,11932,L,75,89,-14
23864,793,11932,W,89,75,14
23865,184,11933,L,99,118,-19
23866,183,11933,W,118,99,19
23867,931,11934,L,87,98,-11
23868,932,11934,W,98,87,11
23869,559,11935,L,113,118,-5
23870,560,11935,W,118,113,5
23871,650,11936,L,97,105,-8
23872,649,11936,W,105,97,8
23873,773,11937,W,124,119,5
23874,774,11937,L,119,124,-5
23875,686,11938,W,104,95,9
23876,685,11938,L,95,104,-9
23877,245,11939,W,111,105,6
23878,246,11939,L,105,111,-6
23879,67,11940,L,108,114,-6
23880,68,11940,W,114,108,6
23881,46,11941,W,106,101,5
23882,45,11941,L,101,106,-5
23883,105,11942,L,94,117,-23
23884,106,11942,W,117,94,23
23885,458,11943,L,105,109,-4
23886,457,11943,W,109,105,4
23887,792,11944,L,101,102,-1
23888,791,11944,W,102,101,1
23889,568,11945,W,115,93,22
23890,567,11945,L,93,115,-22
23891,758,11946,L,80,104,-24
23892,757,11946,W,104,80,24
23893,237,11947,W,113,96,17
23894,238,11947,L,96,113,-17
23895,760,11948,W,108,100,8
23896,759,11948,L,100,108,-8
23897,578,11949,L,107,120,-13
23898,577,11949,W,120,107,13
23899,717,11950,L,88,94,-6
23900,718,11950,W,94,88,6
23901,528,11951,L,97,117,-20
23902,527,11951,W,117,97,20
23903,923,11952,L,101,114,-13
23904,924,11952,W,114,101,13
23905,148,11953,L,88,111,-23
23906,147,11953,W,111,88,23
23907,583,11954,L,99,109,-10
23908,584,11954,W,109,99,10
23909,117,11955,W,112,106,6
23910,118,11955,L,106,112,-6
23911,608,11956,W,107,100,7
23912,607,11956,L,100,107,-7
23913,222,11957,L,100,116,-16
23914,221,11957,W,116,100,16
23915,960,11958,L,96,103,-7
23916,959,11958,W,103,96,7
23917,290,11959,W,94,87,7
23918,289,11959,L,87,94,-7
23919,58,11960,L,76,101,-25
23920,57,11960,W,101,76,25
23921,232,11961,W,103,95,8
23922,231,11961,L,95,103,-8
23923,272,11962,L,90,102,-12
23924,271,11962,W,102,90,12
23925,38,11963,W,98,90,8
23926,37,11963,L,90,98,-8
23927,791,11964,L,109,115,-6
23928,792,11964,W,115,109,6
23929,998,11965,L,80,94,-14
23930,997,11965,W,94,80,14
23931,151,11966,W,114,105,9
23932,152,11966,L,105,114,-9
23933,658,11967,L,99,104,-5
23934,657,11967,W,104,99,5
23935,532,11968,L,91,102,-11
23936,531,11968,W,102,91,11
23937,2,11969,L,101,102,-1
23938,1,11969,W,102,101,1
23939,941,11970,L,89,102,-13
23940,942,11970,W,102,89,13
23941,874,11971,L,94,106,-12
23942,873,11971,W,106,94,12
23943,140,11972,W,110,103,7
23944,139,11972,L,103,110,-7
23945,425,11973,L,96,126,-30
23946,426,11973,W,126,96,30
23947,1033,11974,W,102,85,17
23948,1034,11974,L,85,102,-17
23949,50,11975,L,102,121,-19
23950,49,11975,W,121,102,19
23951,44,11976,W,94,79,15
23952,43,11976,L,79,94,-15
23953,789,11977,L,78,102,-24
23954,790,11977,W,102,78,24
23955,679,11978,W,95,81,14
23956,680,11978,L,81,95,-14
23957,918,11979,L,89,109,-20
23958,917,11979,W,109,89,20
23959,775,11980,L,93,98,-5
23960,776,11980,W,98,93,5
23961,452,11981,W,105,100,5
23962,451,11981,L,100,105,-5
23963,54,11982,W,113,108,5
23964,53,11982,L,108,113,-5
23965,646,11983,L,75,89,-14
23966,645,11983,W,89,75,14
23967,126,11984,L,82,85,-3
23968,125,11984,W,85,82,3
23969,827,11985,L,94,100,-6
23970,828,11985,W,100,94,6
23971,472,11986,W,115,100,15
23972,471,11986,L,100,115,-15
23973,577,11987,L,108,116,-8
23974,578,11987,W,116,108,8
23975,359,11988,W,103,97,6
23976,360,11988,L,97,103,-6
23977,260,11989,W,106,102,4
23978,259,11989,L,102,106,-4
23979,875,11990,W,88,86,2
23980,876,11990,L,86,88,-2
23981,426,11991,W,99,97,2
23982,425,11991,L,97,99,-2
23983,835,11992,W,118,94,24
23984,836,11992,L,94,118,-24
23985,967,11993,W,97,88,9
23986,968,11993,L,88,97,-9
23987,993,11994,W,105,95,10
23988,994,11994,L,95,105,-10
23989,854,11995,W,107,87,20
23990,853,11995,L,87,107,-20
23991,517,11996,L,119,126,-7
23992,518,11996,W,126,119,7
23993,609,11997,W,113,96,17
23994,610,11997,L,96,113,-17
23995,635,11998,L,105,116,-11
23996,636,11998,W,116,105,11
23997,689,11999,W,102,96,6
23998,690,11999,L,96,102,-6
23999,161,12000,L,86,89,-3
24000,162,12000,W,89,86,3
24001,1016,12001,W,94,89,5
24002,1015,12001,L,89,94,-5
24003,235,12002,L,71,77,-6
24004,236,12002,W,77,71,6
24005,842,12003,W,106,92,14
24006,841,12003,L,92,106,-14
24007,962,12004,W,99,93,6
24008,961,12004,L,93,99,-6
24009,1,12005,W,95,83,12
24010,2,12005,L,83,95,-12
24011,268,12006,L,120,121,-1
24012,267,12006,W,121,120,1
24013,401,12007,L,88,112,-24
24014,402,12007,W,112,88,24
24015,456,12008,W,92,86,6
24016,455,12008,L,86,92,-6
24017,82,12009,W,111,100,11
24018,81,12009,L,100,111,-11
24019,902,12010,L,103,104,-1
24020,901,12010,W,104,103,1
24021,370,12011,L,114,116,-2
24022,369,12011,W,116,114,2
24023,712,12012,W,91,86,5
24024,711,12012,L,86,91,-5
24025,698,12013,W,116,108,8
24026,697,12013,L,108,116,-8
24027,1019,12014,L,101,103,-2
24028,1020,12014,W,103,101,2
24029,72,12015,W,103,94,9
24030,71,12015,L,94,103,-9
24031,221,12016,W,102,100,2
24032,222,12016,L,100,102,-2
24033,175,12017,L,85,100,-15
24034,176,12017,W,100,85,15
24035,4,12018,W,99,95,4
24036,3,12018,L,95,99,-4
24037,185,12019,L,74,92,-18
24038,186,12019,W,92,74,18
24039,446,12020,W,117,83,34
24040,445,12020,L,83,117,-34
24041,589,12021,L,85,101,-16
24042,590,12021,W,101,85,16
24043,139,12022,L,112,117,-5
24044,140,12022,W,117,112,5
24045,287,12023,W,112,108,4
24046,288,12023,L,108,112,-4
24047,732,12024,W,100,89,11
24048,731,12024,L,89,100,-11
24049,208,12025,W,105,101,4
24050,207,12025,L,101,105,-4
24051,880,12026,L,89,94,-5
24052,879,12026,W,94,89,5
24053,954,12027,W,104,92,12
24054,953,12027,L,92,104,-12
24055,402,12028,W,104,92,12
24056,401,12028,L,92,104,-12
24057,49,12029,W,108,103,5
24058,50,12029,L,103,108,-5
24059,403,12030,W,93,84,9
24060,404,12030,L,84,93,-9
24061,833,12031,L,96,99,-3
24062,834,12031,W,99,96,3
24063,628,12032,W,107,104,3
24064,627,12032,L,104,107,-3
24065,815,12033,L,103,109,-6
24066,816,12033,W,109,103,6
24067,542,12034,L,79,97,-18
24068,541,12034,W,97,79,18
24069,195,12035,L,80,91,-11
24070,196,12035,W,91,80,11
24071,83,12036,L,103,117,-14
24072,84,12036,W,117,103,14
24073,1011,12037,W,105,86,19
24074,1012,12037,L,86,105,-19
24075,460,12038,W,113,100,13
24076,459,12038,L,100,113,-13
24077,831,12039,W,111,105,6
24078,832,12039,L,105,111,-6
24079,486,12040,W,89,78,11
24080,485,12040,L,78,89,-11
24081,52,12041,W,121,105,16
24082,51,12041,L,105,121,-16
24083,936,12042,W,101,95,6
24084,935,12042,L,95,101,-6
24085,325,12043,W,99,92,7
24086,326,12043,L,92,99,-7
24087,911,12044,W,101,92,9
24088,912,12044,L,92,101,-9
24089,433,12045,L,93,95,-2
24090,434,12045,W,95,93,2
24091,62,12046,L,90,101,-11
24092,61,12046,W,101,90,11
24093,135,12047,W,113,106,7
24094,136,12047,L,106,113,-7
24095,605,12048,L,100,101,-1
24096,606,12048,W,101,100,1
24097,871,12049,W,109,97,12
24098,872,12049,L,97,109,-12
24099,631,12050,L,105,112,-7
24100,632,12050,W,112,105,7
24101,181,12051,W,111,107,4
24102,182,12051,L,107,111,-4
24103,84,12052,L,98,100,-2
24104,83,12052,W,100,98,2
24105,262,12053,W,113,100,13
24106,261,12053,L,100,113,-13
24107,746,12054,W,101,97,4
24108,745,12054,L,97,101,-4
24109,507,12055,L,100,111,-11
24110,508,12055,W,111,100,11
24111,57,12056,W,110,92,18
24112,58,12056,L,92,110,-18
24113,1035,12057,L,82,92,-10
24114,1036,12057,W,92,82,10
24115,423,12058,L,87,100,-13
24116,424,12058,W,100,87,13
24117,16,12059,W,89,88,1
24118,15,12059,L,88,89,-1
24119,115,12060,W,104,100,4
24120,116,12060,L,100,104,-4
24121,96,12061,L,94,100,-6
24122,95,12061,W,100,94,6
24123,839,12062,W,113,97,16
24124,840,12062,L,97,113,-16
24125,580,12063,L,87,100,-13
24126,579,12063,W,100,87,13
24127,461,12064,W,97,96,1
24128,462,12064,L,96,97,-1
24129,12,12065,W,117,112,5
24130,11,12065,L,112,117,-5
24131,989,12066,W,106,92,14
24132,990,12066,L,92,106,-14
24133,762,12067,W,106,88,18
24134,761,12067,L,88,106,-18
24135,686,12068,W,102,84,18
24136,685,12068,L,84,102,-18
24137,910,12069,W,97,87,10
24138,909,12069,L,87,97,-10
24139,309,12070,L,77,92,-15
24140,310,12070,W,92,77,15
24141,209,12071,L,90,109,-19
24142,210,12071,W,109,90,19
24143,965,12072,L,93,104,-11
24144,966,12072,W,104,93,11
24145,956,12073,L,89,97,-8
24146,955,12073,W,97,89,8
24147,533,12074,L,86,99,-13
24148,534,12074,W,99,86,13
24149,129,12075,L,106,114,-8
24150,130,12075,W,114,106,8
24151,826,12076,W,95,90,5
24152,825,12076,L,90,95,-5
24153,790,12077,L,98,105,-7
24154,789,12077,W,105,98,7
24155,927,12078,L,78,83,-5
24156,928,12078,W,83,78,5
24157,526,12079,L,92,102,-10
24158,525,12079,W,102,92,10
24159,454,12080,L,93,104,-11
24160,453,12080,W,104,93,11
24161,281,12081,L,97,100,-3
24162,282,12081,W,100,97,3
24163,1044,12082,L,99,115,-16
24164,1043,12082,W,115,99,16
24165,448,12083,L,90,117,-27
24166,447,12083,W,117,90,27
24167,167,12084,W,108,103,5
24168,168,12084,L,103,108,-5
24169,295,12085,L,106,124,-18
24170,296,12085,W,124,106,18
24171,777,12086,L,99,110,-11
24172,778,12086,W,110,99,11
24173,937,12087,L,102,104,-2
24174,938,12087,W,104,102,2
24175,455,12088,W,109,96,13
24176,456,12088,L,96,109,-13
24177,796,12089,L,87,103,-16
24178,795,12089,W,103,87,16
24179,607,12090,L,81,96,-15
24180,608,12090,W,96,81,15
24181,464,12091,L,91,102,-11
24182,463,12091,W,102,91,11
24183,516,12092,L,93,107,-14
24184,515,12092,W,107,93,14
24185,169,12093,L,95,108,-13
24186,170,12093,W,108,95,13
24187,922,12094,L,88,103,-15
24188,921,12094,W,103,88,15
24189,75,12095,L,89,110,-21
24190,76,12095,W,110,89,21
24191,933,12096,L,96,102,-6
24192,934,12096,W,102,96,6
24193,991,12097,L,81,91,-10
24194,992,12097,W,91,81,10
24195,508,12098,L,87,103,-16
24196,507,12098,W,103,87,16
24197,531,12099,W,99,94,5
24198,532,12099,L,94,99,-5
24199,187,12100,L,117,124,-7
24200,188,12100,W,124,117,7
24201,1012,12101,L,92,124,-32
24202,1011,12101,W,124,92,32
24203,186,12102,W,116,110,6
24204,185,12102,L,110,116,-6
24205,913,12103,W,121,113,8
24206,914,12103,L,113,121,-8
24207,79,12104,L,100,108,-8
24208,80,12104,W,108,100,8
24209,319,12105,W,117,103,14
24210,320,12105,L,103,117,-14
24211,738,12106,L,90,99,-9
24212,737,12106,W,99,90,9
24213,159,12107,W,100,95,5
24214,160,12107,L,95,100,-5
24215,841,12108,L,87,88,-1
24216,842,12108,W,88,87,1
24217,626,12109,L,71,88,-17
24218,625,12109,W,88,71,17
24219,271,12110,L,102,111,-9
24220,272,12110,W,111,102,9
24221,259,12111,L,106,111,-5
24222,260,12111,W,111,106,5
24223,665,12112,L,88,93,-5
24224,666,12112,W,93,88,5
24225,248,12113,W,88,78,10
24226,247,12113,L,78,88,-10
24227,941,12114,W,112,103,9
24228,942,12114,L,103,112,-9
24229,225,12115,W,111,96,15
24230,226,12115,L,96,111,-15
24231,915,12116,W,114,107,7
24232,916,12116,L,107,114,-7
24233,345,12117,L,83,96,-13
24234,346,12117,W,96,83,13
24235,440,12118,W,109,100,9
24236,439,12118,L,100,109,-9
24237,157,12119,W,112,105,7
24238,158,12119,L,105,112,-7
24239,1031,12120,L,88,93,-5
24240,1032,12120,W,93,88,5
24241,736,12121,L,90,98,-8
24242,735,12121,W,98,90,8
24243,593,12122,W,118,117,1
24244,594,12122,L,117,118,-1
24245,40,12123,W,107,94,13
24246,39,12123,L,94,107,-13
24247,230,12124,L,91,120,-29
24248,229,12124,W,120,91,29
24249,705,12125,W,120,109,11
24250,706,12125,L,109,120,-11
24251,66,12126,L,105,112,-7
24252,65,12126,W,112,105,7
24253,925,12127,W,94,89,5
24254,926,12127,L,89,94,-5
24255,354,12128,L,95,112,-17
24256,353,12128,W,112,95,17
24257,491,12129,W,103,96,7
24258,492,12129,L,96,103,-7
24259,616,12130,L,83,92,-9
24260,615,12130,W,92,83,9
24261,280,12131,L,106,115,-9
24262,279,12131,W,115,106,9
24263,999,12132,L,101,103,-2
24264,1000,12132,W,103,101,2
24265,171,12133,L,95,105,-10
24266,172,12133,W,105,95,10
24267,315,12134,W,96,81,15
24268,316,12134,L,81,96,-15
24269,189,12135,W,100,98,2
24270,190,12135,L,98,100,-2
24271,288,12136,W,129,125,4
24272,287,12136,L,125,129,-4
24273,966,12137,L,89,91,-2
24274,965,12137,W,91,89,2
24275,722,12138,W,113,102,11
24276,721,12138,L,102,113,-11
24277,621,12139,L,107,121,-14
24278,622,12139,W,121,107,14
24279,156,12140,L,83,85,-2
24280,155,12140,W,85,83,2
24281,876,12141,W,103,87,16
24282,875,12141,L,87,103,-16
24283,976,12142,L,72,96,-24
24284,975,12142,W,96,72,24
24285,313,12143,W,118,104,14
24286,314,12143,L,104,118,-14
24287,276,12144,L,109,113,-4
24288,275,12144,W,113,109,4
24289,424,12145,L,92,97,-5
24290,423,12145,W,97,92,5
24291,162,12146,W,94,81,13
24292,161,12146,L,81,94,-13
24293,805,12147,L,85,96,-11
24294,806,12147,W,96,85,11
24295,330,12148,L,98,101,-3
24296,329,12148,W,101,98,3
24297,1028,12149,W,87,86,1
24298,1027,12149,L,86,87,-1
24299,231,12150,L,103,120,-17
24300,232,12150,W,120,103,17
24301,414,12151,L,74,75,-1
24302,413,12151,W,75,74,1
24303,273,12152,L,79,92,-13
24304,274,12152,W,92,79,13
24305,971,12153,W,100,59,41
24306,972,12153,L,59,100,-41
24307,128,12154,W,107,97,10
24308,127,12154,L,97,107,-10
24309,257,12155,W,109,91,18
24310,258,12155,L,91,109,-18
24311,830,12156,L,92,101,-9
24312,829,12156,W,101,92,9
24313,213,12157,L,72,112,-40
24314,214,12157,W,112,72,40
24315,434,12158,L,110,115,-5
24316,433,12158,W,115,110,5
24317,1036,12159,L,74,89,-15
24318,1035,12159,W,89,74,15
24319,435,12160,L,112,119,-7
24320,436,12160,W,119,112,7
24321,335,12161,L,86,110,-24
24322,336,12161,W,110,86,24
24323,764,12162,W,102,88,14
24324,763,12162,L,88,102,-14
24325,379,12163,L,77,82,-5
24326,380,12163,W,82,77,5
24327,18,12164,L,93,108,-15
24328,17,12164,W,108,93,15
24329,877,12165,L,97,100,-3
24330,878,12165,W,100,97,3
24331,3,12166,L,98,99,-1
24332,4,12166,W,99,98,1
24333,176,12167,L,87,100,-13
24334,175,12167,W,100,87,13
24335,372,12168,L,89,104,-15
24336,371,12168,W,104,89,15
24337,81,12169,L,95,104,-9
24338,82,12169,W,104,95,9
24339,1013,12170,L,95,103,-8
24340,1014,12170,W,103,95,8
24341,37,12171,L,111,126,-15
24342,38,12171,W,126,111,15
24343,641,12172,L,82,86,-4
24344,642,12172,W,86,82,4
24345,94,12173,L,100,109,-9
24346,93,12173,W,109,100,9
24347,240,12174,L,107,112,-5
24348,239,12174,W,112,107,5
24349,949,12175,L,102,103,-1
24350,950,12175,W,103,102,1
24351,595,12176,L,108,110,-2
24352,596,12176,W,110,108,2
24353,316,12177,W,94,90,4
24354,315,12177,L,90,94,-4
24355,864,12178,W,106,98,8
24356,863,12178,L,98,106,-8
24357,874,12179,W,83,82,1
24358,873,12179,L,82,83,-1
24359,480,12180,W,93,89,4
24360,479,12180,L,89,93,-4
24361,1009,12181,L,100,109,-9
24362,1010,12181,W,109,100,9
24363,769,12182,L,89,103,-14
24364,770,12182,W,103,89,14
24365,639,12183,W,129,121,8
24366,640,12183,L,121,129,-8
24367,878,12184,L,92,96,-4
24368,877,12184,W,96,92,4
24369,680,12185,L,102,113,-11
24370,679,12185,W,113,102,11
24371,849,12186,L,98,100,-2
24372,850,12186,W,100,98,2
24373,410,12187,L,101,108,-7
24374,409,12187,W,108,101,7
24375,195,12188,L,106,109,-3
24376,196,12188,W,109,106,3
24377,800,12189,W,96,84,12
24378,799,12189,L,84,96,-12
24379,970,12190,L,81,85,-4
24380,969,12190,W,85,81,4
24381,241,12191,L,84,93,-9
24382,242,12191,W,93,84,9
24383,217,12192,L,94,101,-7
24384,218,12192,W,101,94,7
24385,782,12193,L,107,114,-7
24386,781,12193,W,114,107,7
24387,219,12194,L,97,110,-13
24388,220,12194,W,110,97,13
24389,120,12195,L,92,99,-7
24390,119,12195,W,99,92,7
24391,320,12196,L,99,127,-28
24392,319,12196,W,127,99,28
24393,390,12197,L,106,110,-4
24394,389,12197,W,110,106,4
24395,788,12198,L,96,99,-3
24396,787,12198,W,99,96,3
24397,638,12199,L,95,98,-3
24398,637,12199,W,98,95,3
24399,1003,12200,L,89,96,-7
24400,1004,12200,W,96,89,7
24401,683,12201,W,112,106,6
24402,684,12201,L,106,112,-6
24403,331,12202,W,108,99,9
24404,332,12202,L,99,108,-9
24405,981,12203,W,88,81,7
24406,982,12203,L,81,88,-7
24407,334,12204,L,70,89,-19
24408,333,12204,W,89,70,19
24409,1005,12205,L,88,100,-12
24410,1006,12205,W,100,88,12
24411,466,12206,L,94,95,-1
24412,465,12206,W,95,94,1
24413,275,12207,L,112,122,-10
24414,276,12207,W,122,112,10
24415,376,12208,L,99,121,-22
24416,375,12208,W,121,99,22
24417,974,12209,W,110,105,5
24418,973,12209,L,105,110,-5
24419,566,12210,W,101,95,6
24420,565,12210,L,95,101,-6
24421,879,12211,L,94,99,-5
24422,880,12211,W,99,94,5
24423,766,12212,W,93,83,10
24424,765,12212,L,83,93,-10
24425,76,12213,W,99,86,13
24426,75,12213,L,86,99,-13
24427,277,12214,L,89,101,-12
24428,278,12214,W,101,89,12
24429,284,12215,L,111,115,-4
24430,283,12215,W,115,111,4
24431,837,12216,L,97,109,-12
24432,838,12216,W,109,97,12
24433,35,12217,L,124,125,-1
24434,36,12217,W,125,124,1
24435,255,12218,L,102,130,-28
24436,256,12218,W,130,102,28
24437,696,12219,W,91,84,7
24438,695,12219,L,84,91,-7
24439,961,12220,L,89,92,-3
24440,962,12220,W,92,89,3
24441,421,12221,W,115,110,5
24442,422,12221,L,110,115,-5
24443,550,12222,W,107,99,8
24444,549,12222,L,99,107,-8
24445,312,12223,L,89,102,-13
24446,311,12223,W,102,89,13
24447,348,12224,L,125,131,-6
24448,347,12224,W,131,125,6
24449,541,12225,L,105,111,-6
24450,542,12225,W,111,105,6
24451,825,12226,L,95,119,-24
24452,826,12226,W,119,95,24
24453,873,12227,L,91,96,-5
24454,874,12227,W,96,91,5
24455,133,12228,W,118,112,6
24456,134,12228,L,112,118,-6
24457,579,12229,W,104,101,3
24458,580,12229,L,101,104,-3
24459,1041,12230,L,109,118,-9
24460,1042,12230,W,118,109,9
24461,818,12231,W,107,96,11
24462,817,12231,L,96,107,-11
24463,250,12232,W,111,103,8
24464,249,12232,L,103,111,-8
24465,362,12233,L,133,136,-3
24466,361,12233,W,136,133,3
24467,720,12234,W,100,86,14
24468,719,12234,L,86,100,-14
24469,520,12235,L,98,132,-34
24470,519,12235,W,132,98,34
24471,657,12236,L,57,112,-55
24472,658,12236,W,112,57,55
24473,670,12237,L,82,95,-13
24474,669,12237,W,95,82,13
24475,405,12238,W,108,102,6
24476,406,12238,L,102,108,-6
24477,900,12239,L,82,96,-14
24478,899,12239,W,96,82,14
24479,306,12240,L,112,118,-6
24480,305,12240,W,118,112,6
24481,817,12241,L,91,94,-3
24482,818,12241,W,94,91,3
24483,276,12242,L,91,105,-14
24484,275,12242,W,105,91,14
24485,948,12243,W,96,87,9
24486,947,12243,L,87,96,-9
24487,610,12244,L,87,109,-22
24488,609,12244,W,109,87,22
24489,511,12245,W,107,100,7
24490,512,12245,L,100,107,-7
24491,863,12246,L,100,108,-8
24492,864,12246,W,108,100,8
24493,654,12247,L,79,90,-11
24494,653,12247,W,90,79,11
24495,462,12248,W,103,99,4
24496,461,12248,L,99,103,-4
24497,266,12249,L,109,112,-3
24498,265,12249,W,112,109,3
24499,208,12250,L,100,109,-9
24500,207,12250,W,109,100,9
24501,882,12251,L,89,104,-15
24502,881,12251,W,104,89,15
24503,707,12252,L,93,108,-15
24504,708,12252,W,108,93,15
24505,474,12253,W,117,107,10
24506,473,12253,L,107,117,-10
24507,992,12254,W,115,92,23
24508,991,12254,L,92,115,-23
24509,679,12255,W,108,98,10
24510,680,12255,L,98,108,-10
24511,1002,12256,L,77,97,-20
24512,1001,12256,W,97,77,20
24513,314,12257,L,95,110,-15
24514,313,12257,W,110,95,15
24515,216,12258,L,99,110,-11
24516,215,12258,W,110,99,11
24517,378,12259,W,90,87,3
24518,377,12259,L,87,90,-3
24519,513,12260,L,99,105,-6
24520,514,12260,W,105,99,6
24521,640,12261,W,121,96,25
24522,639,12261,L,96,121,-25
24523,26,12262,W,101,95,6
24524,25,12262,L,95,101,-6
24525,132,12263,L,102,122,-20
24526,131,12263,W,122,102,20
24527,935,12264,L,97,101,-4
24528,936,12264,W,101,97,4
24529,564,12265,L,98,116,-18
24530,563,12265,W,116,98,18
24531,582,12266,W,99,95,4
24532,581,12266,L,95,99,-4
24533,31,12267,L,102,122,-20
24534,32,12267,W,122,102,20
24535,74,12268,W,103,100,3
24536,73,12268,L,100,103,-3
24537,744,12269,W,110,87,23
24538,743,12269,L,87,110,-23
24539,942,12270,W,110,103,7
24540,941,12270,L,103,110,-7
24541,681,12271,L,103,105,-2
24542,682,12271,W,105,103,2
24543,88,12272,L,93,106,-13
24544,87,12272,W,106,93,13
24545,504,12273,W,99,95,4
24546,503,12273,L,95,99,-4
24547,571,12274,W,120,105,15
24548,572,12274,L,105,120,-15
24549,1030,12275,L,94,96,-2
24550,1029,12275,W,96,94,2
24551,138,12276,L,87,97,-10
24552,137,12276,W,97,87,10
24553,105,12277,L,97,109,-12
24554,106,12277,W,109,97,12
24555,896,12278,W,108,105,3
24556,895,12278,L,105,108,-3
24557,850,12279,W,108,102,6
24558,849,12279,L,102,108,-6
24559,173,12280,L,81,84,-3
24560,174,12280,W,84,81,3
24561,207,12281,L,105,110,-5
24562,208,12281,W,110,105,5
24563,701,12282,L,83,108,-25
24564,702,12282,W,108,83,25
24565,829,12283,L,115,128,-13
24566,830,12283,W,128,115,13
24567,25,12284,L,89,101,-12
24568,26,12284,W,101,89,12
24569,560,12285,L,91,111,-20
24570,559,12285,W,111,91,20
24571,322,12286,L,97,102,-5
24572,321,12286,W,102,97,5
24573,624,12287,L,90,110,-20
24574,623,12287,W,110,90,20
24575,478,12288,L,93,96,-3
24576,477,12288,W,96,93,3
24577,49,12289,L,106,113,-7
24578,50,12289,W,113,106,7
24579,871,12290,W,96,82,14
24580,872,12290,L,82,96,-14
24581,978,12291,L,77,84,-7
24582,977,12291,W,84,77,7
24583,834,12292,W,104,95,9
24584,833,12292,L,95,104,-9
24585,108,12293,L,92,98,-6
24586,107,12293,W,98,92,6
24587,404,12294,W,104,85,19
24588,403,12294,L,85,104,-19
24589,131,12295,W,93,79,14
24590,132,12295,L,79,93,-14
24591,73,12296,L,85,100,-15
24592,74,12296,W,100,85,15
24593,606,12297,W,107,98,9
24594,605,12297,L,98,107,-9
24595,53,12298,L,89,94,-5
24596,54,12298,W,94,89,5
24597,955,12299,W,92,81,11
24598,956,12299,L,81,92,-11
24599,32,12300,L,86,104,-18
24600,31,12300,W,104,86,18
24601,273,12301,L,91,100,-9
24602,274,12301,W,100,91,9
24603,1038,12302,L,88,103,-15
24604,1037,12302,W,103,88,15
24605,198,12303,L,87,99,-12
24606,197,12303,W,99,87,12
24607,500,12304,L,107,114,-7
24608,499,12304,W,114,107,7
24609,458,12305,L,74,101,-27
24610,457,12305,W,101,74,27
24611,215,12306,L,92,98,-6
24612,216,12306,W,98,92,6
24613,413,12307,L,75,92,-17
24614,414,12307,W,92,75,17
24615,599,12308,L,94,103,-9
24616,600,12308,W,103,94,9
24617,952,12309,W,83,81,2
24618,951,12309,L,81,83,-2
24619,914,12310,W,96,95,1
24620,913,12310,L,95,96,-1
24621,1029,12311,L,81,90,-9
24622,1030,12311,W,90,81,9
24623,367,12312,L,98,102,-4
24624,368,12312,W,102,98,4
24625,798,12313,L,105,114,-9
24626,797,12313,W,114,105,9
24627,238,12314,L,86,95,-9
24628,237,12314,W,95,86,9
24629,97,12315,L,89,100,-11
24630,98,12315,W,100,89,11
24631,536,12316,L,103,112,-9
24632,535,12316,W,112,103,9
24633,278,12317,W,99,93,6
24634,277,12317,L,93,99,-6
24635,408,12318,L,98,100,-2
24636,407,12318,W,100,98,2
24637,936,12319,W,103,88,15
24638,935,12319,L,88,103,-15
24639,642,12320,L,92,104,-12
24640,641,12320,W,104,92,12
24641,237,12321,L,90,104,-14
24642,238,12321,W,104,90,14
24643,819,12322,W,125,119,6
24644,820,12322,L,119,125,-6
24645,460,12323,W,119,113,6
24646,459,12323,L,113,119,-6
24647,1040,12324,L,93,114,-21
24648,1039,12324,W,114,93,21
24649,884,12325,L,92,101,-9
24650,883,12325,W,101,92,9
24651,807,12326,L,93,103,-10
24652,808,12326,W,103,93,10
24653,172,12327,W,123,110,13
24654,171,12327,L,110,123,-13
24655,729,12328,W,103,95,8
24656,730,12328,L,95,103,-8
24657,15,12329,L,82,97,-15
24658,16,12329,W,97,82,15
24659,209,12330,L,77,95,-18
24660,210,12330,W,95,77,18
24661,740,12331,W,84,76,8
24662,739,12331,L,76,84,-8
24663,616,12332,L,77,90,-13
24664,615,12332,W,90,77,13
24665,41,12333,W,95,83,12
24666,42,12333,L,83,95,-12
24667,795,12334,W,110,95,15
24668,796,12334,L,95,110,-15
24669,666,12335,L,98,106,-8
24670,665,12335,W,106,98,8
24671,1022,12336,W,104,88,16
24672,1021,12336,L,88,104,-16
24673,736,12337,W,95,80,15
24674,735,12337,L,80,95,-15
24675,856,12338,L,93,100,-7
24676,855,12338,W,100,93,7
24677,909,12339,L,100,105,-5
24678,910,12339,W,105,100,5
24679,190,12340,L,85,96,-11
24680,189,12340,W,96,85,11
24681,98,12341,W,96,91,5
24682,97,12341,L,91,96,-5
24683,470,12342,W,100,99,1
24684,469,12342,L,99,100,-1
24685,581,12343,W,103,93,10
24686,582,12343,L,93,103,-10
24687,953,12344,L,98,113,-15
24688,954,12344,W,113,98,15
24689,323,12345,L,95,110,-15
24690,324,12345,W,110,95,15
24691,836,12346,L,80,94,-14
24692,835,12346,W,94,80,14
24693,699,12347,W,98,97,1
24694,700,12347,L,97,98,-1
24695,778,12348,W,95,89,6
24696,777,12348,L,89,95,-6
24697,810,12349,W,104,90,14
24698,809,12349,L,90,104,-14
24699,223,12350,L,103,108,-5
24700,224,12350,W,108,103,5
24701,669,12351,W,95,92,3
24702,670,12351,L,92,95,-3
24703,972,12352,L,86,93,-7
24704,971,12352,W,93,86,7
24705,196,12353,L,78,86,-8
24706,195,12353,W,86,78,8
24707,124,12354,W,96,80,16
24708,123,12354,L,80,96,-16
24709,612,12355,L,102,109,-7
24710,611,12355,W,109,102,7
24711,399,12356,L,95,103,-8
24712,400,12356,W,103,95,8
24713,239,12357,L,106,114,-8
24714,240,12357,W,114,106,8
24715,394,12358,L,101,123,-22
24716,393,12358,W,123,101,22
24717,202,12359,W,95,83,12
24718,201,12359,L,83,95,-12
24719,510,12360,W,84,79,5
24720,509,12360,L,79,84,-5
24721,144,12361,L,80,84,-4
24722,143,12361,W,84,80,4
24723,494,12362,L,84,98,-14
24724,493,12362,W,98,84,14
24725,329,12363,L,98,112,-14
24726,330,12363,W,112,98,14
24727,80,12364,W,112,107,5
24728,79,12364,L,107,112,-5
24729,219,12365,L,103,109,-6
24730,220,12365,W,109,103,6
24731,346,12366,W,97,92,5
24732,345,12366,L,92,97,-5
24733,566,12367,W,115,93,22
24734,565,12367,L,93,115,-22
24735,9,12368,W,87,80,7
24736,10,12368,L,80,87,-7
24737,1020,12369,L,91,105,-14
24738,1019,12369,W,105,91,14
24739,473,12370,W,105,99,6
24740,474,12370,L,99,105,-6
24741,1032,12371,W,101,94,7
24742,1031,12371,L,94,101,-7
24743,514,12372,L,76,121,-45
24744,513,12372,W,121,76,45
24745,904,12373,W,99,81,18
24746,903,12373,L,81,99,-18
24747,337,12374,W,98,79,19
24748,338,12374,L,79,98,-19
24749,436,12375,W,117,109,8
24750,435,12375,L,109,117,-8
24751,483,12376,W,121,112,9
24752,484,12376,L,112,121,-9
24753,37,12377,L,90,113,-23
24754,38,12377,W,113,90,23
24755,427,12378,L,81,91,-10
24756,428,12378,W,91,81,10
24757,881,12379,L,75,108,-33
24758,882,12379,W,108,75,33
24759,375,12380,W,101,90,11
24760,376,12380,L,90,101,-11
24761,601,12381,L,110,118,-8
24762,602,12381,W,118,110,8
24763,671,12382,L,80,106,-26
24764,672,12382,W,106,80,26
24765,984,12383,L,93,94,-1
24766,983,12383,W,94,93,1
24767,417,12384,W,98,96,2
24768,418,12384,L,96,98,-2
24769,1018,12385,L,82,89,-7
24770,1017,12385,W,89,82,7
24771,42,12386,L,88,99,-11
24772,41,12386,W,99,88,11
24773,8,12387,W,102,93,9
24774,7,12387,L,93,102,-9
24775,964,12388,L,108,111,-3
24776,963,12388,W,111,108,3
24777,251,12389,W,120,110,10
24778,252,12389,L,110,120,-10
24779,182,12390,W,113,110,3
24780,181,12390,L,110,113,-3
24781,459,12391,L,113,115,-2
24782,460,12391,W,115,113,2
24783,611,12392,L,95,96,-1
24784,612,12392,W,96,95,1
24785,823,12393,W,95,86,9
24786,824,12393,L,86,95,-9
24787,110,12394,L,106,112,-6
24788,109,12394,W,112,106,6
24789,761,12395,W,100,99,1
24790,762,12395,L,99,100,-1
24791,3,12396,W,97,89,8
24792,4,12396,L,89,97,-8
24793,307,12397,W,95,94,1
24794,308,12397,L,94,95,-1
24795,29,12398,L,102,109,-7
24796,30,12398,W,109,102,7
24797,987,12399,L,92,98,-6
24798,988,12399,W,98,92,6
24799,680,12400,L,102,107,-5
24800,679,12400,W,107,102,5
24801,11,12401,L,99,108,-9
24802,12,12401,W,108,99,9
24803,716,12402,W,109,88,21
24804,715,12402,L,88,109,-21
24805,665,12403,W,113,91,22
24806,666,12403,L,91,113,-22
24807,433,12404,L,87,103,-16
24808,434,12404,W,103,87,16
24809,118,12405,L,91,106,-15
24810,117,12405,W,106,91,15
24811,940,12406,L,71,100,-29
24812,939,12406,W,100,71,29
24813,368,12407,W,93,81,12
24814,367,12407,L,81,93,-12
24815,425,12408,L,87,102,-15
24816,426,12408,W,102,87,15
24817,875,12409,L,85,90,-5
24818,876,12409,W,90,85,5
24819,220,12410,W,113,112,1
24820,219,12410,L,112,113,-1
24821,1001,12411,L,89,97,-8
24822,1002,12411,W,97,89,8
24823,523,12412,L,90,102,-12
24824,524,12412,W,102,90,12
24825,134,12413,L,105,117,-12
24826,133,12413,W,117,105,12
24827,811,12414,W,118,116,2
24828,812,12414,L,116,118,-2
24829,695,12415,L,90,92,-2
24830,696,12415,W,92,90,2
24831,934,12416,L,91,94,-3
24832,933,12416,W,94,91,3
24833,173,12417,L,98,103,-5
24834,174,12417,W,103,98,5
24835,199,12418,W,109,94,15
24836,200,12418,L,94,109,-15
24837,448,12419,L,95,101,-6
24838,447,12419,W,101,95,6
24839,392,12420,L,91,105,-14
24840,391,12420,W,105,91,14
24841,779,12421,L,122,128,-6
24842,780,12421,W,128,122,6
24843,899,12422,L,80,113,-33
24844,900,12422,W,113,80,33
24845,559,12423,W,110,93,17
24846,560,12423,L,93,110,-17
24847,7,12424,L,105,118,-13
24848,8,12424,W,118,105,13
24849,747,12425,L,94,111,-17
24850,748,12425,W,111,94,17
24851,989,12426,W,82,77,5
24852,990,12426,L,77,82,-5
24853,714,12427,L,99,108,-9
24854,713,12427,W,108,99,9
24855,44,12428,L,80,103,-23
24856,43,12428,W,103,80,23
24857,814,12429,W,103,89,14
24858,813,12429,L,89,103,-14
24859,923,12430,L,91,97,-6
24860,924,12430,W,97,91,6
24861,146,12431,L,73,86,-13
24862,145,12431,W,86,73,13
24863,197,12432,W,103,99,4
24864,198,12432,L,99,103,-4
24865,75,12433,L,73,92,-19
24866,76,12433,W,92,73,19
24867,608,12434,L,95,108,-13
24868,607,12434,W,108,95,13
24869,946,12435,L,84,96,-12
24870,945,12435,W,96,84,12
24871,590,12436,W,94,85,9
24872,589,12436,L,85,94,-9
24873,1006,12437,W,99,92,7
24874,1005,12437,L,92,99,-7
24875,756,12438,L,125,129,-4
24876,755,12438,W,129,125,4
24877,534,12439,L,78,95,-17
24878,533,12439,W,95,78,17
24879,977,12440,L,70,88,-18
24880,978,12440,W,88,70,18
24881,539,12441,L,77,106,-29
24882,540,12441,W,106,77,29
24883,707,12442,L,83,97,-14
24884,708,12442,W,97,83,14
24885,880,12443,W,93,62,31
24886,879,12443,L,62,93,-31
24887,184,12444,L,97,103,-6
24888,183,12444,W,103,97,6
24889,774,12445,L,95,110,-15
24890,773,12445,W,110,95,15
24891,527,12446,W,104,83,21
24892,528,12446,L,83,104,-21
24893,443,12447,W,84,83,1
24894,444,12447,L,83,84,-1
24895,350,12448,L,82,113,-31
24896,349,12448,W,113,82,31
24897,565,12449,W,120,116,4
24898,566,12449,L,116,120,-4
24899,704,12450,L,105,117,-12
24900,703,12450,W,117,105,12
24901,242,12451,L,91,97,-6
24902,241,12451,W,97,91,6
24903,499,12452,W,106,84,22
24904,500,12452,L,84,106,-22
24905,966,12453,W,97,92,5
24906,965,12453,L,92,97,-5
24907,633,12454,L,92,108,-16
24908,634,12454,W,108,92,16
24909,279,12455,W,101,95,6
24910,280,12455,L,95,101,-6
24911,851,12456,L,84,88,-4
24912,852,12456,W,88,84,4
24913,902,12457,L,92,100,-8
24914,901,12457,W,100,92,8
24915,284,12458,W,101,94,7
24916,283,12458,L,94,101,-7
24917,149,12459,W,123,116,7
24918,150,12459,L,116,123,-7
24919,111,12460,L,99,109,-10
24920,112,12460,W,109,99,10
24921,1027,12461,L,89,102,-13
24922,1028,12461,W,102,89,13
24923,374,12462,L,83,97,-14
24924,373,12462,W,97,83,14
24925,143,12463,W,102,101,1
24926,144,12463,L,101,102,-1
24927,361,12464,L,91,116,-25
24928,362,12464,W,116,91,25
24929,359,12465,L,95,97,-2
24930,360,12465,W,97,95,2
24931,963,12466,L,74,93,-19
24932,964,12466,W,93,74,19
24933,14,12467,L,110,113,-3
24934,13,12467,W,113,110,3
24935,586,12468,W,104,98,6
24936,585,12468,L,98,104,-6
24937,274,12469,W,88,83,5
24938,273,12469,L,83,88,-5
24939,793,12470,L,89,105,-16
24940,794,12470,W,105,89,16
24941,497,12471,W,111,98,13
24942,498,12471,L,98,111,-13
24943,120,12472,W,87,86,1
24944,119,12472,L,86,87,-1
24945,721,12473,L,94,111,-17
24946,722,12473,W,111,94,17
24947,593,12474,W,111,103,8
24948,594,12474,L,103,111,-8
24949,813,12475,L,108,115,-7
24950,814,12475,W,115,108,7
24951,759,12476,L,83,97,-14
24952,760,12476,W,97,83,14
24953,897,12477,L,98,100,-2
24954,898,12477,W,100,98,2
24955,1017,12478,L,101,116,-15
24956,1018,12478,W,116,101,15
24957,70,12479,L,97,117,-20
24958,69,12479,W,117,97,20
24959,283,12480,L,99,106,-7
24960,284,12480,W,106,99,7
24961,652,12481,L,100,105,-5
24962,651,12481,W,105,100,5
24963,868,12482,L,114,121,-7
24964,867,12482,W,121,114,7
24965,469,12483,L,91,98,-7
24966,470,12483,W,98,91,7
24967,26,12484,W,88,78,10
24968,25,12484,L,78,88,-10
24969,454,12485,L,100,124,-24
24970,453,12485,W,124,100,24
24971,428,12486,W,80,74,6
24972,427,12486,L,74,80,-6
24973,215,12487,L,85,94,-9
24974,216,12487,W,94,85,9
24975,441,12488,L,90,99,-9
24976,442,12488,W,99,90,9
24977,975,12489,L,84,109,-25
24978,976,12489,W,109,84,25
24979,258,12490,L,108,125,-17
24980,257,12490,W,125,108,17
24981,71,12491,L,92,102,-10
24982,72,12491,W,102,92,10
24983,13,12492,W,116,99,17
24984,14,12492,L,99,116,-17
24985,997,12493,W,100,75,25
24986,998,12493,L,75,100,-25
24987,578,12494,L,107,108,-1
24988,577,12494,W,108,107,1
24989,18,12495,L,91,100,-9
24990,17,12495,W,100,91,9
24991,828,12496,L,109,114,-5
24992,827,12496,W,114,109,5
24993,137,12497,L,85,96,-11
24994,138,12497,W,96,85,11
24995,700,12498,L,95,129,-34
24996,699,12498,W,129,95,34
24997,878,12499,L,91,109,-18
24998,877,12499,W,109,91,18
24999,221,12500,W,105,103,2
25000,222,12500,L,103,105,-2
25001,480,12501,L,77,89,-12
25002,479,12501,W,89,77,12
25003,845,12502,L,116,119,-3
25004,846,12502,W,119,116,3
25005,159,12503,L,80,113,-33
25006,160,12503,W,113,80,33
25007,653,12504,L,92,104,-12
25008,654,12504,W,104,92,12
25009,980,12505,W,100,92,8
25010,979,12505,L,92,100,-8
25011,817,12506,L,101,107,-6
25012,818,12506,W,107,101,6
25013,87,12507,L,104,109,-5
25014,88,12507,W,109,104,5
25015,434,12508,W,127,111,16
25016,433,12508,L,111,127,-16
25017,1016,12509,L,84,91,-7
25018,1015,12509,W,91,84,7
25019,183,12510,W,93,81,12
25020,184,12510,L,81,93,-12
25021,352,12511,L,79,83,-4
25022,351,12511,W,83,79,4
25023,446,12512,L,88,93,-5
25024,445,12512,W,93,88,5
25025,211,12513,L,97,105,-8
25026,212,12513,W,105,97,8
25027,644,12514,L,99,111,-12
25028,643,12514,W,111,99,12
25029,492,12515,W,104,91,13
25030,491,12515,L,91,104,-13
25031,447,12516,W,118,90,28
25032,448,12516,L,90,118,-28
25033,402,12517,W,107,101,6
25034,401,12517,L,101,107,-6
25035,738,12518,W,107,78,29
25036,737,12518,L,78,107,-29
25037,1039,12519,W,123,120,3
25038,1040,12519,L,120,123,-3
25039,637,12520,L,108,127,-19
25040,638,12520,W,127,108,19
25041,247,12521,L,95,99,-4
25042,248,12521,W,99,95,4
25043,382,12522,L,86,100,-14
25044,381,12522,W,100,86,14
25045,982,12523,L,73,89,-16
25046,981,12523,W,89,73,16
25047,841,12524,L,72,97,-25
25048,842,12524,W,97,72,25
25049,130,12525,L,99,109,-10
25050,129,12525,W,109,99,10
25051,547,12526,L,85,90,-5
25052,548,12526,W,90,85,5
25053,613,12527,L,88,110,-22
25054,614,12527,W,110,88,22
25055,289,12528,L,94,105,-11
25056,290,12528,W,105,94,11
25057,78,12529,L,109,112,-3
25058,77,12529,W,112,109,3
25059,192,12530,L,79,88,-9
25060,191,12530,W,88,79,9
25061,742,12531,W,107,98,9
25062,741,12531,L,98,107,-9
25063,491,12532,L,79,90,-11
25064,492,12532,W,90,79,11
25065,403,12533,L,96,98,-2
25066,404,12533,W,98,96,2
25067,994,12534,L,100,111,-11
25068,993,12534,W,111,100,11
25069,722,12535,W,118,98,20
25070,721,12535,L,98,118,-20
25071,353,12536,W,106,87,19
25072,354,12536,L,87,106,-19
25073,824,12537,L,88,109,-21
25074,823,12537,W,109,88,21
25075,308,12538,L,94,105,-11
25076,307,12538,W,105,94,11
25077,965,12539,L,89,95,-6
25078,966,12539,W,95,89,6
25079,259,12540,L,91,101,-10
25080,260,12540,W,101,91,10
25081,520,12541,L,133,138,-5
25082,519,12541,W,138,133,5
25083,200,12542,W,95,92,3
25084,199,12542,L,92,95,-3
25085,579,12543,W,96,78,18
25086,580,12543,L,78,96,-18
25087,133,12544,L,98,99,-1
25088,134,12544,W,99,98,1
25089,729,12545,W,109,97,12
25090,730,12545,L,97,109,-12
25091,296,12546,W,125,116,9
25092,295,12546,L,116,125,-9
25093,1004,12547,L,96,98,-2
25094,1003,12547,W,98,96,2
25095,976,12548,W,109,95,14
25096,975,12548,L,95,109,-14
25097,272,12549,W,99,90,9
25098,271,12549,L,90,99,-9
25099,632,12550,L,86,92,-6
25100,631,12550,W,92,86,6
25101,598,12551,W,96,85,11
25102,597,12551,L,85,96,-11
25103,57,12552,W,100,99,1
25104,58,12552,L,99,100,-1
25105,990,12553,L,86,102,-16
25106,989,12553,W,102,86,16
25107,893,12554,L,101,104,-3
25108,894,12554,W,104,101,3
25109,713,12555,W,104,94,10
25110,714,12555,L,94,104,-10
25111,418,12556,L,95,106,-11
25112,417,12556,W,106,95,11
25113,224,12557,L,108,116,-8
25114,223,12557,W,116,108,8
25115,960,12558,W,97,78,19
25116,959,12558,L,78,97,-19
25117,796,12559,L,100,111,-11
25118,795,12559,W,111,100,11
25119,229,12560,L,96,102,-6
25120,230,12560,W,102,96,6
25121,132,12561,L,101,110,-9
25122,131,12561,W,110,101,9
25123,663,12562,L,111,116,-5
25124,664,12562,W,116,111,5
25125,557,12563,L,90,99,-9
25126,558,12563,W,99,90,9
25127,277,12564,W,103,94,9
25128,278,12564,L,94,103,-9
25129,889,12565,L,89,99,-10
25130,890,12565,W,99,89,10
25131,802,12566,W,110,106,4
25132,801,12566,L,106,110,-4
25133,485,12567,L,89,103,-14
25134,486,12567,W,103,89,14
25135,869,12568,L,97,98,-1
25136,870,12568,W,98,97,1
25137,326,12569,L,96,116,-20
25138,325,12569,W,116,96,20
25139,469,12570,L,82,100,-18
25140,470,12570,W,100,82,18
25141,920,12571,W,99,95,4
25142,919,12571,L,95,99,-4
25143,939,12572,L,87,105,-18
25144,940,12572,W,105,87,18
25145,115,12573,L,95,104,-9
25146,116,12573,W,104,95,9
25147,549,12574,L,84,105,-21
25148,550,12574,W,105,84,21
25149,764,12575,L,81,83,-2
25150,763,12575,W,83,81,2
25151,818,12576,W,113,109,4
25152,817,12576,L,109,113,-4
25153,468,12577,W,123,115,8
25154,467,12577,L,115,123,-8
25155,998,12578,L,83,89,-6
25156,997,12578,W,89,83,6
25157,40,12579,L,90,106,-16
25158,39,12579,W,106,90,16
25159,581,12580,W,111,103,8
25160,582,12580,L,103,111,-8
25161,484,12581,L,101,111,-10
25162,483,12581,W,111,101,10
25163,919,12582,L,107,110,-3
25164,920,12582,W,110,107,3
25165,770,12583,L,84,88,-4
25166,769,12583,W,88,84,4
25167,106,12584,L,114,116,-2
25168,105,12584,W,116,114,2
25169,11,12585,L,89,100,-11
25170,12,12585,W,100,89,11
25171,852,12586,L,91,98,-7
25172,851,12586,W,98,91,7
25173,1018,12587,L,101,107,-6
25174,1017,12587,W,107,101,6
25175,594,12588,L,107,117,-10
25176,593,12588,W,117,107,10
25177,139,12589,W,93,77,16
25178,140,12589,L,77,93,-16
25179,370,12590,W,106,89,17
25180,369,12590,L,89,106,-17
25181,393,12591,L,97,106,-9
25182,394,12591,W,106,97,9
25183,524,12592,W,99,76,23
25184,523,12592,L,76,99,-23
25185,932,12593,L,95,99,-4
25186,931,12593,W,99,95,4
25187,530,12594,W,123,116,7
25188,529,12594,L,116,123,-7
25189,627,12595,L,83,94,-11
25190,628,12595,W,94,83,11
25191,422,12596,L,89,117,-28
25192,421,12596,W,117,89,28
25193,131,12597,L,101,102,-1
25194,132,12597,W,102,101,1
25195,933,12598,W,75,71,4
25196,934,12598,L,71,75,-4
25197,618,12599,L,110,115,-5
25198,617,12599,W,115,110,5
25199,225,12600,W,90,86,4
25200,226,12600,L,86,90,-4
25201,411,12601,W,82,81,1
25202,412,12601,L,81,82,-1
25203,1043,12602,L,103,107,-4
25204,1044,12602,W,107,103,4
25205,916,12603,L,105,123,-18
25206,915,12603,W,123,105,18
25207,697,12604,W,124,115,9
25208,698,12604,L,115,124,-9
25209,97,12605,W,103,94,9
25210,98,12605,L,94,103,-9
25211,302,12606,L,92,116,-24
25212,301,12606,W,116,92,24
25213,753,12607,L,95,97,-2
25214,754,12607,W,97,95,2
25215,463,12608,W,98,93,5
25216,464,12608,L,93,98,-5
25217,771,12609,W,125,119,6
25218,772,12609,L,119,125,-6
25219,466,12610,L,79,90,-11
25220,465,12610,W,90,79,11
25221,797,12611,L,96,106,-10
25222,798,12611,W,106,96,10
25223,157,12612,W,94,82,12
25224,158,12612,L,82,94,-12
25225,299,12613,W,89,84,5
25226,300,12613,L,84,89,-5
25227,515,12614,L,86,89,-3
25228,516,12614,W,89,86,3
25229,943,12615,L,101,108,-7
25230,944,12615,W,108,101,7
25231,1007,12616,L,81,86,-5
25232,1008,12616,W,86,81,5
25233,872,12617,L,87,95,-8
25234,871,12617,W,95,87,8
25235,380,12618,W,88,83,5
25236,379,12618,L,83,88,-5
25237,64,12619,W,112,95,17
25238,63,12619,L,95,112,-17
25239,781,12620,L,80,107,-27
25240,782,12620,W,107,80,27
25241,678,12621,L,89,105,-16
25242,677,12621,W,105,89,16
25243,210,12622,L,83,86,-3
25244,209,12622,W,86,83,3
25245,134,12623,L,99,116,-17
25246,133,12623,W,116,99,17
25247,201,12624,L,96,123,-27
25248,202,12624,W,123,96,27
25249,930,12625,L,97,99,-2
25250,929,12625,W,99,97,2
25251,39,12626,W,94,86,8
25252,40,12626,L,86,94,-8
25253,765,12627,W,113,106,7
25254,766,12627,L,106,113,-7
25255,702,12628,W,103,90,13
25256,701,12628,L,90,103,-13
25257,1014,12629,L,88,98,-10
25258,1013,12629,W,98,88,10
25259,38,12630,L,111,113,-2
25260,37,12630,W,113,111,2
25261,584,12631,L,94,103,-9
25262,583,12631,W,103,94,9
25263,155,12632,L,83,114,-31
25264,156,12632,W,114,83,31
25265,708,12633,W,102,92,10
25266,707,12633,L,92,102,-10
25267,146,12634,W,100,99,1
25268,145,12634,L,99,100,-1
25269,846,12635,W,95,92,3
25270,845,12635,L,92,95,-3
25271,638,12636,L,94,109,-15
25272,637,12636,W,109,94,15
25273,755,12637,L,118,120,-2
25274,756,12637,W,120,118,2
25275,69,12638,L,93,101,-8
25276,70,12638,W,101,93,8
25277,338,12639,W,118,107,11
25278,337,12639,L,107,118,-11
25279,929,12640,L,95,98,-3
25280,930,12640,W,98,95,3
25281,519,12641,L,94,100,-6
25282,520,12641,W,100,94,6
25283,895,12642,L,110,113,-3
25284,896,12642,W,113,110,3
25285,1026,12643,W,110,96,14
25286,1025,12643,L,96,110,-14
25287,34,12644,L,97,101,-4
25288,33,12644,W,101,97,4
25289,282,12645,L,72,89,-17
25290,281,12645,W,89,72,17
25291,52,12646,W,115,108,7
25292,51,12646,L,108,115,-7
25293,371,12647,W,104,96,8
25294,372,12647,L,96,104,-8
25295,503,12648,W,121,116,5
25296,504,12648,L,116,121,-5
25297,544,12649,L,105,111,-6
25298,543,12649,W,111,105,6
25299,457,12650,W,117,104,13
25300,458,12650,L,104,117,-13
25301,389,12651,W,100,94,6
25302,390,12651,L,94,100,-6
25303,12,12652,W,99,85,14
25304,11,12652,L,85,99,-14
25305,928,12653,W,96,95,1
25306,927,12653,L,95,96,-1
25307,24,12654,W,116,110,6
25308,23,12654,L,110,116,-6
25309,231,12655,L,100,109,-9
25310,232,12655,W,109,100,9
25311,95,12656,L,72,79,-7
25312,96,12656,W,79,72,7
25313,236,12657,L,93,116,-23
25314,235,12657,W,116,93,23
25315,959,12658,L,87,107,-20
25316,960,12658,W,107,87,20
25317,1022,12659,W,91,90,1
25318,1021,12659,L,90,91,-1
25319,10,12660,L,96,103,-7
25320,9,12660,W,103,96,7
25321,867,12661,L,103,112,-9
25322,868,12661,W,112,103,9
25323,881,12662,W,93,85,8
25324,882,12662,L,85,93,-8
25325,629,12663,L,108,110,-2
25326,630,12663,W,110,108,2
25327,213,12664,W,110,106,4
25328,214,12664,L,106,110,-4
25329,166,12665,W,102,99,3
25330,165,12665,L,99,102,-3
25331,667,12666,L,90,99,-9
25332,668,12666,W,99,90,9
25333,54,12667,L,89,103,-14
25334,53,12667,W,103,89,14
25335,743,12668,W,90,86,4
25336,744,12668,L,86,90,-4
25337,715,12669,W,113,107,6
25338,716,12669,L,107,113,-6
25339,125,12670,W,112,107,5
25340,126,12670,L,107,112,-5
25341,128,12671,L,112,118,-6
25342,127,12671,W,118,112,6
25343,61,12672,L,90,120,-30
25344,62,12672,W,120,90,30
25345,855,12673,L,91,98,-7
25346,856,12673,W,98,91,7
25347,553,12674,W,98,89,9
25348,554,12674,L,89,98,-9
25349,1000,12675,W,95,87,8
25350,999,12675,L,87,95,-8
25351,548,12676,L,95,107,-12
25352,547,12676,W,107,95,12
25353,772,12677,W,122,117,5
25354,771,12677,L,117,122,-5
25355,735,12678,W,108,91,17
25356,736,12678,L,91,108,-17
25357,334,12679,W,106,91,15
25358,333,12679,L,91,106,-15
25359,692,12680,L,103,109,-6
25360,691,12680,W,109,103,6
25361,703,12681,W,104,94,10
25362,704,12681,L,94,104,-10
25363,924,12682,W,101,96,5
25364,923,12682,L,96,101,-5
25365,498,12683,W,116,114,2
25366,497,12683,L,114,116,-2
25367,68,12684,L,80,107,-27
25368,67,12684,W,107,80,27
25369,451,12685,L,78,100,-22
25370,452,12685,W,100,78,22
25371,999,12686,W,93,91,2
25372,1000,12686,L,91,93,-2
25373,63,12687,L,94,99,-5
25374,64,12687,W,99,94,5
25375,931,12688,L,82,101,-19
25376,932,12688,W,101,82,19
25377,622,12689,L,113,144,-31
25378,621,12689,W,144,113,31
25379,870,12690,L,92,94,-2
25380,869,12690,W,94,92,2
25381,585,12691,L,99,109,-10
25382,586,12691,W,109,99,10
25383,745,12692,L,87,89,-2
25384,746,12692,W,89,87,2
25385,906,12693,W,95,91,4
25386,905,12693,L,91,95,-4
25387,344,12694,W,109,102,7
25388,343,12694,L,102,109,-7
25389,428,12695,L,89,93,-4
25390,427,12695,W,93,89,4
25391,45,12696,L,96,121,-25
25392,46,12696,W,121,96,25
25393,33,12697,L,97,102,-5
25394,34,12697,W,102,97,5
25395,83,12698,W,106,96,10
25396,84,12698,L,96,106,-10
25397,649,12699,W,118,114,4
25398,650,12699,L,114,118,-4
25399,287,12700,L,94,120,-26
25400,288,12700,W,120,94,26
25401,300,12701,W,92,83,9
25402,299,12701,L,83,92,-9
25403,996,12702,L,89,101,-12
25404,995,12702,W,101,89,12
25405,986,12703,W,87,81,6
25406,985,12703,L,81,87,-6
25407,169,12704,L,121,124,-3
25408,170,12704,W,124,121,3
25409,471,12705,W,107,102,5
25410,472,12705,L,102,107,-5
25411,408,12706,W,100,91,9
25412,407,12706,L,91,100,-9
25413,730,12707,L,107,109,-2
25414,729,12707,W,109,107,2
25415,267,12708,W,103,92,11
25416,268,12708,L,92,103,-11
25417,885,12709,W,91,88,3
25418,886,12709,L,88,91,-3
25419,690,12710,L,84,97,-13
25420,689,12710,W,97,84,13
25421,607,12711,L,78,85,-7
25422,608,12711,W,85,78,7
25423,945,12712,L,93,96,-3
25424,946,12712,W,96,93,3
25425,280,12713,L,91,112,-21
25426,279,12713,W,112,91,21
25427,653,12714,L,105,110,-5
25428,654,12714,W,110,105,5
25429,360,12715,W,94,90,4
25430,359,12715,L,90,94,-4
25431,586,12716,L,118,123,-5
25432,585,12716,W,123,118,5
25433,910,12717,L,90,97,-7
25434,909,12717,W,97,90,7
25435,70,12718,W,123,116,7
25436,69,12718,L,116,123,-7
25437,543,12719,W,113,103,10
25438,544,12719,L,103,113,-10
25439,252,12720,L,103,108,-5
25440,251,12720,W,108,103,5
25441,87,12721,L,104,111,-7
25442,88,12721,W,111,104,7
25443,1021,12722,L,90,105,-15
25444,1022,12722,W,105,90,15
25445,630,12723,W,107,106,1
25446,629,12723,L,106,107,-1
25447,400,12724,W,120,112,8
25448,399,12724,L,112,120,-8
25449,293,12725,L,108,125,-17
25450,294,12725,W,125,108,17
25451,974,12726,W,107,99,8
25452,973,12726,L,99,107,-8
25453,664,12727,L,109,115,-6
25454,663,12727,W,115,109,6
25455,332,12728,L,86,128,-42
25456,331,12728,W,128,86,42
25457,160,12729,W,112,100,12
25458,159,12729,L,100,112,-12
25459,147,12730,L,92,107,-15
25460,148,12730,W,107,92,15
25461,99,12731,L,102,105,-3
25462,100,12731,W,105,102,3
25463,250,12732,L,75,101,-26
25464,249,12732,W,101,75,26
25465,268,12733,W,102,101,1
25466,267,12733,L,101,102,-1
25467,43,12734,L,85,94,-9
25468,44,12734,W,94,85,9
25469,602,12735,W,112,110,2
25470,601,12735,L,110,112,-2
25471,1015,12736,W,85,83,2
25472,1016,12736,L,83,85,-2
25473,642,12737,W,109,86,23
25474,641,12737,L,86,109,-23
25475,431,12738,L,97,129,-32
25476,432,12738,W,129,97,32
25477,106,12739,L,115,116,-1
25478,105,12739,W,116,115,1
25479,672,12740,W,90,76,14
25480,671,12740,L,76,90,-14
25481,404,12741,L,105,124,-19
25482,403,12741,W,124,105,19
25483,493,12742,W,100,88,12
25484,494,12742,L,88,100,-12
25485,547,12743,W,97,88,9
25486,548,12743,L,88,97,-9
25487,816,12744,L,98,110,-12
25488,815,12744,W,110,98,12
25489,305,12745,L,108,111,-3
25490,306,12745,W,111,108,3
25491,422,12746,L,83,107,-24
25492,421,12746,W,107,83,24
25493,995,12747,W,101,78,23
25494,996,12747,L,78,101,-23
25495,65,12748,W,99,83,16
25496,66,12748,L,83,99,-16
25497,51,12749,W,120,99,21
25498,52,12749,L,99,120,-21
25499,249,12750,L,86,99,-13
25500,250,12750,W,99,86,13
25501,975,12751,W,99,90,9
25502,976,12751,L,90,99,-9
25503,670,12752,L,91,101,-10
25504,669,12752,W,101,91,10
25505,893,12753,L,88,98,-10
25506,894,12753,W,98,88,10
25507,685,12754,L,89,109,-20
25508,686,12754,W,109,89,20
25509,862,12755,W,107,104,3
25510,861,12755,L,104,107,-3
25511,719,12756,W,100,95,5
25512,720,12756,L,95,100,-5
25513,326,12757,L,95,99,-4
25514,325,12757,W,99,95,4
25515,50,12758,W,107,94,13
25516,49,12758,L,94,107,-13
25517,1008,12759,L,100,106,-6
25518,1007,12759,W,106,100,6
25519,275,12760,L,91,109,-18
25520,276,12760,W,109,91,18
25521,504,12761,W,114,106,8
25522,503,12761,L,106,114,-8
25523,572,12762,L,81,101,-20
25524,571,12762,W,101,81,20
25525,116,12763,L,70,96,-26
25526,115,12763,W,96,70,26
25527,718,12764,L,85,96,-11
25528,717,12764,W,96,85,11
25529,445,12765,W,104,101,3
25530,446,12765,L,101,104,-3
25531,355,12766,W,105,104,1
25532,356,12766,L,104,105,-1
25533,947,12767,L,95,101,-6
25534,948,12767,W,101,95,6
25535,901,12768,W,104,101,3
25536,902,12768,L,101,104,-3
25537,333,12769,W,91,90,1
25538,334,12769,L,90,91,-1
25539,812,12770,L,101,105,-4
25540,811,12770,W,105,101,4
25541,58,12771,L,83,112,-29
25542,57,12771,W,112,83,29
25543,1,12772,W,110,94,16
25544,2,12772,L,94,110,-16
25545,912,12773,L,86,101,-15
25546,911,12773,W,101,86,15
25547,77,12774,W,119,104,15
25548,78,12774,L,104,119,-15
25549,554,12775,W,117,116,1
25550,553,12775,L,116,117,-1
25551,558,12776,W,97,87,10
25552,557,12776,L,87,97,-10
25553,353,12777,L,87,95,-8
25554,354,12777,W,95,87,8
25555,442,12778,L,95,106,-11
25556,441,12778,W,106,95,11
25557,13,12779,W,98,93,5
25558,14,12779,L,93,98,-5
25559,985,12780,L,91,95,-4
25560,986,12780,W,95,91,4
25561,377,12781,L,109,122,-13
25562,378,12781,W,122,109,13
25563,17,12782,W,98,88,10
25564,18,12782,L,88,98,-10
25565,135,12783,L,88,110,-22
25566,136,12783,W,110,88,22
25567,1036,12784,L,98,101,-3
25568,1035,12784,W,101,98,3
25569,483,12785,L,128,132,-4
25570,484,12785,W,132,128,4
25571,283,12786,L,92,106,-14
25572,284,12786,W,106,92,14
25573,129,12787,L,110,112,-2
25574,130,12787,W,112,110,2
25575,126,12788,L,80,88,-8
25576,125,12788,W,88,80,8
25577,455,12789,L,79,83,-4
25578,456,12789,W,83,79,4
25579,455,12790,L,67,89,-22
25580,456,12790,W,89,67,22
25581,456,12791,L,86,92,-6
25582,455,12791,W,92,86,6
25583,456,12792,L,89,96,-7
25584,455,12792,W,96,89,7
25585,456,12793,W,91,84,7
25586,455,12793,L,84,91,-7
25587,455,12794,W,103,94,9
25588,456,12794,L,94,103,-9
25589,455,12795,L,89,102,-13
25590,456,12795,W,102,89,13
25591,504,12796,W,111,103,8
25592,503,12796,L,103,111,-8
25593,195,12797,L,84,96,-12
25594,196,12797,W,96,84,12
25595,503,12798,L,101,103,-2
25596,504,12798,W,103,101,2
25597,196,12799,L,92,113,-21
25598,195,12799,W,113,92,21
25599,504,12800,L,106,115,-9
25600,503,12800,W,115,106,9
25601,195,12801,W,96,92,4
25602,196,12801,L,92,96,-4
25603,504,12802,L,109,118,-9
25604,503,12802,W,118,109,9
25605,195,12803,L,71,94,-23
25606,196,12803,W,94,71,23
25607,503,12804,L,112,124,-12
25608,504,12804,W,124,112,12
25609,196,12805,W,95,92,3
25610,195,12805,L,92,95,-3
25611,503,12806,L,107,128,-21
25612,504,12806,W,128,107,21
25613,196,12807,W,92,88,4
25614,195,12807,L,88,92,-4
25615,354,12808,L,85,94,-9
25616,353,12808,W,94,85,9
25617,353,12809,W,120,88,32
25618,354,12809,L,88,120,-32
25619,427,12810,W,98,84,14
25620,428,12810,L,84,98,-14
25621,229,12811,W,111,96,15
25622,230,12811,L,96,111,-15
25623,601,12812,W,107,101,6
25624,602,12812,L,101,107,-6
25625,354,12813,L,87,97,-10
25626,353,12813,W,97,87,10
25627,229,12814,W,111,110,1
25628,230,12814,L,110,111,-1
25629,427,12815,W,105,75,30
25630,428,12815,L,75,105,-30
25631,601,12816,W,110,96,14
25632,602,12816,L,96,110,-14
25633,354,12817,W,124,95,29
25634,353,12817,L,95,124,-29
25635,428,12818,L,98,112,-14
25636,427,12818,W,112,98,14
25637,602,12819,L,102,110,-8
25638,601,12819,W,110,102,8
25639,230,12820,L,103,111,-8
25640,229,12820,W,111,103,8
25641,428,12821,L,71,114,-43
25642,427,12821,W,114,71,43
25643,602,12822,L,102,111,-9
25644,601,12822,W,111,102,9
25645,353,12823,W,104,86,18
25646,354,12823,L,86,104,-18
25647,735,12824,L,74,95,-21
25648,736,12824,W,95,74,21
25649,230,12825,L,99,104,-5
25650,229,12825,W,104,99,5
25651,353,12826,L,93,101,-8
25652,354,12826,W,101,93,8
25653,136,12827,L,104,112,-8
25654,135,12827,W,112,104,8
25655,736,12828,W,83,69,14
25656,735,12828,L,69,83,-14
25657,218,12829,W,95,94,1
25658,217,12829,L,94,95,-1
25659,283,12830,W,99,90,9
25660,284,12830,L,90,99,-9
25661,277,12831,L,87,97,-10
25662,278,12831,W,97,87,10
25663,735,12832,W,91,87,4
25664,736,12832,L,87,91,-4
25665,135,12833,L,102,116,-14
25666,136,12833,W,116,102,14
25667,126,12834,L,86,96,-10
25668,125,12834,W,96,86,10
25669,278,12835,L,81,103,-22
25670,277,12835,W,103,81,22
25671,274,12836,L,94,96,-2
25672,273,12836,W,96,94,2
25673,217,12837,L,87,111,-24
25674,218,12837,W,111,87,24
25675,284,12838,L,88,107,-19
25676,283,12838,W,107,88,19
25677,885,12839,W,99,90,9
25678,886,12839,L,90,99,-9
25679,736,12840,L,104,111,-7
25680,735,12840,W,111,104,7
25681,273,12841,W,121,98,23
25682,274,12841,L,98,121,-23
25683,125,12842,L,92,101,-9
25684,126,12842,W,101,92,9
25685,277,12843,L,89,92,-3
25686,278,12843,W,92,89,3
25687,136,12844,L,106,117,-11
25688,135,12844,W,117,106,11
25689,218,12845,L,89,110,-21
25690,217,12845,W,110,89,21
25691,283,12846,L,87,96,-9
25692,284,12846,W,96,87,9
25693,885,12847,W,90,86,4
25694,886,12847,L,86,90,-4
25695,736,12848,L,89,107,-18
25696,735,12848,W,107,89,18
25697,277,12849,L,90,94,-4
25698,278,12849,W,94,90,4
25699,125,12850,W,100,98,2
25700,126,12850,L,98,100,-2
25701,136,12851,L,93,105,-12
25702,135,12851,W,105,93,12
25703,283,12852,W,108,89,19
25704,284,12852,L,89,108,-19
25705,218,12853,L,96,101,-5
25706,217,12853,W,101,96,5
25707,273,12854,L,106,108,-2
25708,274,12854,W,108,106,2
25709,886,12855,L,77,92,-15
25710,885,12855,W,92,77,15
25711,278,12856,W,102,88,14
25712,277,12856,L,88,102,-14
25713,284,12857,L,90,119,-29
25714,283,12857,W,119,90,29
25715,126,12858,L,77,106,-29
25716,125,12858,W,106,77,29
25717,735,12859,L,86,96,-10
25718,736,12859,W,96,86,10
25719,217,12860,L,92,95,-3
25720,218,12860,W,95,92,3
25721,135,12861,W,114,111,3
25722,136,12861,L,111,114,-3
25723,274,12862,L,102,112,-10
25724,273,12862,W,112,102,10
25725,886,12863,L,89,98,-9
25726,885,12863,W,98,89,9
25727,284,12864,W,105,100,5
25728,283,12864,L,100,105,-5
25729,217,12865,L,79,87,-8
25730,218,12865,W,87,79,8
25731,278,12866,L,94,100,-6
25732,277,12866,W,100,94,6
25733,735,12867,L,92,102,-10
25734,736,12867,W,102,92,10
25735,274,12868,L,83,96,-13
25736,273,12868,W,96,83,13
25737,135,12869,L,113,126,-13
25738,136,12869,W,126,113,13
25739,126,12870,L,76,85,-9
25740,125,12870,W,85,76,9
25741,611,12871,W,122,116,6
25742,612,12871,L,116,122,-6
25743,99,12872,W,106,95,11
25744,100,12872,L,95,106,-11
25745,120,12873,L,91,107,-16
25746,119,12873,W,107,91,16
25747,974,12874,W,123,115,8
25748,973,12874,L,115,123,-8
25749,494,12875,L,83,99,-16
25750,493,12875,W,99,83,16
25751,873,12876,W,98,89,9
25752,874,12876,L,89,98,-9
25753,111,12877,W,103,98,5
25754,112,12877,L,98,103,-5
25755,278,12878,L,89,96,-7
25756,277,12878,W,96,89,7
25757,3,12879,L,111,125,-14
25758,4,12879,W,125,111,14
25759,13,12880,L,113,131,-18
25760,14,12880,W,131,113,18
25761,1,12881,W,100,86,14
25762,2,12881,L,86,100,-14
25763,996,12882,L,86,94,-8
25764,995,12882,W,94,86,8
25765,208,12883,L,105,114,-9
25766,207,12883,W,114,105,9
25767,237,12884,L,97,98,-1
25768,238,12884,W,98,97,1
25769,607,12885,W,103,94,9
25770,608,12885,L,94,103,-9
25771,654,12886,L,93,101,-8
25772,653,12886,W,101,93,8
25773,159,12887,L,100,106,-6
25774,160,12887,W,106,100,6
25775,519,12888,L,101,123,-22
25776,520,12888,W,123,101,22
25777,565,12889,W,111,97,14
25778,566,12889,L,97,111,-14
25779,578,12890,L,101,123,-22
25780,577,12890,W,123,101,22
25781,225,12891,W,118,98,20
25782,226,12891,L,98,118,-20
25783,630,12892,L,95,103,-8
25784,629,12892,W,103,95,8
25785,817,12893,L,111,133,-22
25786,818,12893,W,133,111,22
25787,558,12894,W,107,105,2
25788,557,12894,L,105,107,-2
25789,280,12895,L,103,114,-11
25790,279,12895,W,114,103,11
25791,736,12896,W,104,96,8
25792,735,12896,L,96,104,-8
25793,1015,12897,W,105,95,10
25794,1016,12897,L,95,105,-10
25795,65,12898,W,117,94,23
25796,66,12898,L,94,117,-23
25797,8,12899,W,117,107,10
25798,7,12899,L,107,117,-10
25799,529,12900,L,106,116,-10
25800,530,12900,W,116,106,10
25801,665,12901,W,111,98,13
25802,666,12901,L,98,111,-13
25803,954,12902,L,86,114,-28
25804,953,12902,W,114,86,28
25805,559,12903,W,104,88,16
25806,560,12903,L,88,104,-16
25807,45,12904,W,91,88,3
25808,46,12904,L,88,91,-3
25809,827,12905,L,117,120,-3
25810,828,12905,W,120,117,3
25811,795,12906,W,98,92,6
25812,796,12906,L,92,98,-6
25813,100,12907,W,105,90,15
25814,99,12907,L,90,105,-15
25815,532,12908,W,120,101,19
25816,531,12908,L,101,120,-19
25817,325,12909,W,105,95,10
25818,326,12909,L,95,105,-10
25819,221,12910,W,126,108,18
25820,222,12910,L,108,126,-18
25821,276,12911,L,104,107,-3
25822,275,12911,W,107,104,3
25823,220,12912,W,104,85,19
25824,219,12912,L,85,104,-19
25825,909,12913,L,95,99,-4
25826,910,12913,W,99,95,4
25827,1012,12914,L,102,115,-13
25828,1011,12914,W,115,102,13
25829,580,12915,L,101,107,-6
25830,579,12915,W,107,101,6
25831,174,12916,W,83,77,6
25832,173,12916,L,77,83,-6
25833,940,12917,W,114,103,11
25834,939,12917,L,103,114,-11
25835,841,12918,W,106,99,7
25836,842,12918,L,99,106,-7
25837,1030,12919,L,116,127,-11
25838,1029,12919,W,127,116,11
25839,110,12920,W,107,99,8
25840,109,12920,L,99,107,-8
25841,536,12921,L,103,118,-15
25842,535,12921,W,118,103,15
25843,64,12922,W,97,88,9
25844,63,12922,L,88,97,-9
25845,466,12923,W,95,90,5
25846,465,12923,L,90,95,-5
25847,12,12924,W,116,113,3
25848,11,12924,L,113,116,-3
25849,155,12925,W,106,96,10
25850,156,12925,L,96,106,-10
25851,182,12926,L,91,96,-5
25852,181,12926,W,96,91,5
25853,890,12927,L,90,97,-7
25854,889,12927,W,97,90,7
25855,470,12928,L,94,116,-22
25856,469,12928,W,116,94,22
25857,128,12929,L,96,98,-2
25858,127,12929,W,98,96,2
25859,273,12930,L,108,109,-1
25860,274,12930,W,109,108,1
25861,107,12931,L,105,113,-8
25862,108,12931,W,113,105,8
25863,557,12932,L,95,99,-4
25864,558,12932,W,99,95,4
25865,44,12933,L,88,90,-2
25866,43,12933,W,90,88,2
25867,58,12934,L,94,121,-27
25868,57,12934,W,121,94,27
25869,602,12935,L,101,112,-11
25870,601,12935,W,112,101,11
25871,713,12936,W,116,107,9
25872,714,12936,L,107,116,-9
25873,239,12937,W,98,94,4
25874,240,12937,L,94,98,-4
25875,462,12938,L,96,113,-17
25876,461,12938,W,113,96,17
25877,333,12939,L,84,110,-26
25878,334,12939,W,110,84,26
25879,982,12940,W,104,103,1
25880,981,12940,L,103,104,-1
25881,131,12941,W,115,104,11
25882,132,12941,L,104,115,-11
25883,991,12942,L,89,108,-19
25884,992,12942,W,108,89,19
25885,17,12943,W,93,85,8
25886,18,12943,L,85,93,-8
25887,811,12944,L,101,104,-3
25888,812,12944,W,104,101,3
25889,386,12945,L,94,112,-18
25890,385,12945,W,112,94,18
25891,434,12946,W,113,103,10
25892,433,12946,L,103,113,-10
25893,616,12947,W,79,74,5
25894,615,12947,L,74,79,-5
25895,876,12948,L,100,109,-9
25896,875,12948,W,109,100,9
25897,52,12949,L,139,140,-1
25898,51,12949,W,140,139,1
25899,265,12950,W,124,103,21
25900,266,12950,L,103,124,-21
25901,262,12951,W,95,86,9
25902,261,12951,L,86,95,-9
25903,571,12952,L,101,113,-12
25904,572,12952,W,113,101,12
25905,354,12953,L,113,117,-4
25906,353,12953,W,117,113,4
25907,1002,12954,L,99,109,-10
25908,1001,12954,W,109,99,10
25909,697,12955,W,113,107,6
25910,698,12955,L,107,113,-6
25911,594,12956,L,108,116,-8
25912,593,12956,W,116,108,8
25913,166,12957,L,102,133,-31
25914,165,12957,W,133,102,31
25915,344,12958,W,113,112,1
25916,343,12958,L,112,113,-1
25917,16,12959,W,100,81,19
25918,15,12959,L,81,100,-19
25919,282,12960,L,92,107,-15
25920,281,12960,W,107,92,15
25921,316,12961,W,98,87,11
25922,315,12961,L,87,98,-11
25923,39,12962,W,128,123,5
25924,40,12962,L,123,128,-5
25925,310,12963,L,98,107,-9
25926,309,12963,W,107,98,9
25927,1019,12964,L,87,115,-28
25928,1020,12964,W,115,87,28
25929,432,12965,W,97,84,13
25930,431,12965,L,84,97,-13
25931,582,12966,W,121,116,5
25932,581,12966,L,116,121,-5
25933,87,12967,L,90,98,-8
25934,88,12967,W,98,90,8
25935,43,12968,L,85,91,-6
25936,44,12968,W,91,85,6
25937,874,12969,L,88,96,-8
25938,873,12969,W,96,88,8
25939,140,12970,W,105,96,9
25940,139,12970,L,96,105,-9
25941,9,12971,W,95,87,8
25942,10,12971,L,87,95,-8
25943,405,12972,W,119,114,5
25944,406,12972,L,114,119,-5
25945,414,12973,W,109,94,15
25946,413,12973,L,94,109,-15
25947,230,12974,L,92,106,-14
25948,229,12974,W,106,92,14
25949,771,12975,L,117,128,-11
25950,772,12975,W,128,117,11
25951,894,12976,L,86,87,-1
25952,893,12976,W,87,86,1
25953,950,12977,L,96,107,-11
25954,949,12977,W,107,96,11
25955,393,12978,L,100,112,-12
25956,394,12978,W,112,100,12
25957,493,12979,L,88,93,-5
25958,494,12979,W,93,88,5
25959,209,12980,L,92,109,-17
25960,210,12980,W,109,92,17
25961,474,12981,W,97,82,15
25962,473,12981,L,82,97,-15
25963,1042,12982,W,116,105,11
25964,1041,12982,L,105,116,-11
25965,764,12983,L,98,101,-3
25966,763,12983,W,101,98,3
25967,720,12984,L,90,118,-28
25968,719,12984,W,118,90,28
25969,169,12985,L,102,119,-17
25970,170,12985,W,119,102,17
25971,842,12986,W,98,81,17
25972,841,12986,L,81,98,-17
25973,554,12987,L,99,108,-9
25974,553,12987,W,108,99,9
25975,608,12988,L,104,128,-24
25976,607,12988,W,128,104,24
25977,334,12989,W,106,102,4
25978,333,12989,L,102,106,-4
25979,299,12990,W,109,104,5
25980,300,12990,L,104,109,-5
25981,956,12991,W,96,91,5
25982,955,12991,L,91,96,-5
25983,877,12992,L,84,103,-19
25984,878,12992,W,103,84,19
25985,775,12993,L,92,114,-22
25986,776,12993,W,114,92,22
25987,757,12994,L,92,109,-17
25988,758,12994,W,109,92,17
25989,789,12995,L,89,107,-18
25990,790,12995,W,107,89,18
25991,467,12996,W,111,105,6
25992,468,12996,L,105,111,-6
25993,856,12997,L,94,98,-4
25994,855,12997,W,98,94,4
25995,691,12998,W,111,93,18
25996,692,12998,L,93,111,-18
25997,741,12999,L,95,102,-7
25998,742,12999,W,102,95,7
25999,1033,13000,L,84,90,-6
26000,1034,13000,W,90,84,6
26001,348,13001,L,98,103,-5
26002,347,13001,W,103,98,5
26003,936,13002,L,100,108,-8
26004,935,13002,W,108,100,8
26005,923,13003,W,103,101,2
26006,924,13003,L,101,103,-2
26007,267,13004,L,93,109,-16
26008,268,13004,W,109,93,16
26009,669,13005,W,110,103,7
26010,670,13005,L,103,110,-7
26011,780,13006,W,111,105,6
26012,779,13006,L,105,111,-6
26013,748,13007,L,97,103,-6
26014,747,13007,W,103,97,6
26015,162,13008,L,103,108,-5
26016,161,13008,W,108,103,5
26017,276,13009,W,121,103,18
26018,275,13009,L,103,121,-18
26019,862,13010,L,90,97,-7
26020,861,13010,W,97,90,7
26021,231,13011,L,94,97,-3
26022,232,13011,W,97,94,3
26023,629,13012,W,92,87,5
26024,630,13012,L,87,92,-5
26025,681,13013,W,94,73,21
26026,682,13013,L,73,94,-21
26027,707,13014,L,84,94,-10
26028,708,13014,W,94,84,10
26029,410,13015,W,103,87,16
26030,409,13015,L,87,103,-16
26031,651,13016,W,111,90,21
26032,652,13016,L,90,111,-21
26033,959,13017,W,112,101,11
26034,960,13017,L,101,112,-11
26035,1029,13018,L,83,106,-23
26036,1030,13018,W,106,83,23
26037,130,13019,W,109,101,8
26038,129,13019,L,101,109,-8
26039,445,13020,L,98,105,-7
26040,446,13020,W,105,98,7
26041,26,13021,W,87,74,13
26042,25,13021,L,74,87,-13
26043,614,13022,L,106,122,-16
26044,613,13022,W,122,106,16
26045,218,13023,L,75,91,-16
26046,217,13023,W,91,75,16
26047,149,13024,W,97,96,1
26048,150,13024,L,96,97,-1
26049,302,13025,L,97,102,-5
26050,301,13025,W,102,97,5
26051,1036,13026,L,110,118,-8
26052,1035,13026,W,118,110,8
26053,825,13027,L,86,94,-8
26054,826,13027,W,94,86,8
26055,882,13028,L,96,107,-11
26056,881,13028,W,107,96,11
26057,640,13029,L,96,132,-36
26058,639,13029,W,132,96,36
26059,332,13030,L,97,106,-9
26060,331,13030,W,106,97,9
26061,788,13031,W,103,74,29
26062,787,13031,L,74,103,-29
26063,174,13032,L,89,101,-12
26064,173,13032,W,101,89,12
26065,345,13033,W,99,93,6
26066,346,13033,L,93,99,-6
26067,427,13034,L,84,86,-2
26068,428,13034,W,86,84,2
26069,238,13035,L,82,99,-17
26070,237,13035,W,99,82,17
26071,793,13036,L,99,113,-14
26072,794,13036,W,113,99,14
26073,895,13037,L,95,108,-13
26074,896,13037,W,108,95,13
26075,465,13038,W,101,86,15
26076,466,13038,L,86,101,-15
26077,134,13039,L,104,122,-18
26078,133,13039,W,122,104,18
26079,294,13040,W,113,87,26
26080,293,13040,L,87,113,-26
26081,664,13041,L,110,128,-18
26082,663,13041,W,128,110,18
26083,15,13042,W,92,83,9
26084,16,13042,L,83,92,-9
26085,943,13043,W,105,92,13
26086,944,13043,L,92,105,-13
26087,1008,13044,L,79,93,-14
26088,1007,13044,W,93,79,14
26089,791,13045,W,98,83,15
26090,792,13045,L,83,98,-15
26091,881,13046,W,95,86,9
26092,882,13046,L,86,95,-9
26093,756,13047,L,104,109,-5
26094,755,13047,W,109,104,5
26095,66,13048,L,96,106,-10
26096,65,13048,W,106,96,10
26097,930,13049,L,99,115,-16
26098,929,13049,W,115,99,16
26099,4,13050,W,109,93,16
26100,3,13050,L,93,109,-16
26101,845,13051,L,88,98,-10
26102,846,13051,W,98,88,10
26103,408,13052,W,102,85,17
26104,407,13052,L,85,102,-17
26105,336,13053,L,97,110,-13
26106,335,13053,W,110,97,13
26107,402,13054,W,133,131,2
26108,401,13054,L,131,133,-2
26109,457,13055,W,99,96,3
26110,458,13055,L,96,99,-3
26111,508,13056,W,106,100,6
26112,507,13056,L,100,106,-6
26113,736,13057,L,95,98,-3
26114,735,13057,W,98,95,3
26115,995,13058,W,99,89,10
26116,996,13058,L,89,99,-10
26117,284,13059,L,87,93,-6
26118,283,13059,W,93,87,6
26119,634,13060,L,114,119,-5
26120,633,13060,W,119,114,5
26121,813,13061,L,92,99,-7
26122,814,13061,W,99,92,7
26123,371,13062,W,116,112,4
26124,372,13062,L,112,116,-4
26125,469,13063,W,102,89,13
26126,470,13063,L,89,102,-13
26127,802,13064,L,101,121,-20
26128,801,13064,W,121,101,20
26129,72,13065,L,79,104,-25
26130,71,13065,W,104,79,25
26131,289,13066,W,102,97,5
26132,290,13066,L,97,102,-5
26133,872,13067,L,71,77,-6
26134,871,13067,W,77,71,6
26135,939,13068,L,86,106,-20
26136,940,13068,W,106,86,20
26137,745,13069,W,102,93,9
26138,746,13069,L,93,102,-9
26139,988,13070,W,100,90,10
26140,987,13070,L,90,100,-10
26141,663,13071,L,107,123,-16
26142,664,13071,W,123,107,16
26143,513,13072,W,98,84,14
26144,514,13072,L,84,98,-14
26145,351,13073,L,74,76,-2
26146,352,13073,W,76,74,2
26147,510,13074,W,114,108,6
26148,509,13074,L,108,114,-6
26149,406,13075,W,94,87,7
26150,405,13075,L,87,94,-7
26151,721,13076,L,116,147,-31
26152,722,13076,W,147,116,31
26153,83,13077,L,88,92,-4
26154,84,13077,W,92,88,4
26155,875,13078,L,92,93,-1
26156,876,13078,W,93,92,1
26157,644,13079,W,115,89,26
26158,643,13079,L,89,115,-26
26159,63,13080,L,96,104,-8
26160,64,13080,W,104,96,8
26161,2,13081,L,100,110,-10
26162,1,13081,W,110,100,10
26163,792,13082,L,102,106,-4
26164,791,13082,W,106,102,4
26165,273,13083,W,92,85,7
26166,274,13083,L,85,92,-7
26167,948,13084,L,80,93,-13
26168,947,13084,W,93,80,13
26169,116,13085,W,108,102,6
26170,115,13085,L,102,108,-6
26171,79,13086,L,100,122,-22
26172,80,13086,W,122,100,22
26173,812,13087,L,97,109,-12
26174,811,13087,W,109,97,12
26175,394,13088,L,84,110,-26
26176,393,13088,W,110,84,26
26177,904,13089,L,92,100,-8
26178,903,13089,W,100,92,8
26179,12,13090,L,94,99,-5
26180,11,13090,W,99,94,5
26181,790,13091,L,93,101,-8
26182,789,13091,W,101,93,8
26183,990,13092,L,97,108,-11
26184,989,13092,W,108,97,11
26185,380,13093,L,106,113,-7
26186,379,13093,W,113,106,7
26187,941,13094,L,121,131,-10
26188,942,13094,W,131,121,10
26189,433,13095,L,94,107,-13
26190,434,13095,W,107,94,13
26191,579,13096,L,105,106,-1
26192,580,13096,W,106,105,1
26193,800,13097,L,97,104,-7
26194,799,13097,W,104,97,7
26195,779,13098,L,114,152,-38
26196,780,13098,W,152,114,38
26197,160,13099,W,106,99,7
26198,159,13099,L,99,106,-7
26199,620,13100,W,88,76,12
26200,619,13100,L,76,88,-12
26201,706,13101,L,87,97,-10
26202,705,13101,W,97,87,10
26203,71,13102,W,113,101,12
26204,72,13102,L,101,113,-12
26205,1018,13103,W,108,84,24
26206,1017,13103,L,84,108,-24
26207,902,13104,L,94,99,-5
26208,901,13104,W,99,94,5
26209,50,13105,L,123,125,-2
26210,49,13105,W,125,123,2
26211,932,13106,W,108,100,8
26212,931,13106,L,100,108,-8
26213,409,13107,L,89,112,-23
26214,410,13107,W,112,89,23
26215,641,13108,L,93,119,-26
26216,642,13108,W,119,93,26
26217,84,13109,W,94,84,10
26218,83,13109,L,84,94,-10
26219,421,13110,W,124,121,3
26220,422,13110,L,121,124,-3
26221,553,13111,L,100,114,-14
26222,554,13111,W,114,100,14
26223,886,13112,W,96,89,7
26224,885,13112,L,89,96,-7
26225,690,13113,L,98,109,-11
26226,689,13113,W,109,98,11
26227,359,13114,L,94,98,-4
26228,360,13114,W,98,94,4
26229,51,13115,L,111,119,-8
26230,52,13115,W,119,111,8
26231,557,13116,L,91,104,-13
26232,558,13116,W,104,91,13
26233,353,13117,L,93,104,-11
26234,354,13117,W,104,93,11
26235,937,13118,L,106,120,-14
26236,938,13118,W,120,106,14
26237,577,13119,W,125,108,17
26238,578,13119,L,108,125,-17
26239,57,13120,W,109,95,14
26240,58,13120,L,95,109,-14
26241,1024,13121,L,108,116,-8
26242,1023,13121,W,116,108,8
26243,548,13122,L,88,118,-30
26244,547,13122,W,118,88,30
26245,43,13123,L,99,112,-13
26246,44,13123,W,112,99,13
26247,343,13124,L,112,124,-12
26248,344,13124,W,124,112,12
26249,840,13125,W,128,94,34
26250,839,13125,L,94,128,-34
26251,1040,13126,L,102,104,-2
26252,1039,13126,W,104,102,2
26253,70,13127,W,100,95,5
26254,69,13127,L,95,100,-5
26255,947,13128,W,102,95,7
26256,948,13128,L,95,102,-7
26257,787,13129,L,95,108,-13
26258,788,13129,W,108,95,13
26259,316,13130,W,110,94,16
26260,315,13130,L,94,110,-16
26261,618,13131,L,87,101,-14
26262,617,13131,W,101,87,14
26263,42,13132,L,103,122,-19
26264,41,13132,W,122,103,19
26265,504,13133,W,102,96,6
26266,503,13133,L,96,102,-6
26267,818,13134,W,103,85,18
26268,817,13134,L,85,103,-18
26269,921,13135,L,98,106,-8
26270,922,13135,W,106,98,8
26271,574,13136,L,112,119,-7
26272,573,13136,W,119,112,7
26273,823,13137,L,87,95,-8
26274,824,13137,W,95,87,8
26275,612,13138,W,110,105,5
26276,611,13138,L,105,110,-5
26277,325,13139,W,105,99,6
26278,326,13139,L,99,105,-6
26279,737,13140,L,82,111,-29
26280,738,13140,W,111,82,29
26281,965,13141,L,83,98,-15
26282,966,13141,W,98,83,15
26283,23,13142,W,111,91,20
26284,24,13142,L,91,111,-20
26285,305,13143,L,90,113,-23
26286,306,13143,W,113,90,23
26287,878,13144,W,102,87,15
26288,877,13144,L,87,102,-15
26289,830,13145,L,87,97,-10
26290,829,13145,W,97,87,10
26291,321,13146,W,115,104,11
26292,322,13146,L,104,115,-11
26293,1027,13147,L,87,96,-9
26294,1028,13147,W,96,87,9
26295,542,13148,L,97,108,-11
26296,541,13148,W,108,97,11
26297,460,13149,W,110,102,8
26298,459,13149,L,102,110,-8
26299,315,13150,L,81,88,-7
26300,316,13150,W,88,81,7
26301,855,13151,W,96,88,8
26302,856,13151,L,88,96,-8
26303,871,13152,L,78,83,-5
26304,872,13152,W,83,78,5
26305,100,13153,L,84,86,-2
26306,99,13153,W,86,84,2
26307,711,13154,W,132,108,24
26308,712,13154,L,108,132,-24
26309,589,13155,L,87,113,-26
26310,590,13155,W,113,87,26
26311,252,13156,L,107,109,-2
26312,251,13156,W,109,107,2
26313,249,13157,L,96,107,-11
26314,250,13157,W,107,96,11
26315,942,13158,L,131,135,-4
26316,941,13158,W,135,131,4
26317,1032,13159,L,101,107,-6
26318,1031,13159,W,107,101,6
26319,381,13160,W,125,112,13
26320,382,13160,L,112,125,-13
26321,301,13161,L,95,97,-2
26322,302,13161,W,97,95,2
26323,272,13162,L,98,99,-1
26324,271,13162,W,99,98,1
26325,646,13163,L,94,96,-2
26326,645,13163,W,96,94,2
26327,40,13164,W,114,101,13
26328,39,13164,L,101,114,-13
26329,209,13165,L,106,118,-12
26330,210,13165,W,118,106,12
26331,426,13166,W,108,102,6
26332,425,13166,L,102,108,-6
26333,155,13167,L,83,86,-3
26334,156,13167,W,86,83,3
26335,760,13168,L,107,110,-3
26336,759,13168,W,110,107,3
26337,730,13169,L,85,107,-22
26338,729,13169,W,107,85,22
26339,379,13170,W,122,116,6
26340,380,13170,L,116,122,-6
26341,288,13171,W,112,98,14
26342,287,13171,L,98,112,-14
26343,211,13172,L,105,113,-8
26344,212,13172,W,113,105,8
26345,109,13173,W,102,92,10
26346,110,13173,L,92,102,-10
26347,914,13174,L,90,101,-11
26348,913,13174,W,101,90,11
26349,994,13175,W,113,93,20
26350,993,13175,L,93,113,-20
26351,763,13176,L,85,92,-7
26352,764,13176,W,92,85,7
26353,480,13177,L,94,100,-6
26354,479,13177,W,100,94,6
26355,975,13178,L,91,102,-11
26356,976,13178,W,102,91,11
26357,918,13179,L,83,98,-15
26358,917,13179,W,98,83,15
26359,1022,13180,W,97,87,10
26360,1021,13180,L,87,97,-10
26361,13,13181,L,96,102,-6
26362,14,13181,W,102,96,6
26363,175,13182,W,102,74,28
26364,176,13182,L,74,102,-28
26365,222,13183,L,100,108,-8
26366,221,13183,W,108,100,8
26367,72,13184,L,92,99,-7
26368,71,13184,W,99,92,7
26369,621,13185,L,114,122,-8
26370,622,13185,W,122,114,8
26371,807,13186,L,122,127,-5
26372,808,13186,W,127,122,5
26373,143,13187,W,96,86,10
26374,144,13187,L,86,96,-10
26375,147,13188,W,104,87,17
26376,148,13188,L,87,104,-17
26377,2,13189,W,116,108,8
26378,1,13189,L,108,116,-8
26379,799,13190,W,105,96,9
26380,800,13190,L,96,105,-9
26381,123,13191,L,111,114,-3
26382,124,13191,W,114,111,3
26383,240,13192,L,90,119,-29
26384,239,13192,W,119,90,29
26385,999,13193,W,111,92,19
26386,1000,13193,L,92,111,-19
26387,223,13194,W,127,101,26
26388,224,13194,L,101,127,-26
26389,7,13195,W,84,81,3
26390,8,13195,L,81,84,-3
26391,382,13196,L,109,112,-3
26392,381,13196,W,112,109,3
26393,949,13197,W,104,100,4
26394,950,13197,L,100,104,-4
26395,295,13198,L,104,128,-24
26396,296,13198,W,128,104,24
26397,176,13199,L,87,100,-13
26398,175,13199,W,100,87,13
26399,424,13200,L,79,102,-23
26400,423,13200,W,102,79,23
26401,624,13201,L,90,117,-27
26402,623,13201,W,117,90,27
26403,879,13202,L,80,104,-24
26404,880,13202,W,104,80,24
26405,446,13203,L,93,112,-19
26406,445,13203,W,112,93,19
26407,500,13204,L,106,110,-4
26408,499,13204,W,110,106,4
26409,200,13205,L,99,122,-23
26410,199,13205,W,122,99,23
26411,642,13206,W,105,100,5
26412,641,13206,L,100,105,-5
26413,425,13207,L,107,113,-6
26414,426,13207,W,113,107,6
26415,146,13208,W,103,93,10
26416,145,13208,L,93,103,-10
26417,29,13209,L,93,124,-31
26418,30,13209,W,124,93,31
26419,729,13210,L,104,108,-4
26420,730,13210,W,108,104,4
26421,4,13211,W,126,105,21
26422,3,13211,L,105,126,-21
26423,976,13212,W,106,92,14
26424,975,13212,L,92,106,-14
26425,911,13213,W,89,84,5
26426,912,13213,L,84,89,-5
26427,101,13214,W,116,92,24
26428,102,13214,L,92,116,-24
26429,519,13215,L,85,101,-16
26430,520,13215,W,101,85,16
26431,798,13216,L,92,116,-24
26432,797,13216,W,116,92,24
26433,601,13217,L,110,113,-3
26434,602,13217,W,113,110,3
26435,735,13218,L,102,106,-4
26436,736,13218,W,106,102,4
26437,929,13219,L,100,108,-8
26438,930,13219,W,108,100,8
26439,643,13220,L,99,119,-20
26440,644,13220,W,119,99,20
26441,470,13221,L,92,97,-5
26442,469,13221,W,97,92,5
26443,1001,13222,W,89,85,4
26444,1002,13222,L,85,89,-4
26445,127,13223,L,89,95,-6
26446,128,13223,W,95,89,6
26447,115,13224,L,80,96,-16
26448,116,13224,W,96,80,16
26449,461,13225,L,110,133,-23
26450,462,13225,W,133,110,23
26451,679,13226,W,110,91,19
26452,680,13226,L,91,110,-19
26453,573,13227,W,120,109,11
26454,574,13227,L,109,120,-11
26455,34,13228,L,88,95,-7
26456,33,13228,W,95,88,7
26457,998,13229,W,104,96,8
26458,997,13229,L,96,104,-8
26459,25,13230,W,94,71,23
26460,26,13230,L,71,94,-23
26461,76,13231,L,90,100,-10
26462,75,13231,W,100,90,10
26463,816,13232,L,111,115,-4
26464,815,13232,W,115,111,4
26465,628,13233,L,99,103,-4
26466,627,13233,W,103,99,4
26467,279,13234,W,118,116,2
26468,280,13234,L,116,118,-2
26469,170,13235,L,104,109,-5
26470,169,13235,W,109,104,5
26471,367,13236,L,90,99,-9
26472,368,13236,W,99,90,9
26473,594,13237,L,92,109,-17
26474,593,13237,W,109,92,17
26475,463,13238,W,111,103,8
26476,464,13238,L,103,111,-8
26477,439,13239,L,102,107,-5
26478,440,13239,W,107,102,5
26479,961,13240,L,93,100,-7
26480,962,13240,W,100,93,7
26481,224,13241,L,112,125,-13
26482,223,13241,W,125,112,13
26483,899,13242,W,93,89,4
26484,900,13242,L,89,93,-4
26485,572,13243,W,126,118,8
26486,571,13243,L,118,126,-8
26487,354,13244,W,108,88,20
26488,353,13244,L,88,108,-20
26489,360,13245,W,112,110,2
26490,359,13245,L,110,112,-2
26491,370,13246,W,127,112,15
26492,369,13246,L,112,127,-15
26493,715,13247,L,91,97,-6
26494,716,13247,W,97,91,6
26495,94,13248,L,96,101,-5
26496,93,13248,W,101,96,5
26497,689,13249,W,101,87,14
26498,690,13249,L,87,101,-14
26499,75,13250,L,110,120,-10
26500,76,13250,W,120,110,10
26501,172,13251,L,95,106,-11
26502,171,13251,W,106,95,11
26503,986,13252,L,95,115,-20
26504,985,13252,W,115,95,20
26505,544,13253,L,92,98,-6
26506,543,13253,W,98,92,6
26507,515,13254,W,99,94,5
26508,516,13254,L,94,99,-5
26509,927,13255,L,93,102,-9
26510,928,13255,W,102,93,9
26511,313,13256,W,110,92,18
26512,314,13256,L,92,110,-18
26513,458,13257,L,87,95,-8
26514,457,13257,W,95,87,8
26515,323,13258,W,110,102,8
26516,324,13258,L,102,110,-8
26517,431,13259,W,91,88,3
26518,432,13259,L,88,91,-3
26519,1004,13260,W,102,93,9
26520,1003,13260,L,93,102,-9
26521,182,13261,W,104,102,2
26522,181,13261,L,102,104,-2
26523,389,13262,W,101,89,12
26524,390,13262,L,89,101,-12
26525,944,13263,L,95,105,-10
26526,943,13263,W,105,95,10
26527,812,13264,L,106,110,-4
26528,811,13264,W,110,106,4
26529,403,13265,W,99,98,1
26530,404,13265,L,98,99,-1
26531,311,13266,L,82,91,-9
26532,312,13266,W,91,82,9
26533,67,13267,W,83,67,16
26534,68,13267,L,67,83,-16
26535,9,13268,L,95,101,-6
26536,10,13268,W,101,95,6
26537,922,13269,L,94,98,-4
26538,921,13269,W,98,94,4
26539,744,13270,W,105,100,5
26540,743,13270,L,100,105,-5
26541,1031,13271,W,104,94,10
26542,1032,13271,L,94,104,-10
26543,732,13272,L,101,109,-8
26544,731,13272,W,109,101,8
26545,593,13273,W,109,107,2
26546,594,13273,L,107,109,-2
26547,794,13274,L,105,114,-9
26548,793,13274,W,114,105,9
26549,97,13275,W,93,89,4
26550,98,13275,L,89,93,-4
26551,808,13276,L,104,108,-4
26552,807,13276,W,108,104,4
26553,973,13277,L,94,102,-8
26554,974,13277,W,102,94,8
26555,54,13278,L,88,104,-16
26556,53,13278,W,104,88,16
26557,796,13279,L,95,101,-6
26558,795,13279,W,101,95,6
26559,418,13280,L,91,97,-6
26560,417,13280,W,97,91,6
26561,514,13281,L,90,122,-32
26562,513,13281,W,122,90,32
26563,329,13282,W,121,118,3
26564,330,13282,L,118,121,-3
26565,637,13283,L,104,109,-5
26566,638,13283,W,109,104,5
26567,165,13284,W,125,115,10
26568,166,13284,L,115,125,-10
26569,893,13285,L,88,93,-5
26570,894,13285,W,93,88,5
26571,469,13286,L,89,99,-10
26572,470,13286,W,99,89,10
26573,349,13287,W,100,94,6
26574,350,13287,L,94,100,-6
26575,235,13288,L,94,106,-12
26576,236,13288,W,106,94,12
26577,485,13289,W,91,85,6
26578,486,13289,L,85,91,-6
26579,884,13290,L,93,110,-17
26580,883,13290,W,110,93,17
26581,753,13291,W,100,87,13
26582,754,13291,L,87,100,-13
26583,607,13292,W,100,89,11
26584,608,13292,L,89,100,-11
26585,650,13293,L,80,88,-8
26586,649,13293,W,88,80,8
26587,248,13294,W,96,76,20
26588,247,13294,L,76,96,-20
26589,983,13295,L,101,107,-6
26590,984,13295,W,107,101,6
26591,705,13296,L,97,107,-10
26592,706,13296,W,107,97,10
26593,988,13297,W,106,89,17
26594,987,13297,L,89,106,-17
26595,473,13298,W,95,85,10
26596,474,13298,L,85,95,-10
26597,455,13299,W,87,86,1
26598,456,13299,L,86,87,-1
26599,319,13300,W,118,116,2
26600,320,13300,L,116,118,-2
26601,940,13301,W,98,90,8
26602,939,13301,L,90,98,-8
26603,838,13302,L,99,108,-9
26604,837,13302,W,108,99,9
26605,242,13303,W,127,99,28
26606,241,13303,L,99,127,-28
26607,118,13304,L,97,107,-10
26608,117,13304,W,107,97,10
26609,995,13305,W,87,84,3
26610,996,13305,L,84,87,-3
26611,435,13306,L,98,130,-32
26612,436,13306,W,130,98,32
26613,491,13307,L,91,116,-25
26614,492,13307,W,116,91,25
26615,606,13308,W,110,92,18
26616,605,13308,L,92,110,-18
26617,189,13309,W,109,102,7
26618,190,13309,L,102,109,-7
26619,378,13310,W,90,87,3
26620,377,13310,L,87,90,-3
26621,399,13311,W,115,109,6
26622,400,13311,L,109,115,-6
26623,112,13312,L,85,108,-23
26624,111,13312,W,108,85,23
26625,18,13313,L,87,109,-22
26626,17,13313,W,109,87,22
26627,1016,13314,W,103,94,9
26628,1015,13314,L,94,103,-9
26629,400,13315,L,85,118,-33
26630,399,13315,W,118,85,33
26631,422,13316,L,94,104,-10
26632,421,13316,W,104,94,10
26633,558,13317,W,105,78,27
26634,557,13317,L,78,105,-27
26635,826,13318,W,95,92,3
26636,825,13318,L,92,95,-3
26637,462,13319,W,104,95,9
26638,461,13319,L,95,104,-9
26639,581,13320,L,86,99,-13
26640,582,13320,W,99,86,13
26641,585,13321,W,109,95,14
26642,586,13321,L,95,109,-14
26643,220,13322,W,111,92,19
26644,219,13322,L,92,111,-19
26645,795,13323,L,106,115,-9
26646,796,13323,W,115,106,9
26647,390,13324,W,103,97,6
26648,389,13324,L,97,103,-6
26649,738,13325,W,107,87,20
26650,737,13325,L,87,107,-20
26651,40,13326,L,93,104,-11
26652,39,13326,W,104,93,11
26653,992,13327,W,97,77,20
26654,991,13327,L,77,97,-20
26655,951,13328,L,85,93,-8
26656,952,13328,W,93,85,8
26657,275,13329,L,102,132,-30
26658,276,13329,W,132,102,30
26659,284,13330,W,108,101,7
26660,283,13330,L,101,108,-7
26661,229,13331,W,96,81,15
26662,230,13331,L,81,96,-15
26663,479,13332,W,94,76,18
26664,480,13332,L,76,94,-18
26665,896,13333,W,93,92,1
26666,895,13333,L,92,93,-1
26667,630,13334,W,89,77,12
26668,629,13334,L,77,89,-12
26669,729,13335,W,109,99,10
26670,730,13335,L,99,109,-10
26671,882,13336,L,92,94,-2
26672,881,13336,W,94,92,2
26673,76,13337,W,109,101,8
26674,75,13337,L,101,109,-8
26675,766,13338,W,118,114,4
26676,765,13338,L,114,118,-4
26677,853,13339,L,97,119,-22
26678,854,13339,W,119,97,22
26679,77,13340,W,108,94,14
26680,78,13340,L,94,108,-14
26681,486,13341,W,93,81,12
26682,485,13341,L,81,93,-12
26683,820,13342,L,66,99,-33
26684,819,13342,W,99,66,33
26685,1000,13343,L,97,104,-7
26686,999,13343,W,104,97,7
26687,268,13344,L,91,127,-36
26688,267,13344,W,127,91,36
26689,651,13345,W,127,117,10
26690,652,13345,L,117,127,-10
26691,962,13346,L,117,123,-6
26692,961,13346,W,123,117,6
26693,16,13347,L,89,101,-12
26694,15,13347,W,101,89,12
26695,306,13348,L,104,115,-11
26696,305,13348,W,115,104,11
26697,195,13349,W,96,89,7
26698,196,13349,L,89,96,-7
26699,136,13350,L,106,116,-10
26700,135,13350,W,116,106,10
26701,547,13351,W,98,81,17
26702,548,13351,L,81,98,-17
26703,359,13352,L,81,93,-12
26704,360,13352,W,93,81,12
26705,1035,13353,L,92,99,-7
26706,1036,13353,W,99,92,7
26707,151,13354,W,102,95,7
26708,152,13354,L,95,102,-7
26709,788,13355,L,91,95,-4
26710,787,13355,W,95,91,4
26711,827,13356,W,104,95,9
26712,828,13356,L,95,104,-9
26713,981,13357,W,104,99,5
26714,982,13357,L,99,104,-5
26715,686,13358,L,102,109,-7
26716,685,13358,W,109,102,7
26717,29,13359,L,106,113,-7
26718,30,13359,W,113,106,7
26719,46,13360,W,99,82,17
26720,45,13360,L,82,99,-17
26721,127,13361,W,126,113,13
26722,128,13361,L,113,126,-13
26723,102,13362,L,81,91,-10
26724,101,13362,W,91,81,10
26725,58,13363,W,92,91,1
26726,57,13363,L,91,92,-1
26727,67,13364,W,114,107,7
26728,68,13364,L,107,114,-7
26729,998,13365,L,87,96,-9
26730,997,13365,W,96,87,9
26731,53,13366,W,114,102,12
26732,54,13366,L,102,114,-12
26733,434,13367,W,101,83,18
26734,433,13367,L,83,101,-18
26735,382,13368,W,117,108,9
26736,381,13368,L,108,117,-9
26737,792,13369,L,83,107,-24
26738,791,13369,W,107,83,24
26739,978,13370,W,101,94,7
26740,977,13370,L,94,101,-7
26741,533,13371,L,93,96,-3
26742,534,13371,W,96,93,3
26743,447,13372,L,86,102,-16
26744,448,13372,W,102,86,16
26745,987,13373,L,99,108,-9
26746,988,13373,W,108,99,9
26747,605,13374,L,97,103,-6
26748,606,13374,W,103,97,6
26749,917,13375,L,97,99,-2
26750,918,13375,W,99,97,2
26751,280,13376,L,85,107,-22
26752,279,13376,W,107,85,22
26753,966,13377,W,103,99,4
26754,965,13377,L,99,103,-4
26755,520,13378,W,109,97,12
26756,519,13378,L,97,109,-12
26757,513,13379,L,103,106,-3
26758,514,13379,W,106,103,3
26759,652,13380,L,101,110,-9
26760,651,13380,W,110,101,9
26761,98,13381,L,105,118,-13
26762,97,13381,W,118,105,13
26763,126,13382,L,102,107,-5
26764,125,13382,W,107,102,5
26765,262,13383,W,115,113,2
26766,261,13383,L,113,115,-2
26767,138,13384,L,82,99,-17
26768,137,13384,W,99,82,17
26769,761,13385,W,90,82,8
26770,762,13385,L,82,90,-8
26771,632,13386,L,89,105,-16
26772,631,13386,W,105,89,16
26773,484,13387,L,97,119,-22
26774,483,13387,W,119,97,22
26775,1036,13388,W,97,93,4
26776,1035,13388,L,93,97,-4
26777,599,13389,L,99,106,-7
26778,600,13389,W,106,99,7
26779,454,13390,L,115,130,-15
26780,453,13390,W,130,115,15
26781,32,13391,L,109,112,-3
26782,31,13391,W,112,109,3
26783,156,13392,W,99,88,11
26784,155,13392,L,88,99,-11
26785,892,13393,L,79,98,-19
26786,891,13393,W,98,79,19
26787,403,13394,L,93,95,-2
26788,404,13394,W,95,93,2
26789,25,13395,W,97,81,16
26790,26,13395,L,81,97,-16
26791,183,13396,L,92,104,-12
26792,184,13396,W,104,92,12
26793,938,13397,W,109,100,9
26794,937,13397,L,100,109,-9
26795,989,13398,W,83,79,4
26796,990,13398,L,79,83,-4
26797,867,13399,L,91,112,-21
26798,868,13399,W,112,91,21
26799,492,13400,W,91,86,5
26800,491,13400,L,86,91,-5
26801,453,13401,L,102,117,-15
26802,454,13401,W,117,102,15
26803,517,13402,L,89,114,-25
26804,518,13402,W,114,89,25
26805,828,13403,L,104,112,-8
26806,827,13403,W,112,104,8
26807,530,13404,W,115,111,4
26808,529,13404,L,111,115,-4
26809,456,13405,W,90,89,1
26810,455,13405,L,89,90,-1
26811,219,13406,W,103,89,14
26812,220,13406,L,89,103,-14
26813,950,13407,W,109,102,7
26814,949,13407,L,102,109,-7
26815,173,13408,W,114,112,2
26816,174,13408,L,112,114,-2
26817,279,13409,L,96,106,-10
26818,280,13409,W,106,96,10
26819,428,13410,L,86,104,-18
26820,427,13410,W,104,86,18
26821,925,13411,W,103,96,7
26822,926,13411,L,96,103,-7
26823,26,13412,L,84,95,-11
26824,25,13412,W,95,84,11
26825,1001,13413,W,81,79,2
26826,1002,13413,L,79,81,-2
26827,110,13414,L,97,104,-7
26828,109,13414,W,104,97,7
26829,11,13415,W,94,73,21
26830,12,13415,L,73,94,-21
26831,368,13416,W,99,91,8
26832,367,13416,L,91,99,-8
26833,967,13417,W,108,106,2
26834,968,13417,L,106,108,-2
26835,38,13418,L,97,111,-14
26836,37,13418,W,111,97,14
26837,74,13419,L,100,104,-4
26838,73,13419,W,104,100,4
26839,524,13420,L,91,100,-9
26840,523,13420,W,100,91,9
26841,239,13421,L,84,101,-17
26842,240,13421,W,101,84,17
26843,913,13422,W,121,110,11
26844,914,13422,L,110,121,-11
26845,842,13423,W,92,65,27
26846,841,13423,L,65,92,-27
26847,627,13424,L,94,101,-7
26848,628,13424,W,101,94,7
26849,14,13425,W,106,104,2
26850,13,13425,L,104,106,-2
26851,196,13426,L,94,96,-2
26852,195,13426,W,96,94,2
26853,117,13427,L,106,112,-6
26854,118,13427,W,112,106,6
26855,633,13428,L,90,105,-15
26856,634,13428,W,105,90,15
26857,699,13429,L,95,109,-14
26858,700,13429,W,109,95,14
26859,550,13430,W,99,93,6
26860,549,13430,L,93,99,-6
26861,941,13431,W,123,110,13
26862,942,13431,L,110,123,-13
26863,1025,13432,L,87,103,-16
26864,1026,13432,W,103,87,16
26865,442,13433,W,96,86,10
26866,441,13433,L,86,96,-10
26867,97,13434,W,106,95,11
26868,98,13434,L,95,106,-11
26869,232,13435,L,103,111,-8
26870,231,13435,W,111,103,8
26871,465,13436,L,88,91,-3
26872,466,13436,W,91,88,3
26873,199,13437,W,118,96,22
26874,200,13437,L,96,118,-22
26875,50,13438,W,97,92,5
26876,49,13438,L,92,97,-5
26877,197,13439,L,107,108,-1
26878,198,13439,W,108,107,1
26879,868,13440,L,105,132,-27
26880,867,13440,W,132,105,27
26881,915,13441,W,114,109,5
26882,916,13441,L,109,114,-5
26883,814,13442,W,115,103,12
26884,813,13442,L,103,115,-12
26885,436,13443,L,96,99,-3
26886,435,13443,W,99,96,3
26887,684,13444,W,102,95,7
26888,683,13444,L,95,102,-7
26889,489,13445,L,89,95,-6
26890,490,13445,W,95,89,6
26891,281,13446,L,94,99,-5
26892,282,13446,W,99,94,5
26893,584,13447,W,98,93,5
26894,583,13447,L,93,98,-5
26895,898,13448,L,93,104,-11
26896,897,13448,W,104,93,11
26897,448,13449,W,92,91,1
26898,447,13449,L,91,92,-1
26899,960,13450,W,98,97,1
26900,959,13450,L,97,98,-1
26901,1,13451,L,115,124,-9
26902,2,13451,W,124,115,9
26903,250,13452,W,109,98,11
26904,249,13452,L,98,109,-11
26905,251,13453,L,105,106,-1
26906,252,13453,W,106,105,1
26907,839,13454,W,128,78,50
26908,840,13454,L,78,128,-50
26909,783,13455,W,92,78,14
26910,784,13455,L,78,92,-14
26911,528,13456,L,84,115,-31
26912,527,13456,W,115,84,31
26913,717,13457,L,94,127,-33
26914,718,13457,W,127,94,33
26915,1014,13458,L,83,116,-33
26916,1013,13458,W,116,83,33
26917,948,13459,L,110,116,-6
26918,947,13459,W,116,110,6
26919,846,13460,W,104,97,7
26920,845,13460,L,97,104,-7
26921,401,13461,L,103,112,-9
26922,402,13461,W,112,103,9
26923,452,13462,W,97,93,4
26924,451,13462,L,93,97,-4
26925,249,13463,W,107,97,10
26926,250,13463,L,97,107,-10
26927,540,13464,L,99,100,-1
26928,539,13464,W,100,99,1
26929,885,13465,W,106,95,11
26930,886,13465,L,95,106,-11
26931,953,13466,W,96,94,2
26932,954,13466,L,94,96,-2
26933,247,13467,L,95,98,-3
26934,248,13467,W,98,95,3
26935,207,13468,L,84,86,-2
26936,208,13468,W,86,84,2
26937,791,13469,W,105,93,12
26938,792,13469,L,93,105,-12
26939,245,13470,L,84,100,-16
26940,246,13470,W,100,84,16
26941,169,13471,W,116,109,7
26942,170,13471,L,109,116,-7
26943,875,13472,L,89,103,-14
26944,876,13472,W,103,89,14
26945,1009,13473,L,79,111,-32
26946,1010,13473,W,111,79,32
26947,307,13474,W,112,88,24
26948,308,13474,L,88,112,-24
26949,668,13475,L,81,92,-11
26950,667,13475,W,92,81,11
26951,468,13476,W,115,104,11
26952,467,13476,L,104,115,-11
26953,609,13477,W,115,105,10
26954,610,13477,L,105,115,-10
26955,186,13478,L,96,101,-5
26956,185,13478,W,101,96,5
26957,658,13479,L,87,93,-6
26958,657,13479,W,93,87,6
26959,87,13480,L,85,105,-20
26960,88,13480,W,105,85,20
26961,185,13481,L,107,113,-6
26962,186,13481,W,113,107,6
26963,1041,13482,L,94,118,-24
26964,1042,13482,W,118,94,24
26965,949,13483,L,111,113,-2
26966,950,13483,W,113,111,2
26967,158,13484,W,105,98,7
26968,157,13484,L,98,105,-7
26969,762,13485,L,97,104,-7
26970,761,13485,W,104,97,7
26971,642,13486,L,86,92,-6
26972,641,13486,W,92,86,6
26973,226,13487,L,98,109,-11
26974,225,13487,W,109,98,11
26975,192,13488,W,98,90,8
26976,191,13488,L,90,98,-8
26977,370,13489,W,123,118,5
26978,369,13489,L,118,123,-5
26979,525,13490,W,94,93,1
26980,526,13490,L,93,94,-1
26981,871,13491,L,65,104,-39
26982,872,13491,W,104,65,39
26983,849,13492,L,97,108,-11
26984,850,13492,W,108,97,11
26985,593,13493,W,94,92,2
26986,594,13493,L,92,94,-2
26987,571,13494,L,100,108,-8
26988,572,13494,W,108,100,8
26989,139,13495,L,83,113,-30
26990,140,13495,W,113,83,30
26991,295,13496,L,91,99,-8
26992,296,13496,W,99,91,8
26993,62,13497,L,97,114,-17
26994,61,13497,W,114,97,17
26995,926,13498,L,103,105,-2
26996,925,13498,W,105,103,2
26997,854,13499,L,103,108,-5
26998,853,13499,W,108,103,5
26999,976,13500,W,97,90,7
27000,975,13500,L,90,97,-7
27001,241,13501,L,98,101,-3
27002,242,13501,W,101,98,3
27003,1026,13502,L,95,106,-11
27004,1025,13502,W,106,95,11
27005,585,13503,L,118,125,-7
27006,586,13503,W,125,118,7
27007,645,13504,L,92,98,-6
27008,646,13504,W,98,92,6
27009,746,13505,W,99,90,9
27010,745,13505,L,90,99,-9
27011,600,13506,W,94,91,3
27012,599,13506,L,91,94,-3
27013,352,13507,L,92,97,-5
27014,351,13507,W,97,92,5
27015,739,13508,L,88,110,-22
27016,740,13508,W,110,88,22
27017,135,13509,L,112,119,-7
27018,136,13509,W,119,112,7
27019,518,13510,W,102,101,1
27020,517,13510,L,101,102,-1
27021,824,13511,L,95,112,-17
27022,823,13511,W,112,95,17
27023,296,13512,L,90,94,-4
27024,295,13512,W,94,90,4
27025,362,13513,L,86,96,-10
27026,361,13513,W,96,86,10
27027,984,13514,W,101,96,5
27028,983,13514,L,96,101,-5
27029,167,13515,L,80,98,-18
27030,168,13515,W,98,80,18
27031,916,13516,L,99,125,-26
27032,915,13516,W,125,99,26
27033,109,13517,L,86,92,-6
27034,110,13517,W,92,86,6
27035,10,13518,L,119,121,-2
27036,9,13518,W,121,119,2
27037,1011,13519,W,121,105,16
27038,1012,13519,L,105,121,-16
27039,819,13520,W,115,106,9
27040,820,13520,L,106,115,-9
27041,14,13521,W,112,104,8
27042,13,13521,L,104,112,-8
27043,649,13522,L,101,102,-1
27044,650,13522,W,102,101,1
27045,119,13523,L,86,126,-40
27046,120,13523,W,126,86,40
27047,685,13524,L,110,135,-25
27048,686,13524,W,135,110,25
27049,582,13525,L,98,99,-1
27050,581,13525,W,99,98,1
27051,96,13526,W,113,104,9
27052,95,13526,L,104,113,-9
27053,342,13527,L,86,98,-12
27054,341,13527,W,98,86,12
27055,374,13528,L,87,102,-15
27056,373,13528,W,102,87,15
27057,964,13529,L,104,110,-6
27058,963,13529,W,110,104,6
27059,906,13530,L,76,92,-16
27060,905,13530,W,92,76,16
27061,653,13531,W,96,83,13
27062,654,13531,L,83,96,-13
27063,376,13532,L,96,97,-1
27064,375,13532,W,97,96,1
27065,287,13533,L,114,120,-6
27066,288,13533,W,120,114,6
27067,326,13534,L,82,94,-12
27068,325,13534,W,94,82,12
27069,747,13535,L,97,115,-18
27070,748,13535,W,115,97,18
27071,212,13536,L,114,122,-8
27072,211,13536,W,122,114,8
27073,931,13537,L,94,108,-14
27074,932,13537,W,108,94,14
27075,84,13538,W,93,92,1
27076,83,13538,L,92,93,-1
27077,94,13539,W,100,95,5
27078,93,13539,L,95,100,-5
27079,997,13540,W,111,87,24
27080,998,13540,L,87,111,-24
27081,457,13541,W,109,108,1
27082,458,13541,L,108,109,-1
27083,499,13542,W,115,102,13
27084,500,13542,L,102,115,-13
27085,671,13543,L,108,120,-12
27086,672,13543,W,120,108,12
27087,246,13544,W,109,88,21
27088,245,13544,L,88,109,-21
27089,617,13545,W,99,90,9
27090,618,13545,L,90,99,-9
27091,889,13546,L,94,102,-8
27092,890,13546,W,102,94,8
27093,15,13547,L,85,105,-20
27094,16,13547,W,105,85,20
27095,444,13548,L,102,104,-2
27096,443,13548,W,104,102,2
27097,454,13549,L,101,105,-4
27098,453,13549,W,105,101,4
27099,309,13550,L,101,105,-4
27100,310,13550,W,105,101,4
27101,330,13551,L,88,106,-18
27102,329,13551,W,106,88,18
27103,670,13552,L,87,120,-33
27104,669,13552,W,120,87,33
27105,977,13553,L,92,96,-4
27106,978,13553,W,96,92,4
27107,564,13554,W,117,114,3
27108,563,13554,L,114,117,-3
27109,523,13555,W,102,96,6
27110,524,13555,L,96,102,-6
27111,459,13556,L,94,105,-11
27112,460,13556,W,105,94,11
27113,497,13557,L,89,118,-29
27114,498,13557,W,118,89,29
27115,131,13558,W,114,107,7
27116,132,13558,L,107,114,-7
27117,337,13559,L,77,95,-18
27118,338,13559,W,95,77,18
27119,541,13560,L,84,94,-10
27120,542,13560,W,94,84,10
27121,832,13561,W,106,94,12
27122,831,13561,L,94,106,-12
27123,1034,13562,L,85,97,-12
27124,1033,13562,W,97,85,12
27125,955,13563,W,115,110,5
27126,956,13563,L,110,115,-5
27127,801,13564,L,102,108,-6
27128,802,13564,W,108,102,6
27129,266,13565,W,104,94,10
27130,265,13565,L,94,104,-10
27131,372,13566,L,96,105,-9
27132,371,13566,W,105,96,9
27133,350,13567,L,96,110,-14
27134,349,13567,W,110,96,14
27135,428,13568,L,81,113,-32
27136,427,13568,W,113,81,32
27137,31,13569,L,100,102,-2
27138,32,13569,W,102,100,2
27139,184,13570,W,111,93,18
27140,183,13570,L,93,111,-18
27141,900,13571,L,87,89,-2
27142,899,13571,W,89,87,2
27143,57,13572,L,97,104,-7
27144,58,13572,W,104,97,7
27145,615,13573,L,93,96,-3
27146,616,13573,W,96,93,3
27147,202,13574,W,109,105,4
27148,201,13574,L,105,109,-4
27149,39,13575,W,108,106,2
27150,40,13575,L,106,108,-2
27151,435,13576,L,101,108,-7
27152,436,13576,W,108,101,7
27153,46,13577,L,98,107,-9
27154,45,13577,W,107,98,9
27155,320,13578,L,97,99,-2
27156,319,13578,W,99,97,2
27157,524,13579,L,85,93,-8
27158,523,13579,W,93,85,8
27159,277,13580,W,112,103,9
27160,278,13580,L,103,112,-9
27161,216,13581,L,89,91,-2
27162,215,13581,W,91,89,2
27163,636,13582,L,109,116,-7
27164,635,13582,W,116,109,7
27165,1020,13583,L,99,103,-4
27166,1019,13583,W,103,99,4
27167,919,13584,L,93,97,-4
27168,920,13584,W,97,93,4
27169,529,13585,L,110,118,-8
27170,530,13585,W,118,110,8
27171,125,13586,W,112,106,6
27172,126,13586,L,106,112,-6
27173,1017,13587,L,89,119,-30
27174,1018,13587,W,119,89,30
27175,472,13588,L,98,121,-23
27176,471,13588,W,121,98,23
27177,120,13589,L,91,102,-11
27178,119,13589,W,102,91,11
27179,965,13590,W,97,92,5
27180,966,13590,L,92,97,-5
27181,731,13591,L,92,112,-20
27182,732,13591,W,112,92,20
27183,713,13592,W,107,101,6
27184,714,13592,L,101,107,-6
27185,215,13593,L,94,117,-23
27186,216,13593,W,117,94,23
27187,213,13594,W,108,103,5
27188,214,13594,L,103,108,-5
27189,225,13595,L,90,97,-7
27190,226,13595,W,97,90,7
27191,53,13596,W,113,109,4
27192,54,13596,L,109,113,-4
27193,105,13597,W,104,97,7
27194,106,13597,L,97,104,-7
27195,992,13598,W,98,76,22
27196,991,13598,L,76,98,-22
27197,369,13599,L,122,123,-1
27198,370,13599,W,123,122,1
27199,145,13600,W,109,105,4
27200,146,13600,L,105,109,-4
27201,129,13601,L,79,88,-9
27202,130,13601,W,88,79,9
27203,873,13602,L,108,113,-5
27204,874,13602,W,113,108,5
27205,770,13603,L,93,98,-5
27206,769,13603,W,98,93,5
27207,441,13604,W,98,85,13
27208,442,13604,L,85,98,-13
27209,939,13605,W,91,87,4
27210,940,13605,L,87,91,-4
27211,17,13606,L,95,105,-10
27212,18,13606,W,105,95,10
27213,480,13607,L,75,92,-17
27214,479,13607,W,92,75,17
27215,883,13608,W,91,88,3
27216,884,13608,L,88,91,-3
27217,93,13609,L,96,131,-35
27218,94,13609,W,131,96,35
27219,778,13610,W,108,105,3
27220,777,13610,L,105,108,-3
27221,108,13611,L,89,132,-43
27222,107,13611,W,132,89,43
27223,82,13612,L,86,91,-5
27224,81,13612,W,91,86,5
27225,221,13613,W,99,91,8
27226,222,13613,L,91,99,-8
27227,999,13614,W,94,86,8
27228,1000,13614,L,86,94,-8
27229,835,13615,W,97,86,11
27230,836,13615,L,86,97,-11
27231,136,13616,W,105,95,10
27232,135,13616,L,95,105,-10
27233,132,13617,L,96,103,-7
27234,131,13617,W,103,96,7
27235,635,13618,L,111,122,-11
27236,636,13618,W,122,111,11
27237,611,13619,L,89,105,-16
27238,612,13619,W,105,89,16
27239,586,13620,W,128,103,25
27240,585,13620,L,103,128,-25
27241,872,13621,W,107,97,10
27242,871,13621,L,97,107,-10
27243,973,13622,L,95,99,-4
27244,974,13622,W,99,95,4
27245,411,13623,L,97,103,-6
27246,412,13623,W,103,97,6
27247,738,13624,L,93,101,-8
27248,737,13624,W,101,93,8
27249,271,13625,W,112,108,4
27250,272,13625,L,108,112,-4
27251,159,13626,L,108,109,-1
27252,160,13626,W,109,108,1
27253,331,13627,W,106,94,12
27254,332,13627,L,94,106,-12
